name,from_cbsa_info_CBSA Code,YYYYMM,net_inflow,net_inflow_temp,net_inflow_perm
"Lafayette, LA",29180.0,2019-01-01,-20,0,-20
"Lafayette, LA",29180.0,2019-02-01,-56,0,-56
"Lafayette, LA",29180.0,2019-03-01,42,0,42
"Lafayette, LA",29180.0,2019-04-01,34,0,34
"Lafayette, LA",29180.0,2019-05-01,-73,0,-73
"Lafayette, LA",29180.0,2019-06-01,-96,0,-96
"Lafayette, LA",29180.0,2019-07-01,25,0,25
"Lafayette, LA",29180.0,2019-08-01,14,0,14
"Lafayette, LA",29180.0,2019-09-01,4,0,4
"Lafayette, LA",29180.0,2019-10-01,7,0,7
"Lafayette, LA",29180.0,2019-11-01,-19,0,-19
"Lafayette, LA",29180.0,2019-12-01,-72,0,-72
"Lafayette, LA",29180.0,2020-01-01,-37,0,-37
"Lafayette, LA",29180.0,2020-02-01,43,0,43
"Lafayette, LA",29180.0,2020-03-01,31,0,31
"Lafayette, LA",29180.0,2020-04-01,48,0,48
"Lafayette, LA",29180.0,2020-05-01,40,0,40
"Lafayette, LA",29180.0,2020-06-01,-12,0,-12
"Lafayette, LA",29180.0,2020-07-01,12,0,12
"Lafayette, LA",29180.0,2020-08-01,68,50,18
"Lafayette, LA",29180.0,2020-09-01,368,131,237
"Lafayette, LA",29180.0,2020-10-01,267,32,235
"Lafayette, LA",29180.0,2020-11-01,150,17,133
"Lafayette, LA",29180.0,2020-12-01,96,14,82
"Boise City, ID",14260.0,2019-01-01,216,-166,382
"Boise City, ID",14260.0,2019-02-01,279,-16,295
"Boise City, ID",14260.0,2019-03-01,526,0,526
"Boise City, ID",14260.0,2019-04-01,879,183,696
"Boise City, ID",14260.0,2019-05-01,731,116,615
"Boise City, ID",14260.0,2019-06-01,831,13,818
"Boise City, ID",14260.0,2019-07-01,847,0,847
"Boise City, ID",14260.0,2019-08-01,799,-11,810
"Boise City, ID",14260.0,2019-09-01,565,-5,570
"Boise City, ID",14260.0,2019-10-01,129,-416,545
"Boise City, ID",14260.0,2019-11-01,142,-300,442
"Boise City, ID",14260.0,2019-12-01,-27,-236,209
"Boise City, ID",14260.0,2020-01-01,108,-131,239
"Boise City, ID",14260.0,2020-02-01,263,-21,284
"Boise City, ID",14260.0,2020-03-01,944,86,858
"Boise City, ID",14260.0,2020-04-01,777,105,672
"Boise City, ID",14260.0,2020-05-01,895,126,769
"Boise City, ID",14260.0,2020-06-01,836,33,803
"Boise City, ID",14260.0,2020-07-01,1052,2,1050
"Boise City, ID",14260.0,2020-08-01,1264,14,1250
"Boise City, ID",14260.0,2020-09-01,1172,-18,1190
"Boise City, ID",14260.0,2020-10-01,783,-342,1125
"Boise City, ID",14260.0,2020-11-01,651,-296,947
"Boise City, ID",14260.0,2020-12-01,555,-171,726
"Kirksville, MO",28860.0,2019-01-01,0,0,0
"Kirksville, MO",28860.0,2019-02-01,0,0,0
"Kirksville, MO",28860.0,2019-03-01,-12,0,-12
"Kirksville, MO",28860.0,2019-04-01,0,0,0
"Kirksville, MO",28860.0,2019-05-01,-77,0,-77
"Kirksville, MO",28860.0,2019-06-01,-29,0,-29
"Kirksville, MO",28860.0,2019-07-01,-13,0,-13
"Kirksville, MO",28860.0,2019-08-01,0,0,0
"Kirksville, MO",28860.0,2019-09-01,-14,0,-14
"Kirksville, MO",28860.0,2019-10-01,-12,0,-12
"Kirksville, MO",28860.0,2019-11-01,0,0,0
"Kirksville, MO",28860.0,2019-12-01,0,0,0
"Kirksville, MO",28860.0,2020-01-01,0,0,0
"Kirksville, MO",28860.0,2020-02-01,0,0,0
"Kirksville, MO",28860.0,2020-03-01,-11,0,-11
"Kirksville, MO",28860.0,2020-04-01,-11,0,-11
"Kirksville, MO",28860.0,2020-05-01,-70,0,-70
"Kirksville, MO",28860.0,2020-06-01,-43,0,-43
"Kirksville, MO",28860.0,2020-07-01,-11,0,-11
"Kirksville, MO",28860.0,2020-08-01,-13,0,-13
"Kirksville, MO",28860.0,2020-09-01,0,0,0
"Kirksville, MO",28860.0,2020-10-01,0,0,0
"Kirksville, MO",28860.0,2020-11-01,0,0,0
"Kirksville, MO",28860.0,2020-12-01,0,0,0
"Denver-Aurora-Lakewood, CO",19740.0,2019-01-01,-126,-574,448
"Denver-Aurora-Lakewood, CO",19740.0,2019-02-01,-38,-121,83
"Denver-Aurora-Lakewood, CO",19740.0,2019-03-01,23,-9,32
"Denver-Aurora-Lakewood, CO",19740.0,2019-04-01,1007,528,479
"Denver-Aurora-Lakewood, CO",19740.0,2019-05-01,1442,995,447
"Denver-Aurora-Lakewood, CO",19740.0,2019-06-01,800,254,546
"Denver-Aurora-Lakewood, CO",19740.0,2019-07-01,1344,87,1257
"Denver-Aurora-Lakewood, CO",19740.0,2019-08-01,822,9,813
"Denver-Aurora-Lakewood, CO",19740.0,2019-09-01,264,-63,327
"Denver-Aurora-Lakewood, CO",19740.0,2019-10-01,-1165,-928,-237
"Denver-Aurora-Lakewood, CO",19740.0,2019-11-01,-517,-515,-2
"Denver-Aurora-Lakewood, CO",19740.0,2019-12-01,-257,-539,282
"Denver-Aurora-Lakewood, CO",19740.0,2020-01-01,-139,-535,396
"Denver-Aurora-Lakewood, CO",19740.0,2020-02-01,288,-57,345
"Denver-Aurora-Lakewood, CO",19740.0,2020-03-01,229,66,163
"Denver-Aurora-Lakewood, CO",19740.0,2020-04-01,-23,60,-83
"Denver-Aurora-Lakewood, CO",19740.0,2020-05-01,1204,813,391
"Denver-Aurora-Lakewood, CO",19740.0,2020-06-01,537,390,147
"Denver-Aurora-Lakewood, CO",19740.0,2020-07-01,936,91,845
"Denver-Aurora-Lakewood, CO",19740.0,2020-08-01,731,92,639
"Denver-Aurora-Lakewood, CO",19740.0,2020-09-01,261,-44,305
"Denver-Aurora-Lakewood, CO",19740.0,2020-10-01,-922,-913,-9
"Denver-Aurora-Lakewood, CO",19740.0,2020-11-01,-368,-547,179
"Denver-Aurora-Lakewood, CO",19740.0,2020-12-01,-400,-538,138
"Quincy, IL-MO",39500.0,2019-01-01,0,0,0
"Quincy, IL-MO",39500.0,2019-02-01,12,0,12
"Quincy, IL-MO",39500.0,2019-03-01,-10,0,-10
"Quincy, IL-MO",39500.0,2019-04-01,-12,0,-12
"Quincy, IL-MO",39500.0,2019-05-01,6,0,6
"Quincy, IL-MO",39500.0,2019-06-01,11,0,11
"Quincy, IL-MO",39500.0,2019-07-01,-12,0,-12
"Quincy, IL-MO",39500.0,2019-08-01,4,0,4
"Quincy, IL-MO",39500.0,2019-09-01,-3,0,-3
"Quincy, IL-MO",39500.0,2019-10-01,-16,0,-16
"Quincy, IL-MO",39500.0,2019-11-01,8,0,8
"Quincy, IL-MO",39500.0,2019-12-01,0,0,0
"Quincy, IL-MO",39500.0,2020-01-01,-4,0,-4
"Quincy, IL-MO",39500.0,2020-02-01,-11,0,-11
"Quincy, IL-MO",39500.0,2020-03-01,-12,0,-12
"Quincy, IL-MO",39500.0,2020-04-01,-34,0,-34
"Quincy, IL-MO",39500.0,2020-05-01,-4,0,-4
"Quincy, IL-MO",39500.0,2020-06-01,-4,0,-4
"Quincy, IL-MO",39500.0,2020-07-01,-5,0,-5
"Quincy, IL-MO",39500.0,2020-08-01,0,0,0
"Quincy, IL-MO",39500.0,2020-09-01,-11,0,-11
"Quincy, IL-MO",39500.0,2020-10-01,-16,0,-16
"Quincy, IL-MO",39500.0,2020-11-01,0,0,0
"Quincy, IL-MO",39500.0,2020-12-01,-19,-13,-6
"Decatur, IN",19540.0,2019-01-01,-24,0,-24
"Decatur, IN",19540.0,2019-02-01,-33,0,-33
"Decatur, IN",19540.0,2019-03-01,-1,0,-1
"Decatur, IN",19540.0,2019-04-01,-16,0,-16
"Decatur, IN",19540.0,2019-05-01,9,0,9
"Decatur, IN",19540.0,2019-06-01,-13,0,-13
"Decatur, IN",19540.0,2019-07-01,10,0,10
"Decatur, IN",19540.0,2019-08-01,-2,0,-2
"Decatur, IN",19540.0,2019-09-01,10,0,10
"Decatur, IN",19540.0,2019-10-01,-4,0,-4
"Decatur, IN",19540.0,2019-11-01,12,0,12
"Decatur, IN",19540.0,2019-12-01,7,0,7
"Decatur, IN",19540.0,2020-01-01,31,0,31
"Decatur, IN",19540.0,2020-02-01,-7,0,-7
"Decatur, IN",19540.0,2020-03-01,-14,0,-14
"Decatur, IN",19540.0,2020-04-01,-12,0,-12
"Decatur, IN",19540.0,2020-05-01,-8,0,-8
"Decatur, IN",19540.0,2020-06-01,-25,0,-25
"Decatur, IN",19540.0,2020-07-01,-22,0,-22
"Decatur, IN",19540.0,2020-08-01,-4,0,-4
"Decatur, IN",19540.0,2020-09-01,32,0,32
"Decatur, IN",19540.0,2020-10-01,-18,0,-18
"Decatur, IN",19540.0,2020-11-01,17,0,17
"Decatur, IN",19540.0,2020-12-01,-11,0,-11
"Natchez, MS-LA",35020.0,2019-01-01,41,0,41
"Natchez, MS-LA",35020.0,2019-02-01,0,0,0
"Natchez, MS-LA",35020.0,2019-03-01,13,0,13
"Natchez, MS-LA",35020.0,2019-04-01,0,0,0
"Natchez, MS-LA",35020.0,2019-05-01,0,0,0
"Natchez, MS-LA",35020.0,2019-06-01,0,0,0
"Natchez, MS-LA",35020.0,2019-07-01,0,0,0
"Natchez, MS-LA",35020.0,2019-08-01,0,0,0
"Natchez, MS-LA",35020.0,2019-09-01,0,0,0
"Natchez, MS-LA",35020.0,2019-10-01,0,0,0
"Natchez, MS-LA",35020.0,2019-11-01,0,0,0
"Natchez, MS-LA",35020.0,2019-12-01,0,0,0
"Natchez, MS-LA",35020.0,2020-01-01,19,0,19
"Natchez, MS-LA",35020.0,2020-02-01,0,0,0
"Natchez, MS-LA",35020.0,2020-03-01,0,0,0
"Natchez, MS-LA",35020.0,2020-04-01,0,0,0
"Natchez, MS-LA",35020.0,2020-05-01,-16,0,-16
"Natchez, MS-LA",35020.0,2020-06-01,0,0,0
"Natchez, MS-LA",35020.0,2020-07-01,0,0,0
"Natchez, MS-LA",35020.0,2020-08-01,0,0,0
"Natchez, MS-LA",35020.0,2020-09-01,0,0,0
"Natchez, MS-LA",35020.0,2020-10-01,0,0,0
"Natchez, MS-LA",35020.0,2020-11-01,0,0,0
"Natchez, MS-LA",35020.0,2020-12-01,-23,0,-23
"Hastings, NE",25580.0,2019-01-01,-25,0,-25
"Hastings, NE",25580.0,2019-02-01,0,0,0
"Hastings, NE",25580.0,2019-03-01,0,0,0
"Hastings, NE",25580.0,2019-04-01,11,0,11
"Hastings, NE",25580.0,2019-05-01,9,0,9
"Hastings, NE",25580.0,2019-06-01,-16,0,-16
"Hastings, NE",25580.0,2019-07-01,14,0,14
"Hastings, NE",25580.0,2019-08-01,-16,0,-16
"Hastings, NE",25580.0,2019-09-01,-6,0,-6
"Hastings, NE",25580.0,2019-10-01,-5,0,-5
"Hastings, NE",25580.0,2019-11-01,24,0,24
"Hastings, NE",25580.0,2019-12-01,-3,0,-3
"Hastings, NE",25580.0,2020-01-01,3,0,3
"Hastings, NE",25580.0,2020-02-01,16,0,16
"Hastings, NE",25580.0,2020-03-01,-4,0,-4
"Hastings, NE",25580.0,2020-04-01,-5,0,-5
"Hastings, NE",25580.0,2020-05-01,2,0,2
"Hastings, NE",25580.0,2020-06-01,-1,0,-1
"Hastings, NE",25580.0,2020-07-01,-1,0,-1
"Hastings, NE",25580.0,2020-08-01,3,0,3
"Hastings, NE",25580.0,2020-09-01,13,0,13
"Hastings, NE",25580.0,2020-10-01,4,0,4
"Hastings, NE",25580.0,2020-11-01,-11,0,-11
"Hastings, NE",25580.0,2020-12-01,6,0,6
"Gettysburg, PA",23900.0,2019-01-01,-26,-1,-25
"Gettysburg, PA",23900.0,2019-02-01,27,0,27
"Gettysburg, PA",23900.0,2019-03-01,-20,0,-20
"Gettysburg, PA",23900.0,2019-04-01,41,0,41
"Gettysburg, PA",23900.0,2019-05-01,15,0,15
"Gettysburg, PA",23900.0,2019-06-01,4,0,4
"Gettysburg, PA",23900.0,2019-07-01,5,0,5
"Gettysburg, PA",23900.0,2019-08-01,49,0,49
"Gettysburg, PA",23900.0,2019-09-01,-19,0,-19
"Gettysburg, PA",23900.0,2019-10-01,2,0,2
"Gettysburg, PA",23900.0,2019-11-01,-8,0,-8
"Gettysburg, PA",23900.0,2019-12-01,48,0,48
"Gettysburg, PA",23900.0,2020-01-01,-67,-11,-56
"Gettysburg, PA",23900.0,2020-02-01,1,0,1
"Gettysburg, PA",23900.0,2020-03-01,66,0,66
"Gettysburg, PA",23900.0,2020-04-01,30,0,30
"Gettysburg, PA",23900.0,2020-05-01,17,0,17
"Gettysburg, PA",23900.0,2020-06-01,42,0,42
"Gettysburg, PA",23900.0,2020-07-01,-31,0,-31
"Gettysburg, PA",23900.0,2020-08-01,38,0,38
"Gettysburg, PA",23900.0,2020-09-01,40,12,28
"Gettysburg, PA",23900.0,2020-10-01,78,0,78
"Gettysburg, PA",23900.0,2020-11-01,12,0,12
"Gettysburg, PA",23900.0,2020-12-01,54,0,54
"Othello, WA",36830.0,2019-01-01,-9,0,-9
"Othello, WA",36830.0,2019-02-01,0,0,0
"Othello, WA",36830.0,2019-03-01,-3,0,-3
"Othello, WA",36830.0,2019-04-01,11,0,11
"Othello, WA",36830.0,2019-05-01,-11,0,-11
"Othello, WA",36830.0,2019-06-01,-20,0,-20
"Othello, WA",36830.0,2019-07-01,-16,0,-16
"Othello, WA",36830.0,2019-08-01,3,0,3
"Othello, WA",36830.0,2019-09-01,-1,0,-1
"Othello, WA",36830.0,2019-10-01,-22,0,-22
"Othello, WA",36830.0,2019-11-01,-18,0,-18
"Othello, WA",36830.0,2019-12-01,0,0,0
"Othello, WA",36830.0,2020-01-01,12,0,12
"Othello, WA",36830.0,2020-02-01,0,0,0
"Othello, WA",36830.0,2020-03-01,-11,0,-11
"Othello, WA",36830.0,2020-04-01,-3,0,-3
"Othello, WA",36830.0,2020-05-01,17,0,17
"Othello, WA",36830.0,2020-06-01,-14,0,-14
"Othello, WA",36830.0,2020-07-01,0,0,0
"Othello, WA",36830.0,2020-08-01,-14,0,-14
"Othello, WA",36830.0,2020-09-01,-1,0,-1
"Othello, WA",36830.0,2020-10-01,0,0,0
"Othello, WA",36830.0,2020-11-01,11,0,11
"Othello, WA",36830.0,2020-12-01,-12,0,-12
"Aguadilla-Isabela, PR",10380.0,2019-01-01,0,0,0
"Aguadilla-Isabela, PR",10380.0,2019-02-01,0,0,0
"Aguadilla-Isabela, PR",10380.0,2019-03-01,0,0,0
"Aguadilla-Isabela, PR",10380.0,2019-04-01,0,0,0
"Aguadilla-Isabela, PR",10380.0,2019-05-01,0,0,0
"Aguadilla-Isabela, PR",10380.0,2019-06-01,0,0,0
"Aguadilla-Isabela, PR",10380.0,2019-07-01,-15,0,-15
"Aguadilla-Isabela, PR",10380.0,2019-08-01,0,0,0
"Aguadilla-Isabela, PR",10380.0,2019-09-01,0,0,0
"Aguadilla-Isabela, PR",10380.0,2019-10-01,12,12,0
"Aguadilla-Isabela, PR",10380.0,2019-11-01,11,0,11
"Aguadilla-Isabela, PR",10380.0,2019-12-01,0,0,0
"Aguadilla-Isabela, PR",10380.0,2020-01-01,0,0,0
"Aguadilla-Isabela, PR",10380.0,2020-02-01,0,0,0
"Aguadilla-Isabela, PR",10380.0,2020-03-01,0,0,0
"Aguadilla-Isabela, PR",10380.0,2020-04-01,0,0,0
"Aguadilla-Isabela, PR",10380.0,2020-05-01,0,0,0
"Aguadilla-Isabela, PR",10380.0,2020-06-01,0,0,0
"Aguadilla-Isabela, PR",10380.0,2020-07-01,0,0,0
"Aguadilla-Isabela, PR",10380.0,2020-08-01,0,0,0
"Aguadilla-Isabela, PR",10380.0,2020-09-01,0,0,0
"Aguadilla-Isabela, PR",10380.0,2020-10-01,11,11,0
"Aguadilla-Isabela, PR",10380.0,2020-11-01,0,0,0
"Aguadilla-Isabela, PR",10380.0,2020-12-01,0,0,0
"Augusta-Richmond County, GA-SC",12260.0,2019-01-01,30,0,30
"Augusta-Richmond County, GA-SC",12260.0,2019-02-01,8,0,8
"Augusta-Richmond County, GA-SC",12260.0,2019-03-01,11,0,11
"Augusta-Richmond County, GA-SC",12260.0,2019-04-01,-55,0,-55
"Augusta-Richmond County, GA-SC",12260.0,2019-05-01,-56,0,-56
"Augusta-Richmond County, GA-SC",12260.0,2019-06-01,2,0,2
"Augusta-Richmond County, GA-SC",12260.0,2019-07-01,47,0,47
"Augusta-Richmond County, GA-SC",12260.0,2019-08-01,-23,0,-23
"Augusta-Richmond County, GA-SC",12260.0,2019-09-01,40,0,40
"Augusta-Richmond County, GA-SC",12260.0,2019-10-01,-61,0,-61
"Augusta-Richmond County, GA-SC",12260.0,2019-11-01,19,0,19
"Augusta-Richmond County, GA-SC",12260.0,2019-12-01,-33,0,-33
"Augusta-Richmond County, GA-SC",12260.0,2020-01-01,53,0,53
"Augusta-Richmond County, GA-SC",12260.0,2020-02-01,-15,0,-15
"Augusta-Richmond County, GA-SC",12260.0,2020-03-01,4,0,4
"Augusta-Richmond County, GA-SC",12260.0,2020-04-01,16,0,16
"Augusta-Richmond County, GA-SC",12260.0,2020-05-01,11,0,11
"Augusta-Richmond County, GA-SC",12260.0,2020-06-01,137,0,137
"Augusta-Richmond County, GA-SC",12260.0,2020-07-01,123,0,123
"Augusta-Richmond County, GA-SC",12260.0,2020-08-01,75,0,75
"Augusta-Richmond County, GA-SC",12260.0,2020-09-01,-29,-11,-18
"Augusta-Richmond County, GA-SC",12260.0,2020-10-01,26,0,26
"Augusta-Richmond County, GA-SC",12260.0,2020-11-01,-41,0,-41
"Augusta-Richmond County, GA-SC",12260.0,2020-12-01,-36,0,-36
"Gainesville, FL",23540.0,2019-01-01,-108,0,-108
"Gainesville, FL",23540.0,2019-02-01,43,0,43
"Gainesville, FL",23540.0,2019-03-01,-45,0,-45
"Gainesville, FL",23540.0,2019-04-01,-142,0,-142
"Gainesville, FL",23540.0,2019-05-01,-265,-23,-242
"Gainesville, FL",23540.0,2019-06-01,-154,0,-154
"Gainesville, FL",23540.0,2019-07-01,-448,0,-448
"Gainesville, FL",23540.0,2019-08-01,-47,0,-47
"Gainesville, FL",23540.0,2019-09-01,85,0,85
"Gainesville, FL",23540.0,2019-10-01,32,0,32
"Gainesville, FL",23540.0,2019-11-01,-13,0,-13
"Gainesville, FL",23540.0,2019-12-01,-96,0,-96
"Gainesville, FL",23540.0,2020-01-01,-51,0,-51
"Gainesville, FL",23540.0,2020-02-01,-69,0,-69
"Gainesville, FL",23540.0,2020-03-01,-69,-25,-44
"Gainesville, FL",23540.0,2020-04-01,-209,1,-210
"Gainesville, FL",23540.0,2020-05-01,-255,0,-255
"Gainesville, FL",23540.0,2020-06-01,-336,0,-336
"Gainesville, FL",23540.0,2020-07-01,-580,0,-580
"Gainesville, FL",23540.0,2020-08-01,42,12,30
"Gainesville, FL",23540.0,2020-09-01,21,0,21
"Gainesville, FL",23540.0,2020-10-01,-55,0,-55
"Gainesville, FL",23540.0,2020-11-01,9,0,9
"Gainesville, FL",23540.0,2020-12-01,-71,0,-71
"Burlington, NC",15500.0,2019-01-01,64,0,64
"Burlington, NC",15500.0,2019-02-01,126,0,126
"Burlington, NC",15500.0,2019-03-01,94,0,94
"Burlington, NC",15500.0,2019-04-01,52,0,52
"Burlington, NC",15500.0,2019-05-01,97,0,97
"Burlington, NC",15500.0,2019-06-01,198,0,198
"Burlington, NC",15500.0,2019-07-01,97,0,97
"Burlington, NC",15500.0,2019-08-01,200,0,200
"Burlington, NC",15500.0,2019-09-01,96,0,96
"Burlington, NC",15500.0,2019-10-01,60,0,60
"Burlington, NC",15500.0,2019-11-01,60,0,60
"Burlington, NC",15500.0,2019-12-01,30,0,30
"Burlington, NC",15500.0,2020-01-01,97,0,97
"Burlington, NC",15500.0,2020-02-01,-39,0,-39
"Burlington, NC",15500.0,2020-03-01,85,0,85
"Burlington, NC",15500.0,2020-04-01,114,0,114
"Burlington, NC",15500.0,2020-05-01,156,0,156
"Burlington, NC",15500.0,2020-06-01,172,0,172
"Burlington, NC",15500.0,2020-07-01,158,0,158
"Burlington, NC",15500.0,2020-08-01,139,0,139
"Burlington, NC",15500.0,2020-09-01,119,0,119
"Burlington, NC",15500.0,2020-10-01,158,0,158
"Burlington, NC",15500.0,2020-11-01,102,0,102
"Burlington, NC",15500.0,2020-12-01,117,0,117
"San Francisco-Oakland-Berkeley, CA",41860.0,2019-01-01,-2068,-43,-2025
"San Francisco-Oakland-Berkeley, CA",41860.0,2019-02-01,-1791,-13,-1778
"San Francisco-Oakland-Berkeley, CA",41860.0,2019-03-01,-2669,-8,-2661
"San Francisco-Oakland-Berkeley, CA",41860.0,2019-04-01,-2321,29,-2350
"San Francisco-Oakland-Berkeley, CA",41860.0,2019-05-01,-2827,124,-2951
"San Francisco-Oakland-Berkeley, CA",41860.0,2019-06-01,-3343,-6,-3337
"San Francisco-Oakland-Berkeley, CA",41860.0,2019-07-01,-3236,-11,-3225
"San Francisco-Oakland-Berkeley, CA",41860.0,2019-08-01,-2804,-41,-2763
"San Francisco-Oakland-Berkeley, CA",41860.0,2019-09-01,-2737,-10,-2727
"San Francisco-Oakland-Berkeley, CA",41860.0,2019-10-01,-2758,-70,-2688
"San Francisco-Oakland-Berkeley, CA",41860.0,2019-11-01,-2431,-128,-2303
"San Francisco-Oakland-Berkeley, CA",41860.0,2019-12-01,-2226,-37,-2189
"San Francisco-Oakland-Berkeley, CA",41860.0,2020-01-01,-2580,-122,-2458
"San Francisco-Oakland-Berkeley, CA",41860.0,2020-02-01,-2329,-38,-2291
"San Francisco-Oakland-Berkeley, CA",41860.0,2020-03-01,-4257,-1001,-3256
"San Francisco-Oakland-Berkeley, CA",41860.0,2020-04-01,-4518,-786,-3732
"San Francisco-Oakland-Berkeley, CA",41860.0,2020-05-01,-5096,-361,-4735
"San Francisco-Oakland-Berkeley, CA",41860.0,2020-06-01,-6675,-437,-6238
"San Francisco-Oakland-Berkeley, CA",41860.0,2020-07-01,-7790,-364,-7426
"San Francisco-Oakland-Berkeley, CA",41860.0,2020-08-01,-8966,-352,-8614
"San Francisco-Oakland-Berkeley, CA",41860.0,2020-09-01,-8852,-576,-8276
"San Francisco-Oakland-Berkeley, CA",41860.0,2020-10-01,-8357,-713,-7644
"San Francisco-Oakland-Berkeley, CA",41860.0,2020-11-01,-6878,-565,-6313
"San Francisco-Oakland-Berkeley, CA",41860.0,2020-12-01,-6346,-691,-5655
"Albany-Schenectady-Troy, NY",10580.0,2019-01-01,-1216,-1245,29
"Albany-Schenectady-Troy, NY",10580.0,2019-02-01,10,-41,51
"Albany-Schenectady-Troy, NY",10580.0,2019-03-01,126,0,126
"Albany-Schenectady-Troy, NY",10580.0,2019-04-01,1032,758,274
"Albany-Schenectady-Troy, NY",10580.0,2019-05-01,1137,1062,75
"Albany-Schenectady-Troy, NY",10580.0,2019-06-01,305,162,143
"Albany-Schenectady-Troy, NY",10580.0,2019-07-01,40,24,16
"Albany-Schenectady-Troy, NY",10580.0,2019-08-01,169,0,169
"Albany-Schenectady-Troy, NY",10580.0,2019-09-01,-92,-18,-74
"Albany-Schenectady-Troy, NY",10580.0,2019-10-01,-793,-784,-9
"Albany-Schenectady-Troy, NY",10580.0,2019-11-01,-532,-609,77
"Albany-Schenectady-Troy, NY",10580.0,2019-12-01,-894,-1009,115
"Albany-Schenectady-Troy, NY",10580.0,2020-01-01,-1227,-1325,98
"Albany-Schenectady-Troy, NY",10580.0,2020-02-01,-12,-25,13
"Albany-Schenectady-Troy, NY",10580.0,2020-03-01,513,281,232
"Albany-Schenectady-Troy, NY",10580.0,2020-04-01,709,439,270
"Albany-Schenectady-Troy, NY",10580.0,2020-05-01,770,747,23
"Albany-Schenectady-Troy, NY",10580.0,2020-06-01,808,501,307
"Albany-Schenectady-Troy, NY",10580.0,2020-07-01,444,160,284
"Albany-Schenectady-Troy, NY",10580.0,2020-08-01,356,31,325
"Albany-Schenectady-Troy, NY",10580.0,2020-09-01,281,-27,308
"Albany-Schenectady-Troy, NY",10580.0,2020-10-01,-411,-538,127
"Albany-Schenectady-Troy, NY",10580.0,2020-11-01,-297,-520,223
"Albany-Schenectady-Troy, NY",10580.0,2020-12-01,-596,-735,139
"Laramie, WY",29660.0,2019-01-01,-10,0,-10
"Laramie, WY",29660.0,2019-02-01,-18,0,-18
"Laramie, WY",29660.0,2019-03-01,-16,0,-16
"Laramie, WY",29660.0,2019-04-01,-7,0,-7
"Laramie, WY",29660.0,2019-05-01,-98,11,-109
"Laramie, WY",29660.0,2019-06-01,3,0,3
"Laramie, WY",29660.0,2019-07-01,-48,0,-48
"Laramie, WY",29660.0,2019-08-01,15,0,15
"Laramie, WY",29660.0,2019-09-01,3,0,3
"Laramie, WY",29660.0,2019-10-01,-24,0,-24
"Laramie, WY",29660.0,2019-11-01,0,0,0
"Laramie, WY",29660.0,2019-12-01,-32,0,-32
"Laramie, WY",29660.0,2020-01-01,-18,0,-18
"Laramie, WY",29660.0,2020-02-01,4,0,4
"Laramie, WY",29660.0,2020-03-01,0,0,0
"Laramie, WY",29660.0,2020-04-01,-43,0,-43
"Laramie, WY",29660.0,2020-05-01,-27,11,-38
"Laramie, WY",29660.0,2020-06-01,-10,0,-10
"Laramie, WY",29660.0,2020-07-01,-12,0,-12
"Laramie, WY",29660.0,2020-08-01,-52,0,-52
"Laramie, WY",29660.0,2020-09-01,-13,0,-13
"Laramie, WY",29660.0,2020-10-01,-5,0,-5
"Laramie, WY",29660.0,2020-11-01,-13,0,-13
"Laramie, WY",29660.0,2020-12-01,-19,0,-19
"Charlottesville, VA",16820.0,2019-01-01,-64,0,-64
"Charlottesville, VA",16820.0,2019-02-01,28,0,28
"Charlottesville, VA",16820.0,2019-03-01,-17,0,-17
"Charlottesville, VA",16820.0,2019-04-01,-20,0,-20
"Charlottesville, VA",16820.0,2019-05-01,-151,0,-151
"Charlottesville, VA",16820.0,2019-06-01,-193,0,-193
"Charlottesville, VA",16820.0,2019-07-01,-286,0,-286
"Charlottesville, VA",16820.0,2019-08-01,-97,0,-97
"Charlottesville, VA",16820.0,2019-09-01,-34,0,-34
"Charlottesville, VA",16820.0,2019-10-01,-48,0,-48
"Charlottesville, VA",16820.0,2019-11-01,-12,0,-12
"Charlottesville, VA",16820.0,2019-12-01,8,0,8
"Charlottesville, VA",16820.0,2020-01-01,-18,0,-18
"Charlottesville, VA",16820.0,2020-02-01,-34,0,-34
"Charlottesville, VA",16820.0,2020-03-01,39,49,-10
"Charlottesville, VA",16820.0,2020-04-01,-30,14,-44
"Charlottesville, VA",16820.0,2020-05-01,-61,23,-84
"Charlottesville, VA",16820.0,2020-06-01,-109,0,-109
"Charlottesville, VA",16820.0,2020-07-01,-48,0,-48
"Charlottesville, VA",16820.0,2020-08-01,32,0,32
"Charlottesville, VA",16820.0,2020-09-01,-33,0,-33
"Charlottesville, VA",16820.0,2020-10-01,6,0,6
"Charlottesville, VA",16820.0,2020-11-01,-24,0,-24
"Charlottesville, VA",16820.0,2020-12-01,17,0,17
"Corinth, MS",18420.0,2019-01-01,-3,0,-3
"Corinth, MS",18420.0,2019-02-01,11,0,11
"Corinth, MS",18420.0,2019-03-01,29,0,29
"Corinth, MS",18420.0,2019-04-01,16,0,16
"Corinth, MS",18420.0,2019-05-01,12,0,12
"Corinth, MS",18420.0,2019-06-01,-37,0,-37
"Corinth, MS",18420.0,2019-07-01,10,0,10
"Corinth, MS",18420.0,2019-08-01,23,0,23
"Corinth, MS",18420.0,2019-09-01,1,0,1
"Corinth, MS",18420.0,2019-10-01,0,0,0
"Corinth, MS",18420.0,2019-11-01,0,0,0
"Corinth, MS",18420.0,2019-12-01,-17,0,-17
"Corinth, MS",18420.0,2020-01-01,12,0,12
"Corinth, MS",18420.0,2020-02-01,14,0,14
"Corinth, MS",18420.0,2020-03-01,3,0,3
"Corinth, MS",18420.0,2020-04-01,24,0,24
"Corinth, MS",18420.0,2020-05-01,-3,0,-3
"Corinth, MS",18420.0,2020-06-01,-44,0,-44
"Corinth, MS",18420.0,2020-07-01,3,0,3
"Corinth, MS",18420.0,2020-08-01,-28,0,-28
"Corinth, MS",18420.0,2020-09-01,-12,0,-12
"Corinth, MS",18420.0,2020-10-01,12,0,12
"Corinth, MS",18420.0,2020-11-01,0,0,0
"Corinth, MS",18420.0,2020-12-01,-14,0,-14
"Cape Girardeau, MO-IL",16020.0,2019-01-01,25,0,25
"Cape Girardeau, MO-IL",16020.0,2019-02-01,6,0,6
"Cape Girardeau, MO-IL",16020.0,2019-03-01,-4,0,-4
"Cape Girardeau, MO-IL",16020.0,2019-04-01,26,0,26
"Cape Girardeau, MO-IL",16020.0,2019-05-01,-24,0,-24
"Cape Girardeau, MO-IL",16020.0,2019-06-01,-5,0,-5
"Cape Girardeau, MO-IL",16020.0,2019-07-01,-27,0,-27
"Cape Girardeau, MO-IL",16020.0,2019-08-01,19,0,19
"Cape Girardeau, MO-IL",16020.0,2019-09-01,7,0,7
"Cape Girardeau, MO-IL",16020.0,2019-10-01,-10,0,-10
"Cape Girardeau, MO-IL",16020.0,2019-11-01,6,0,6
"Cape Girardeau, MO-IL",16020.0,2019-12-01,-19,0,-19
"Cape Girardeau, MO-IL",16020.0,2020-01-01,21,0,21
"Cape Girardeau, MO-IL",16020.0,2020-02-01,-13,0,-13
"Cape Girardeau, MO-IL",16020.0,2020-03-01,8,0,8
"Cape Girardeau, MO-IL",16020.0,2020-04-01,-8,0,-8
"Cape Girardeau, MO-IL",16020.0,2020-05-01,1,0,1
"Cape Girardeau, MO-IL",16020.0,2020-06-01,-17,0,-17
"Cape Girardeau, MO-IL",16020.0,2020-07-01,0,0,0
"Cape Girardeau, MO-IL",16020.0,2020-08-01,18,0,18
"Cape Girardeau, MO-IL",16020.0,2020-09-01,9,0,9
"Cape Girardeau, MO-IL",16020.0,2020-10-01,-12,0,-12
"Cape Girardeau, MO-IL",16020.0,2020-11-01,13,0,13
"Cape Girardeau, MO-IL",16020.0,2020-12-01,-15,0,-15
"Hickory-Lenoir-Morganton, NC",25860.0,2019-01-01,48,0,48
"Hickory-Lenoir-Morganton, NC",25860.0,2019-02-01,35,0,35
"Hickory-Lenoir-Morganton, NC",25860.0,2019-03-01,49,0,49
"Hickory-Lenoir-Morganton, NC",25860.0,2019-04-01,68,0,68
"Hickory-Lenoir-Morganton, NC",25860.0,2019-05-01,99,0,99
"Hickory-Lenoir-Morganton, NC",25860.0,2019-06-01,95,0,95
"Hickory-Lenoir-Morganton, NC",25860.0,2019-07-01,137,0,137
"Hickory-Lenoir-Morganton, NC",25860.0,2019-08-01,24,0,24
"Hickory-Lenoir-Morganton, NC",25860.0,2019-09-01,28,0,28
"Hickory-Lenoir-Morganton, NC",25860.0,2019-10-01,70,0,70
"Hickory-Lenoir-Morganton, NC",25860.0,2019-11-01,62,0,62
"Hickory-Lenoir-Morganton, NC",25860.0,2019-12-01,10,0,10
"Hickory-Lenoir-Morganton, NC",25860.0,2020-01-01,-10,0,-10
"Hickory-Lenoir-Morganton, NC",25860.0,2020-02-01,20,0,20
"Hickory-Lenoir-Morganton, NC",25860.0,2020-03-01,-16,-24,8
"Hickory-Lenoir-Morganton, NC",25860.0,2020-04-01,3,0,3
"Hickory-Lenoir-Morganton, NC",25860.0,2020-05-01,4,0,4
"Hickory-Lenoir-Morganton, NC",25860.0,2020-06-01,13,0,13
"Hickory-Lenoir-Morganton, NC",25860.0,2020-07-01,26,0,26
"Hickory-Lenoir-Morganton, NC",25860.0,2020-08-01,43,0,43
"Hickory-Lenoir-Morganton, NC",25860.0,2020-09-01,2,0,2
"Hickory-Lenoir-Morganton, NC",25860.0,2020-10-01,53,0,53
"Hickory-Lenoir-Morganton, NC",25860.0,2020-11-01,69,0,69
"Hickory-Lenoir-Morganton, NC",25860.0,2020-12-01,38,0,38
"Washington-Arlington-Alexandria, DC-VA-MD-WV",47900.0,2019-01-01,-1369,-475,-894
"Washington-Arlington-Alexandria, DC-VA-MD-WV",47900.0,2019-02-01,-879,-25,-854
"Washington-Arlington-Alexandria, DC-VA-MD-WV",47900.0,2019-03-01,-741,64,-805
"Washington-Arlington-Alexandria, DC-VA-MD-WV",47900.0,2019-04-01,-809,420,-1229
"Washington-Arlington-Alexandria, DC-VA-MD-WV",47900.0,2019-05-01,-197,749,-946
"Washington-Arlington-Alexandria, DC-VA-MD-WV",47900.0,2019-06-01,-1499,-40,-1459
"Washington-Arlington-Alexandria, DC-VA-MD-WV",47900.0,2019-07-01,-1218,16,-1234
"Washington-Arlington-Alexandria, DC-VA-MD-WV",47900.0,2019-08-01,-1912,27,-1939
"Washington-Arlington-Alexandria, DC-VA-MD-WV",47900.0,2019-09-01,-1394,60,-1454
"Washington-Arlington-Alexandria, DC-VA-MD-WV",47900.0,2019-10-01,-1463,-90,-1373
"Washington-Arlington-Alexandria, DC-VA-MD-WV",47900.0,2019-11-01,-1381,-78,-1303
"Washington-Arlington-Alexandria, DC-VA-MD-WV",47900.0,2019-12-01,-1611,-534,-1077
"Washington-Arlington-Alexandria, DC-VA-MD-WV",47900.0,2020-01-01,-1087,-374,-713
"Washington-Arlington-Alexandria, DC-VA-MD-WV",47900.0,2020-02-01,-989,-39,-950
"Washington-Arlington-Alexandria, DC-VA-MD-WV",47900.0,2020-03-01,-616,549,-1165
"Washington-Arlington-Alexandria, DC-VA-MD-WV",47900.0,2020-04-01,-987,298,-1285
"Washington-Arlington-Alexandria, DC-VA-MD-WV",47900.0,2020-05-01,-1173,141,-1314
"Washington-Arlington-Alexandria, DC-VA-MD-WV",47900.0,2020-06-01,-1613,192,-1805
"Washington-Arlington-Alexandria, DC-VA-MD-WV",47900.0,2020-07-01,-1489,173,-1662
"Washington-Arlington-Alexandria, DC-VA-MD-WV",47900.0,2020-08-01,-2365,174,-2539
"Washington-Arlington-Alexandria, DC-VA-MD-WV",47900.0,2020-09-01,-2635,17,-2652
"Washington-Arlington-Alexandria, DC-VA-MD-WV",47900.0,2020-10-01,-2479,-75,-2404
"Washington-Arlington-Alexandria, DC-VA-MD-WV",47900.0,2020-11-01,-2219,-287,-1932
"Washington-Arlington-Alexandria, DC-VA-MD-WV",47900.0,2020-12-01,-2614,-561,-2053
"Holland, MI",26090.0,2019-01-01,-46,-77,31
"Holland, MI",26090.0,2019-02-01,49,0,49
"Holland, MI",26090.0,2019-03-01,57,0,57
"Holland, MI",26090.0,2019-04-01,209,112,97
"Holland, MI",26090.0,2019-05-01,285,237,48
"Holland, MI",26090.0,2019-06-01,19,0,19
"Holland, MI",26090.0,2019-07-01,14,0,14
"Holland, MI",26090.0,2019-08-01,35,0,35
"Holland, MI",26090.0,2019-09-01,-7,-16,9
"Holland, MI",26090.0,2019-10-01,-225,-224,-1
"Holland, MI",26090.0,2019-11-01,-121,-148,27
"Holland, MI",26090.0,2019-12-01,-120,-107,-13
"Holland, MI",26090.0,2020-01-01,6,-28,34
"Holland, MI",26090.0,2020-02-01,47,0,47
"Holland, MI",26090.0,2020-03-01,76,15,61
"Holland, MI",26090.0,2020-04-01,100,13,87
"Holland, MI",26090.0,2020-05-01,222,156,66
"Holland, MI",26090.0,2020-06-01,170,106,64
"Holland, MI",26090.0,2020-07-01,60,11,49
"Holland, MI",26090.0,2020-08-01,62,0,62
"Holland, MI",26090.0,2020-09-01,45,0,45
"Holland, MI",26090.0,2020-10-01,-223,-240,17
"Holland, MI",26090.0,2020-11-01,-116,-112,-4
"Holland, MI",26090.0,2020-12-01,-100,-92,-8
"Cumberland, MD-WV",19060.0,2019-01-01,-11,0,-11
"Cumberland, MD-WV",19060.0,2019-02-01,0,0,0
"Cumberland, MD-WV",19060.0,2019-03-01,-11,0,-11
"Cumberland, MD-WV",19060.0,2019-04-01,0,0,0
"Cumberland, MD-WV",19060.0,2019-05-01,-1,0,-1
"Cumberland, MD-WV",19060.0,2019-06-01,47,0,47
"Cumberland, MD-WV",19060.0,2019-07-01,-16,0,-16
"Cumberland, MD-WV",19060.0,2019-08-01,6,0,6
"Cumberland, MD-WV",19060.0,2019-09-01,-1,0,-1
"Cumberland, MD-WV",19060.0,2019-10-01,0,0,0
"Cumberland, MD-WV",19060.0,2019-11-01,11,0,11
"Cumberland, MD-WV",19060.0,2019-12-01,-11,0,-11
"Cumberland, MD-WV",19060.0,2020-01-01,0,0,0
"Cumberland, MD-WV",19060.0,2020-02-01,0,0,0
"Cumberland, MD-WV",19060.0,2020-03-01,25,0,25
"Cumberland, MD-WV",19060.0,2020-04-01,12,0,12
"Cumberland, MD-WV",19060.0,2020-05-01,21,0,21
"Cumberland, MD-WV",19060.0,2020-06-01,0,0,0
"Cumberland, MD-WV",19060.0,2020-07-01,2,0,2
"Cumberland, MD-WV",19060.0,2020-08-01,0,0,0
"Cumberland, MD-WV",19060.0,2020-09-01,15,0,15
"Cumberland, MD-WV",19060.0,2020-10-01,-27,0,-27
"Cumberland, MD-WV",19060.0,2020-11-01,14,0,14
"Cumberland, MD-WV",19060.0,2020-12-01,12,0,12
"Pittsburgh, PA",38300.0,2019-01-01,-1985,-1665,-320
"Pittsburgh, PA",38300.0,2019-02-01,-349,-137,-212
"Pittsburgh, PA",38300.0,2019-03-01,-39,48,-87
"Pittsburgh, PA",38300.0,2019-04-01,789,726,63
"Pittsburgh, PA",38300.0,2019-05-01,863,897,-34
"Pittsburgh, PA",38300.0,2019-06-01,-264,143,-407
"Pittsburgh, PA",38300.0,2019-07-01,-495,71,-566
"Pittsburgh, PA",38300.0,2019-08-01,-209,0,-209
"Pittsburgh, PA",38300.0,2019-09-01,-202,-69,-133
"Pittsburgh, PA",38300.0,2019-10-01,-796,-662,-134
"Pittsburgh, PA",38300.0,2019-11-01,-658,-531,-127
"Pittsburgh, PA",38300.0,2019-12-01,-1470,-1305,-165
"Pittsburgh, PA",38300.0,2020-01-01,-1800,-1540,-260
"Pittsburgh, PA",38300.0,2020-02-01,-250,-113,-137
"Pittsburgh, PA",38300.0,2020-03-01,100,145,-45
"Pittsburgh, PA",38300.0,2020-04-01,422,281,141
"Pittsburgh, PA",38300.0,2020-05-01,729,595,134
"Pittsburgh, PA",38300.0,2020-06-01,177,482,-305
"Pittsburgh, PA",38300.0,2020-07-01,-485,99,-584
"Pittsburgh, PA",38300.0,2020-08-01,-89,45,-134
"Pittsburgh, PA",38300.0,2020-09-01,-211,0,-211
"Pittsburgh, PA",38300.0,2020-10-01,-866,-497,-369
"Pittsburgh, PA",38300.0,2020-11-01,-796,-641,-155
"Pittsburgh, PA",38300.0,2020-12-01,-1248,-1012,-236
"Fort Wayne, IN",23060.0,2019-01-01,-125,-236,111
"Fort Wayne, IN",23060.0,2019-02-01,-24,-11,-13
"Fort Wayne, IN",23060.0,2019-03-01,47,0,47
"Fort Wayne, IN",23060.0,2019-04-01,305,194,111
"Fort Wayne, IN",23060.0,2019-05-01,237,133,104
"Fort Wayne, IN",23060.0,2019-06-01,75,11,64
"Fort Wayne, IN",23060.0,2019-07-01,43,0,43
"Fort Wayne, IN",23060.0,2019-08-01,-15,0,-15
"Fort Wayne, IN",23060.0,2019-09-01,-28,-14,-14
"Fort Wayne, IN",23060.0,2019-10-01,-184,-197,13
"Fort Wayne, IN",23060.0,2019-11-01,-190,-154,-36
"Fort Wayne, IN",23060.0,2019-12-01,-290,-323,33
"Fort Wayne, IN",23060.0,2020-01-01,-310,-244,-66
"Fort Wayne, IN",23060.0,2020-02-01,-29,-11,-18
"Fort Wayne, IN",23060.0,2020-03-01,96,28,68
"Fort Wayne, IN",23060.0,2020-04-01,122,91,31
"Fort Wayne, IN",23060.0,2020-05-01,180,107,73
"Fort Wayne, IN",23060.0,2020-06-01,89,14,75
"Fort Wayne, IN",23060.0,2020-07-01,104,0,104
"Fort Wayne, IN",23060.0,2020-08-01,2,13,-11
"Fort Wayne, IN",23060.0,2020-09-01,51,0,51
"Fort Wayne, IN",23060.0,2020-10-01,-172,-189,17
"Fort Wayne, IN",23060.0,2020-11-01,-182,-144,-38
"Fort Wayne, IN",23060.0,2020-12-01,-306,-271,-35
"Bowling Green, KY",14540.0,2019-01-01,-34,0,-34
"Bowling Green, KY",14540.0,2019-02-01,-10,0,-10
"Bowling Green, KY",14540.0,2019-03-01,3,0,3
"Bowling Green, KY",14540.0,2019-04-01,21,0,21
"Bowling Green, KY",14540.0,2019-05-01,-5,0,-5
"Bowling Green, KY",14540.0,2019-06-01,-58,0,-58
"Bowling Green, KY",14540.0,2019-07-01,25,0,25
"Bowling Green, KY",14540.0,2019-08-01,27,0,27
"Bowling Green, KY",14540.0,2019-09-01,16,0,16
"Bowling Green, KY",14540.0,2019-10-01,-46,0,-46
"Bowling Green, KY",14540.0,2019-11-01,22,0,22
"Bowling Green, KY",14540.0,2019-12-01,-18,0,-18
"Bowling Green, KY",14540.0,2020-01-01,-34,0,-34
"Bowling Green, KY",14540.0,2020-02-01,-8,0,-8
"Bowling Green, KY",14540.0,2020-03-01,12,0,12
"Bowling Green, KY",14540.0,2020-04-01,35,0,35
"Bowling Green, KY",14540.0,2020-05-01,14,0,14
"Bowling Green, KY",14540.0,2020-06-01,-23,0,-23
"Bowling Green, KY",14540.0,2020-07-01,-6,0,-6
"Bowling Green, KY",14540.0,2020-08-01,40,0,40
"Bowling Green, KY",14540.0,2020-09-01,17,0,17
"Bowling Green, KY",14540.0,2020-10-01,12,0,12
"Bowling Green, KY",14540.0,2020-11-01,38,0,38
"Bowling Green, KY",14540.0,2020-12-01,-7,0,-7
"Lima, OH",30620.0,2019-01-01,5,-11,16
"Lima, OH",30620.0,2019-02-01,33,0,33
"Lima, OH",30620.0,2019-03-01,8,0,8
"Lima, OH",30620.0,2019-04-01,37,28,9
"Lima, OH",30620.0,2019-05-01,68,12,56
"Lima, OH",30620.0,2019-06-01,23,0,23
"Lima, OH",30620.0,2019-07-01,21,0,21
"Lima, OH",30620.0,2019-08-01,-4,0,-4
"Lima, OH",30620.0,2019-09-01,-22,0,-22
"Lima, OH",30620.0,2019-10-01,-34,-40,6
"Lima, OH",30620.0,2019-11-01,-68,-57,-11
"Lima, OH",30620.0,2019-12-01,-74,-53,-21
"Lima, OH",30620.0,2020-01-01,9,-13,22
"Lima, OH",30620.0,2020-02-01,11,0,11
"Lima, OH",30620.0,2020-03-01,21,0,21
"Lima, OH",30620.0,2020-04-01,32,13,19
"Lima, OH",30620.0,2020-05-01,26,17,9
"Lima, OH",30620.0,2020-06-01,13,0,13
"Lima, OH",30620.0,2020-07-01,-34,0,-34
"Lima, OH",30620.0,2020-08-01,-29,0,-29
"Lima, OH",30620.0,2020-09-01,0,0,0
"Lima, OH",30620.0,2020-10-01,-42,-29,-13
"Lima, OH",30620.0,2020-11-01,-9,-12,3
"Lima, OH",30620.0,2020-12-01,-81,-59,-22
"Alpena, MI",10980.0,2019-01-01,0,0,0
"Alpena, MI",10980.0,2019-02-01,0,0,0
"Alpena, MI",10980.0,2019-03-01,0,0,0
"Alpena, MI",10980.0,2019-04-01,44,13,31
"Alpena, MI",10980.0,2019-05-01,25,25,0
"Alpena, MI",10980.0,2019-06-01,29,0,29
"Alpena, MI",10980.0,2019-07-01,-14,0,-14
"Alpena, MI",10980.0,2019-08-01,0,0,0
"Alpena, MI",10980.0,2019-09-01,0,0,0
"Alpena, MI",10980.0,2019-10-01,-47,-47,0
"Alpena, MI",10980.0,2019-11-01,-18,-18,0
"Alpena, MI",10980.0,2019-12-01,-23,-23,0
"Alpena, MI",10980.0,2020-01-01,-11,-11,0
"Alpena, MI",10980.0,2020-02-01,0,0,0
"Alpena, MI",10980.0,2020-03-01,11,0,11
"Alpena, MI",10980.0,2020-04-01,1,0,1
"Alpena, MI",10980.0,2020-05-01,24,11,13
"Alpena, MI",10980.0,2020-06-01,0,0,0
"Alpena, MI",10980.0,2020-07-01,0,0,0
"Alpena, MI",10980.0,2020-08-01,12,0,12
"Alpena, MI",10980.0,2020-09-01,0,0,0
"Alpena, MI",10980.0,2020-10-01,-14,-14,0
"Alpena, MI",10980.0,2020-11-01,-13,-13,0
"Alpena, MI",10980.0,2020-12-01,-35,-23,-12
"Richmond, VA",40060.0,2019-01-01,77,-28,105
"Richmond, VA",40060.0,2019-02-01,100,0,100
"Richmond, VA",40060.0,2019-03-01,81,0,81
"Richmond, VA",40060.0,2019-04-01,84,29,55
"Richmond, VA",40060.0,2019-05-01,132,13,119
"Richmond, VA",40060.0,2019-06-01,216,0,216
"Richmond, VA",40060.0,2019-07-01,260,0,260
"Richmond, VA",40060.0,2019-08-01,291,-23,314
"Richmond, VA",40060.0,2019-09-01,116,0,116
"Richmond, VA",40060.0,2019-10-01,59,0,59
"Richmond, VA",40060.0,2019-11-01,111,0,111
"Richmond, VA",40060.0,2019-12-01,81,-22,103
"Richmond, VA",40060.0,2020-01-01,115,-29,144
"Richmond, VA",40060.0,2020-02-01,84,0,84
"Richmond, VA",40060.0,2020-03-01,268,23,245
"Richmond, VA",40060.0,2020-04-01,206,38,168
"Richmond, VA",40060.0,2020-05-01,230,17,213
"Richmond, VA",40060.0,2020-06-01,273,11,262
"Richmond, VA",40060.0,2020-07-01,275,11,264
"Richmond, VA",40060.0,2020-08-01,397,0,397
"Richmond, VA",40060.0,2020-09-01,308,0,308
"Richmond, VA",40060.0,2020-10-01,216,-11,227
"Richmond, VA",40060.0,2020-11-01,169,0,169
"Richmond, VA",40060.0,2020-12-01,69,-25,94
"Lynchburg, VA",31340.0,2019-01-01,30,0,30
"Lynchburg, VA",31340.0,2019-02-01,-1,0,-1
"Lynchburg, VA",31340.0,2019-03-01,-28,0,-28
"Lynchburg, VA",31340.0,2019-04-01,-3,0,-3
"Lynchburg, VA",31340.0,2019-05-01,-25,0,-25
"Lynchburg, VA",31340.0,2019-06-01,-9,0,-9
"Lynchburg, VA",31340.0,2019-07-01,-45,0,-45
"Lynchburg, VA",31340.0,2019-08-01,5,0,5
"Lynchburg, VA",31340.0,2019-09-01,-18,0,-18
"Lynchburg, VA",31340.0,2019-10-01,-15,0,-15
"Lynchburg, VA",31340.0,2019-11-01,18,0,18
"Lynchburg, VA",31340.0,2019-12-01,-22,-23,1
"Lynchburg, VA",31340.0,2020-01-01,2,0,2
"Lynchburg, VA",31340.0,2020-02-01,-49,0,-49
"Lynchburg, VA",31340.0,2020-03-01,-1,0,-1
"Lynchburg, VA",31340.0,2020-04-01,2,0,2
"Lynchburg, VA",31340.0,2020-05-01,26,12,14
"Lynchburg, VA",31340.0,2020-06-01,19,0,19
"Lynchburg, VA",31340.0,2020-07-01,-44,0,-44
"Lynchburg, VA",31340.0,2020-08-01,34,0,34
"Lynchburg, VA",31340.0,2020-09-01,14,0,14
"Lynchburg, VA",31340.0,2020-10-01,10,0,10
"Lynchburg, VA",31340.0,2020-11-01,-8,0,-8
"Lynchburg, VA",31340.0,2020-12-01,17,0,17
"Anchorage, AK",11260.0,2019-01-01,-165,-126,-39
"Anchorage, AK",11260.0,2019-02-01,-41,-18,-23
"Anchorage, AK",11260.0,2019-03-01,-2,-10,8
"Anchorage, AK",11260.0,2019-04-01,213,186,27
"Anchorage, AK",11260.0,2019-05-01,134,173,-39
"Anchorage, AK",11260.0,2019-06-01,6,6,0
"Anchorage, AK",11260.0,2019-07-01,-113,0,-113
"Anchorage, AK",11260.0,2019-08-01,21,2,19
"Anchorage, AK",11260.0,2019-09-01,-72,-35,-37
"Anchorage, AK",11260.0,2019-10-01,-307,-219,-88
"Anchorage, AK",11260.0,2019-11-01,-131,-113,-18
"Anchorage, AK",11260.0,2019-12-01,-33,-23,-10
"Anchorage, AK",11260.0,2020-01-01,-110,-99,-11
"Anchorage, AK",11260.0,2020-02-01,2,-25,27
"Anchorage, AK",11260.0,2020-03-01,63,64,-1
"Anchorage, AK",11260.0,2020-04-01,76,-8,84
"Anchorage, AK",11260.0,2020-05-01,111,124,-13
"Anchorage, AK",11260.0,2020-06-01,26,40,-14
"Anchorage, AK",11260.0,2020-07-01,-33,-13,-20
"Anchorage, AK",11260.0,2020-08-01,-96,-13,-83
"Anchorage, AK",11260.0,2020-09-01,-106,-42,-64
"Anchorage, AK",11260.0,2020-10-01,-108,-101,-7
"Anchorage, AK",11260.0,2020-11-01,-57,-87,30
"Anchorage, AK",11260.0,2020-12-01,-61,-88,27
"Frankfort, KY",23180.0,2019-01-01,21,0,21
"Frankfort, KY",23180.0,2019-02-01,55,0,55
"Frankfort, KY",23180.0,2019-03-01,-4,0,-4
"Frankfort, KY",23180.0,2019-04-01,-9,0,-9
"Frankfort, KY",23180.0,2019-05-01,16,0,16
"Frankfort, KY",23180.0,2019-06-01,81,0,81
"Frankfort, KY",23180.0,2019-07-01,36,0,36
"Frankfort, KY",23180.0,2019-08-01,-18,0,-18
"Frankfort, KY",23180.0,2019-09-01,30,0,30
"Frankfort, KY",23180.0,2019-10-01,64,0,64
"Frankfort, KY",23180.0,2019-11-01,23,0,23
"Frankfort, KY",23180.0,2019-12-01,4,0,4
"Frankfort, KY",23180.0,2020-01-01,32,0,32
"Frankfort, KY",23180.0,2020-02-01,48,0,48
"Frankfort, KY",23180.0,2020-03-01,50,0,50
"Frankfort, KY",23180.0,2020-04-01,45,0,45
"Frankfort, KY",23180.0,2020-05-01,43,0,43
"Frankfort, KY",23180.0,2020-06-01,27,0,27
"Frankfort, KY",23180.0,2020-07-01,24,0,24
"Frankfort, KY",23180.0,2020-08-01,28,0,28
"Frankfort, KY",23180.0,2020-09-01,14,0,14
"Frankfort, KY",23180.0,2020-10-01,-3,0,-3
"Frankfort, KY",23180.0,2020-11-01,5,0,5
"Frankfort, KY",23180.0,2020-12-01,14,0,14
"Greenville-Anderson, SC",24860.0,2019-01-01,41,0,41
"Greenville-Anderson, SC",24860.0,2019-02-01,93,0,93
"Greenville-Anderson, SC",24860.0,2019-03-01,2,0,2
"Greenville-Anderson, SC",24860.0,2019-04-01,26,11,15
"Greenville-Anderson, SC",24860.0,2019-05-01,40,11,29
"Greenville-Anderson, SC",24860.0,2019-06-01,96,11,85
"Greenville-Anderson, SC",24860.0,2019-07-01,125,9,116
"Greenville-Anderson, SC",24860.0,2019-08-01,255,12,243
"Greenville-Anderson, SC",24860.0,2019-09-01,73,14,59
"Greenville-Anderson, SC",24860.0,2019-10-01,70,2,68
"Greenville-Anderson, SC",24860.0,2019-11-01,46,-9,55
"Greenville-Anderson, SC",24860.0,2019-12-01,156,13,143
"Greenville-Anderson, SC",24860.0,2020-01-01,87,-14,101
"Greenville-Anderson, SC",24860.0,2020-02-01,-68,-17,-51
"Greenville-Anderson, SC",24860.0,2020-03-01,84,20,64
"Greenville-Anderson, SC",24860.0,2020-04-01,83,-11,94
"Greenville-Anderson, SC",24860.0,2020-05-01,47,0,47
"Greenville-Anderson, SC",24860.0,2020-06-01,217,-12,229
"Greenville-Anderson, SC",24860.0,2020-07-01,215,15,200
"Greenville-Anderson, SC",24860.0,2020-08-01,73,0,73
"Greenville-Anderson, SC",24860.0,2020-09-01,214,0,214
"Greenville-Anderson, SC",24860.0,2020-10-01,130,13,117
"Greenville-Anderson, SC",24860.0,2020-11-01,155,11,144
"Greenville-Anderson, SC",24860.0,2020-12-01,158,0,158
"Knoxville, TN",28940.0,2019-01-01,1,0,1
"Knoxville, TN",28940.0,2019-02-01,64,0,64
"Knoxville, TN",28940.0,2019-03-01,-89,0,-89
"Knoxville, TN",28940.0,2019-04-01,39,0,39
"Knoxville, TN",28940.0,2019-05-01,-48,0,-48
"Knoxville, TN",28940.0,2019-06-01,-63,0,-63
"Knoxville, TN",28940.0,2019-07-01,-4,0,-4
"Knoxville, TN",28940.0,2019-08-01,16,0,16
"Knoxville, TN",28940.0,2019-09-01,53,0,53
"Knoxville, TN",28940.0,2019-10-01,52,-12,64
"Knoxville, TN",28940.0,2019-11-01,75,0,75
"Knoxville, TN",28940.0,2019-12-01,-58,-26,-32
"Knoxville, TN",28940.0,2020-01-01,-34,-12,-22
"Knoxville, TN",28940.0,2020-02-01,57,0,57
"Knoxville, TN",28940.0,2020-03-01,80,0,80
"Knoxville, TN",28940.0,2020-04-01,17,0,17
"Knoxville, TN",28940.0,2020-05-01,1,0,1
"Knoxville, TN",28940.0,2020-06-01,47,0,47
"Knoxville, TN",28940.0,2020-07-01,43,0,43
"Knoxville, TN",28940.0,2020-08-01,124,0,124
"Knoxville, TN",28940.0,2020-09-01,34,0,34
"Knoxville, TN",28940.0,2020-10-01,118,0,118
"Knoxville, TN",28940.0,2020-11-01,49,0,49
"Knoxville, TN",28940.0,2020-12-01,34,-24,58
"Palestine, TX",37300.0,2019-01-01,18,0,18
"Palestine, TX",37300.0,2019-02-01,-31,0,-31
"Palestine, TX",37300.0,2019-03-01,3,0,3
"Palestine, TX",37300.0,2019-04-01,-13,0,-13
"Palestine, TX",37300.0,2019-05-01,30,0,30
"Palestine, TX",37300.0,2019-06-01,0,0,0
"Palestine, TX",37300.0,2019-07-01,24,0,24
"Palestine, TX",37300.0,2019-08-01,-33,0,-33
"Palestine, TX",37300.0,2019-09-01,-20,0,-20
"Palestine, TX",37300.0,2019-10-01,26,0,26
"Palestine, TX",37300.0,2019-11-01,30,0,30
"Palestine, TX",37300.0,2019-12-01,2,0,2
"Palestine, TX",37300.0,2020-01-01,-22,0,-22
"Palestine, TX",37300.0,2020-02-01,0,0,0
"Palestine, TX",37300.0,2020-03-01,18,0,18
"Palestine, TX",37300.0,2020-04-01,-23,0,-23
"Palestine, TX",37300.0,2020-05-01,-16,0,-16
"Palestine, TX",37300.0,2020-06-01,-16,0,-16
"Palestine, TX",37300.0,2020-07-01,-3,0,-3
"Palestine, TX",37300.0,2020-08-01,27,0,27
"Palestine, TX",37300.0,2020-09-01,44,0,44
"Palestine, TX",37300.0,2020-10-01,6,0,6
"Palestine, TX",37300.0,2020-11-01,19,0,19
"Palestine, TX",37300.0,2020-12-01,21,0,21
"St. Joseph, MO-KS",41140.0,2019-01-01,-35,0,-35
"St. Joseph, MO-KS",41140.0,2019-02-01,8,0,8
"St. Joseph, MO-KS",41140.0,2019-03-01,-31,0,-31
"St. Joseph, MO-KS",41140.0,2019-04-01,-61,0,-61
"St. Joseph, MO-KS",41140.0,2019-05-01,-28,0,-28
"St. Joseph, MO-KS",41140.0,2019-06-01,-43,0,-43
"St. Joseph, MO-KS",41140.0,2019-07-01,-80,0,-80
"St. Joseph, MO-KS",41140.0,2019-08-01,-50,0,-50
"St. Joseph, MO-KS",41140.0,2019-09-01,-38,0,-38
"St. Joseph, MO-KS",41140.0,2019-10-01,-40,0,-40
"St. Joseph, MO-KS",41140.0,2019-11-01,-33,0,-33
"St. Joseph, MO-KS",41140.0,2019-12-01,-20,0,-20
"St. Joseph, MO-KS",41140.0,2020-01-01,-7,0,-7
"St. Joseph, MO-KS",41140.0,2020-02-01,-56,0,-56
"St. Joseph, MO-KS",41140.0,2020-03-01,-60,0,-60
"St. Joseph, MO-KS",41140.0,2020-04-01,-32,0,-32
"St. Joseph, MO-KS",41140.0,2020-05-01,-4,0,-4
"St. Joseph, MO-KS",41140.0,2020-06-01,-6,0,-6
"St. Joseph, MO-KS",41140.0,2020-07-01,-31,0,-31
"St. Joseph, MO-KS",41140.0,2020-08-01,-17,0,-17
"St. Joseph, MO-KS",41140.0,2020-09-01,-17,0,-17
"St. Joseph, MO-KS",41140.0,2020-10-01,-48,0,-48
"St. Joseph, MO-KS",41140.0,2020-11-01,-14,0,-14
"St. Joseph, MO-KS",41140.0,2020-12-01,-11,0,-11
"Andrews, TX",11380.0,2019-01-01,0,0,0
"Andrews, TX",11380.0,2019-02-01,0,0,0
"Andrews, TX",11380.0,2019-03-01,12,0,12
"Andrews, TX",11380.0,2019-04-01,-17,0,-17
"Andrews, TX",11380.0,2019-05-01,0,0,0
"Andrews, TX",11380.0,2019-06-01,0,0,0
"Andrews, TX",11380.0,2019-07-01,0,0,0
"Andrews, TX",11380.0,2019-08-01,-11,0,-11
"Andrews, TX",11380.0,2019-09-01,0,0,0
"Andrews, TX",11380.0,2019-10-01,0,0,0
"Andrews, TX",11380.0,2019-11-01,-13,0,-13
"Andrews, TX",11380.0,2019-12-01,0,0,0
"Andrews, TX",11380.0,2020-01-01,0,0,0
"Andrews, TX",11380.0,2020-02-01,0,0,0
"Andrews, TX",11380.0,2020-03-01,-11,0,-11
"Andrews, TX",11380.0,2020-04-01,0,0,0
"Andrews, TX",11380.0,2020-05-01,0,0,0
"Andrews, TX",11380.0,2020-06-01,0,0,0
"Andrews, TX",11380.0,2020-07-01,0,0,0
"Andrews, TX",11380.0,2020-08-01,0,0,0
"Andrews, TX",11380.0,2020-09-01,0,0,0
"Andrews, TX",11380.0,2020-10-01,0,0,0
"Andrews, TX",11380.0,2020-11-01,11,0,11
"Andrews, TX",11380.0,2020-12-01,11,0,11
"Lewiston-Auburn, ME",30340.0,2019-01-01,-4,-14,10
"Lewiston-Auburn, ME",30340.0,2019-02-01,-16,0,-16
"Lewiston-Auburn, ME",30340.0,2019-03-01,33,0,33
"Lewiston-Auburn, ME",30340.0,2019-04-01,88,34,54
"Lewiston-Auburn, ME",30340.0,2019-05-01,186,118,68
"Lewiston-Auburn, ME",30340.0,2019-06-01,48,11,37
"Lewiston-Auburn, ME",30340.0,2019-07-01,111,0,111
"Lewiston-Auburn, ME",30340.0,2019-08-01,53,0,53
"Lewiston-Auburn, ME",30340.0,2019-09-01,-14,0,-14
"Lewiston-Auburn, ME",30340.0,2019-10-01,-118,-109,-9
"Lewiston-Auburn, ME",30340.0,2019-11-01,52,-32,84
"Lewiston-Auburn, ME",30340.0,2019-12-01,-60,-57,-3
"Lewiston-Auburn, ME",30340.0,2020-01-01,-48,-28,-20
"Lewiston-Auburn, ME",30340.0,2020-02-01,13,0,13
"Lewiston-Auburn, ME",30340.0,2020-03-01,62,30,32
"Lewiston-Auburn, ME",30340.0,2020-04-01,62,22,40
"Lewiston-Auburn, ME",30340.0,2020-05-01,93,60,33
"Lewiston-Auburn, ME",30340.0,2020-06-01,-4,12,-16
"Lewiston-Auburn, ME",30340.0,2020-07-01,7,0,7
"Lewiston-Auburn, ME",30340.0,2020-08-01,12,0,12
"Lewiston-Auburn, ME",30340.0,2020-09-01,-60,0,-60
"Lewiston-Auburn, ME",30340.0,2020-10-01,-43,-44,1
"Lewiston-Auburn, ME",30340.0,2020-11-01,-26,-30,4
"Lewiston-Auburn, ME",30340.0,2020-12-01,-25,-22,-3
"Lufkin, TX",31260.0,2019-01-01,-6,0,-6
"Lufkin, TX",31260.0,2019-02-01,-11,0,-11
"Lufkin, TX",31260.0,2019-03-01,40,0,40
"Lufkin, TX",31260.0,2019-04-01,-5,0,-5
"Lufkin, TX",31260.0,2019-05-01,11,0,11
"Lufkin, TX",31260.0,2019-06-01,1,0,1
"Lufkin, TX",31260.0,2019-07-01,4,0,4
"Lufkin, TX",31260.0,2019-08-01,-9,0,-9
"Lufkin, TX",31260.0,2019-09-01,15,0,15
"Lufkin, TX",31260.0,2019-10-01,6,0,6
"Lufkin, TX",31260.0,2019-11-01,-6,0,-6
"Lufkin, TX",31260.0,2019-12-01,2,0,2
"Lufkin, TX",31260.0,2020-01-01,23,0,23
"Lufkin, TX",31260.0,2020-02-01,-2,0,-2
"Lufkin, TX",31260.0,2020-03-01,8,0,8
"Lufkin, TX",31260.0,2020-04-01,-3,0,-3
"Lufkin, TX",31260.0,2020-05-01,13,0,13
"Lufkin, TX",31260.0,2020-06-01,-3,0,-3
"Lufkin, TX",31260.0,2020-07-01,-3,0,-3
"Lufkin, TX",31260.0,2020-08-01,3,0,3
"Lufkin, TX",31260.0,2020-09-01,21,0,21
"Lufkin, TX",31260.0,2020-10-01,21,0,21
"Lufkin, TX",31260.0,2020-11-01,32,0,32
"Lufkin, TX",31260.0,2020-12-01,-6,0,-6
"Baltimore-Columbia-Towson, MD",12580.0,2019-01-01,-641,-393,-248
"Baltimore-Columbia-Towson, MD",12580.0,2019-02-01,-85,-13,-72
"Baltimore-Columbia-Towson, MD",12580.0,2019-03-01,-66,12,-78
"Baltimore-Columbia-Towson, MD",12580.0,2019-04-01,558,470,88
"Baltimore-Columbia-Towson, MD",12580.0,2019-05-01,-422,590,-1012
"Baltimore-Columbia-Towson, MD",12580.0,2019-06-01,-658,57,-715
"Baltimore-Columbia-Towson, MD",12580.0,2019-07-01,-336,22,-358
"Baltimore-Columbia-Towson, MD",12580.0,2019-08-01,-66,-3,-63
"Baltimore-Columbia-Towson, MD",12580.0,2019-09-01,-71,-7,-64
"Baltimore-Columbia-Towson, MD",12580.0,2019-10-01,-609,-249,-360
"Baltimore-Columbia-Towson, MD",12580.0,2019-11-01,-44,-145,101
"Baltimore-Columbia-Towson, MD",12580.0,2019-12-01,-288,-445,157
"Baltimore-Columbia-Towson, MD",12580.0,2020-01-01,-518,-431,-87
"Baltimore-Columbia-Towson, MD",12580.0,2020-02-01,-81,0,-81
"Baltimore-Columbia-Towson, MD",12580.0,2020-03-01,371,302,69
"Baltimore-Columbia-Towson, MD",12580.0,2020-04-01,307,250,57
"Baltimore-Columbia-Towson, MD",12580.0,2020-05-01,-102,406,-508
"Baltimore-Columbia-Towson, MD",12580.0,2020-06-01,418,357,61
"Baltimore-Columbia-Towson, MD",12580.0,2020-07-01,337,140,197
"Baltimore-Columbia-Towson, MD",12580.0,2020-08-01,353,17,336
"Baltimore-Columbia-Towson, MD",12580.0,2020-09-01,318,64,254
"Baltimore-Columbia-Towson, MD",12580.0,2020-10-01,-92,-233,141
"Baltimore-Columbia-Towson, MD",12580.0,2020-11-01,133,-136,269
"Baltimore-Columbia-Towson, MD",12580.0,2020-12-01,-48,-295,247
"Minneapolis-St. Paul-Bloomington, MN-WI",33460.0,2019-01-01,-4062,-4180,118
"Minneapolis-St. Paul-Bloomington, MN-WI",33460.0,2019-02-01,-766,-718,-48
"Minneapolis-St. Paul-Bloomington, MN-WI",33460.0,2019-03-01,191,-154,345
"Minneapolis-St. Paul-Bloomington, MN-WI",33460.0,2019-04-01,4328,2860,1468
"Minneapolis-St. Paul-Bloomington, MN-WI",33460.0,2019-05-01,4080,3566,514
"Minneapolis-St. Paul-Bloomington, MN-WI",33460.0,2019-06-01,508,552,-44
"Minneapolis-St. Paul-Bloomington, MN-WI",33460.0,2019-07-01,-69,147,-216
"Minneapolis-St. Paul-Bloomington, MN-WI",33460.0,2019-08-01,-728,28,-756
"Minneapolis-St. Paul-Bloomington, MN-WI",33460.0,2019-09-01,-1167,-262,-905
"Minneapolis-St. Paul-Bloomington, MN-WI",33460.0,2019-10-01,-4845,-4114,-731
"Minneapolis-St. Paul-Bloomington, MN-WI",33460.0,2019-11-01,-2581,-2357,-224
"Minneapolis-St. Paul-Bloomington, MN-WI",33460.0,2019-12-01,-4793,-4624,-169
"Minneapolis-St. Paul-Bloomington, MN-WI",33460.0,2020-01-01,-4715,-4396,-319
"Minneapolis-St. Paul-Bloomington, MN-WI",33460.0,2020-02-01,-1045,-712,-333
"Minneapolis-St. Paul-Bloomington, MN-WI",33460.0,2020-03-01,1826,293,1533
"Minneapolis-St. Paul-Bloomington, MN-WI",33460.0,2020-04-01,1720,1017,703
"Minneapolis-St. Paul-Bloomington, MN-WI",33460.0,2020-05-01,3144,2442,702
"Minneapolis-St. Paul-Bloomington, MN-WI",33460.0,2020-06-01,910,878,32
"Minneapolis-St. Paul-Bloomington, MN-WI",33460.0,2020-07-01,81,277,-196
"Minneapolis-St. Paul-Bloomington, MN-WI",33460.0,2020-08-01,-1000,46,-1046
"Minneapolis-St. Paul-Bloomington, MN-WI",33460.0,2020-09-01,-1416,-279,-1137
"Minneapolis-St. Paul-Bloomington, MN-WI",33460.0,2020-10-01,-5173,-3946,-1227
"Minneapolis-St. Paul-Bloomington, MN-WI",33460.0,2020-11-01,-3658,-3141,-517
"Minneapolis-St. Paul-Bloomington, MN-WI",33460.0,2020-12-01,-4298,-3918,-380
"Charlotte-Concord-Gastonia, NC-SC",16740.0,2019-01-01,409,0,409
"Charlotte-Concord-Gastonia, NC-SC",16740.0,2019-02-01,387,0,387
"Charlotte-Concord-Gastonia, NC-SC",16740.0,2019-03-01,95,0,95
"Charlotte-Concord-Gastonia, NC-SC",16740.0,2019-04-01,236,55,181
"Charlotte-Concord-Gastonia, NC-SC",16740.0,2019-05-01,520,61,459
"Charlotte-Concord-Gastonia, NC-SC",16740.0,2019-06-01,341,0,341
"Charlotte-Concord-Gastonia, NC-SC",16740.0,2019-07-01,517,-13,530
"Charlotte-Concord-Gastonia, NC-SC",16740.0,2019-08-01,833,-11,844
"Charlotte-Concord-Gastonia, NC-SC",16740.0,2019-09-01,419,0,419
"Charlotte-Concord-Gastonia, NC-SC",16740.0,2019-10-01,494,15,479
"Charlotte-Concord-Gastonia, NC-SC",16740.0,2019-11-01,406,0,406
"Charlotte-Concord-Gastonia, NC-SC",16740.0,2019-12-01,335,-29,364
"Charlotte-Concord-Gastonia, NC-SC",16740.0,2020-01-01,465,-13,478
"Charlotte-Concord-Gastonia, NC-SC",16740.0,2020-02-01,306,0,306
"Charlotte-Concord-Gastonia, NC-SC",16740.0,2020-03-01,701,0,701
"Charlotte-Concord-Gastonia, NC-SC",16740.0,2020-04-01,339,81,258
"Charlotte-Concord-Gastonia, NC-SC",16740.0,2020-05-01,698,46,652
"Charlotte-Concord-Gastonia, NC-SC",16740.0,2020-06-01,878,26,852
"Charlotte-Concord-Gastonia, NC-SC",16740.0,2020-07-01,895,-10,905
"Charlotte-Concord-Gastonia, NC-SC",16740.0,2020-08-01,768,38,730
"Charlotte-Concord-Gastonia, NC-SC",16740.0,2020-09-01,346,37,309
"Charlotte-Concord-Gastonia, NC-SC",16740.0,2020-10-01,586,40,546
"Charlotte-Concord-Gastonia, NC-SC",16740.0,2020-11-01,214,-16,230
"Charlotte-Concord-Gastonia, NC-SC",16740.0,2020-12-01,467,-32,499
"Rockport, TX",40530.0,2019-01-01,23,0,23
"Rockport, TX",40530.0,2019-02-01,35,0,35
"Rockport, TX",40530.0,2019-03-01,36,0,36
"Rockport, TX",40530.0,2019-04-01,9,0,9
"Rockport, TX",40530.0,2019-05-01,18,0,18
"Rockport, TX",40530.0,2019-06-01,10,0,10
"Rockport, TX",40530.0,2019-07-01,41,0,41
"Rockport, TX",40530.0,2019-08-01,23,0,23
"Rockport, TX",40530.0,2019-09-01,8,0,8
"Rockport, TX",40530.0,2019-10-01,11,0,11
"Rockport, TX",40530.0,2019-11-01,3,0,3
"Rockport, TX",40530.0,2019-12-01,31,0,31
"Rockport, TX",40530.0,2020-01-01,24,0,24
"Rockport, TX",40530.0,2020-02-01,26,0,26
"Rockport, TX",40530.0,2020-03-01,68,0,68
"Rockport, TX",40530.0,2020-04-01,29,0,29
"Rockport, TX",40530.0,2020-05-01,50,0,50
"Rockport, TX",40530.0,2020-06-01,55,0,55
"Rockport, TX",40530.0,2020-07-01,18,0,18
"Rockport, TX",40530.0,2020-08-01,20,0,20
"Rockport, TX",40530.0,2020-09-01,12,0,12
"Rockport, TX",40530.0,2020-10-01,26,0,26
"Rockport, TX",40530.0,2020-11-01,18,0,18
"Rockport, TX",40530.0,2020-12-01,19,0,19
"Wichita Falls, TX",48660.0,2019-01-01,-539,0,-539
"Wichita Falls, TX",48660.0,2019-02-01,-621,0,-621
"Wichita Falls, TX",48660.0,2019-03-01,-931,0,-931
"Wichita Falls, TX",48660.0,2019-04-01,-758,0,-758
"Wichita Falls, TX",48660.0,2019-05-01,-720,0,-720
"Wichita Falls, TX",48660.0,2019-06-01,-763,0,-763
"Wichita Falls, TX",48660.0,2019-07-01,-685,0,-685
"Wichita Falls, TX",48660.0,2019-08-01,-927,0,-927
"Wichita Falls, TX",48660.0,2019-09-01,-634,0,-634
"Wichita Falls, TX",48660.0,2019-10-01,-736,0,-736
"Wichita Falls, TX",48660.0,2019-11-01,-642,0,-642
"Wichita Falls, TX",48660.0,2019-12-01,-681,0,-681
"Wichita Falls, TX",48660.0,2020-01-01,-619,0,-619
"Wichita Falls, TX",48660.0,2020-02-01,-682,0,-682
"Wichita Falls, TX",48660.0,2020-03-01,-903,0,-903
"Wichita Falls, TX",48660.0,2020-04-01,-1005,-12,-993
"Wichita Falls, TX",48660.0,2020-05-01,-760,0,-760
"Wichita Falls, TX",48660.0,2020-06-01,-669,0,-669
"Wichita Falls, TX",48660.0,2020-07-01,-459,0,-459
"Wichita Falls, TX",48660.0,2020-08-01,-284,0,-284
"Wichita Falls, TX",48660.0,2020-09-01,-382,0,-382
"Wichita Falls, TX",48660.0,2020-10-01,-399,0,-399
"Wichita Falls, TX",48660.0,2020-11-01,-366,0,-366
"Wichita Falls, TX",48660.0,2020-12-01,-373,0,-373
"Arecibo, PR",11640.0,2019-01-01,0,0,0
"Arecibo, PR",11640.0,2019-02-01,0,0,0
"Arecibo, PR",11640.0,2019-03-01,0,0,0
"Arecibo, PR",11640.0,2019-04-01,0,0,0
"Arecibo, PR",11640.0,2019-05-01,0,0,0
"Arecibo, PR",11640.0,2019-06-01,0,0,0
"Arecibo, PR",11640.0,2019-07-01,0,0,0
"Arecibo, PR",11640.0,2019-08-01,0,0,0
"Arecibo, PR",11640.0,2019-09-01,0,0,0
"Arecibo, PR",11640.0,2019-10-01,0,0,0
"Arecibo, PR",11640.0,2019-11-01,0,0,0
"Arecibo, PR",11640.0,2020-01-01,0,0,0
"Arecibo, PR",11640.0,2020-02-01,0,0,0
"Arecibo, PR",11640.0,2020-03-01,0,0,0
"Arecibo, PR",11640.0,2020-04-01,0,0,0
"Arecibo, PR",11640.0,2020-05-01,0,0,0
"Arecibo, PR",11640.0,2020-06-01,0,0,0
"Arecibo, PR",11640.0,2020-07-01,0,0,0
"Arecibo, PR",11640.0,2020-08-01,0,0,0
"Arecibo, PR",11640.0,2020-09-01,0,0,0
"Arecibo, PR",11640.0,2020-10-01,0,0,0
"Arecibo, PR",11640.0,2020-11-01,0,0,0
"Arecibo, PR",11640.0,2020-12-01,0,0,0
"Baton Rouge, LA",12940.0,2019-01-01,-55,0,-55
"Baton Rouge, LA",12940.0,2019-02-01,-38,-11,-27
"Baton Rouge, LA",12940.0,2019-03-01,29,0,29
"Baton Rouge, LA",12940.0,2019-04-01,21,0,21
"Baton Rouge, LA",12940.0,2019-05-01,-127,0,-127
"Baton Rouge, LA",12940.0,2019-06-01,-91,0,-91
"Baton Rouge, LA",12940.0,2019-07-01,-165,0,-165
"Baton Rouge, LA",12940.0,2019-08-01,-91,0,-91
"Baton Rouge, LA",12940.0,2019-09-01,12,0,12
"Baton Rouge, LA",12940.0,2019-10-01,-49,0,-49
"Baton Rouge, LA",12940.0,2019-11-01,-8,0,-8
"Baton Rouge, LA",12940.0,2019-12-01,7,0,7
"Baton Rouge, LA",12940.0,2020-01-01,-81,0,-81
"Baton Rouge, LA",12940.0,2020-02-01,-86,0,-86
"Baton Rouge, LA",12940.0,2020-03-01,93,0,93
"Baton Rouge, LA",12940.0,2020-04-01,14,0,14
"Baton Rouge, LA",12940.0,2020-05-01,-50,0,-50
"Baton Rouge, LA",12940.0,2020-06-01,-54,0,-54
"Baton Rouge, LA",12940.0,2020-07-01,50,0,50
"Baton Rouge, LA",12940.0,2020-08-01,16,24,-8
"Baton Rouge, LA",12940.0,2020-09-01,157,39,118
"Baton Rouge, LA",12940.0,2020-10-01,52,0,52
"Baton Rouge, LA",12940.0,2020-11-01,-5,0,-5
"Baton Rouge, LA",12940.0,2020-12-01,54,0,54
"Ashland, OH",11740.0,2019-01-01,22,0,22
"Ashland, OH",11740.0,2019-02-01,-9,0,-9
"Ashland, OH",11740.0,2019-03-01,-5,0,-5
"Ashland, OH",11740.0,2019-04-01,-6,11,-17
"Ashland, OH",11740.0,2019-05-01,-9,0,-9
"Ashland, OH",11740.0,2019-06-01,22,0,22
"Ashland, OH",11740.0,2019-07-01,12,0,12
"Ashland, OH",11740.0,2019-08-01,-4,0,-4
"Ashland, OH",11740.0,2019-09-01,-3,0,-3
"Ashland, OH",11740.0,2019-10-01,7,-11,18
"Ashland, OH",11740.0,2019-11-01,-40,-11,-29
"Ashland, OH",11740.0,2019-12-01,-8,-14,6
"Ashland, OH",11740.0,2020-01-01,-18,0,-18
"Ashland, OH",11740.0,2020-02-01,2,0,2
"Ashland, OH",11740.0,2020-03-01,-59,0,-59
"Ashland, OH",11740.0,2020-04-01,7,0,7
"Ashland, OH",11740.0,2020-05-01,-31,0,-31
"Ashland, OH",11740.0,2020-06-01,-19,0,-19
"Ashland, OH",11740.0,2020-07-01,-34,0,-34
"Ashland, OH",11740.0,2020-08-01,17,0,17
"Ashland, OH",11740.0,2020-09-01,3,0,3
"Ashland, OH",11740.0,2020-10-01,-52,-16,-36
"Ashland, OH",11740.0,2020-11-01,-29,-11,-18
"Ashland, OH",11740.0,2020-12-01,8,-14,22
"Ashtabula, OH",11780.0,2019-01-01,-52,-13,-39
"Ashtabula, OH",11780.0,2019-02-01,-24,0,-24
"Ashtabula, OH",11780.0,2019-03-01,2,0,2
"Ashtabula, OH",11780.0,2019-04-01,7,38,-31
"Ashtabula, OH",11780.0,2019-05-01,87,89,-2
"Ashtabula, OH",11780.0,2019-06-01,23,0,23
"Ashtabula, OH",11780.0,2019-07-01,47,0,47
"Ashtabula, OH",11780.0,2019-08-01,-5,0,-5
"Ashtabula, OH",11780.0,2019-09-01,-19,0,-19
"Ashtabula, OH",11780.0,2019-10-01,-67,-55,-12
"Ashtabula, OH",11780.0,2019-11-01,-84,-61,-23
"Ashtabula, OH",11780.0,2019-12-01,-73,-44,-29
"Ashtabula, OH",11780.0,2020-01-01,-44,-14,-30
"Ashtabula, OH",11780.0,2020-02-01,-39,0,-39
"Ashtabula, OH",11780.0,2020-03-01,-3,0,-3
"Ashtabula, OH",11780.0,2020-04-01,9,0,9
"Ashtabula, OH",11780.0,2020-05-01,36,23,13
"Ashtabula, OH",11780.0,2020-06-01,15,11,4
"Ashtabula, OH",11780.0,2020-07-01,-54,0,-54
"Ashtabula, OH",11780.0,2020-08-01,18,0,18
"Ashtabula, OH",11780.0,2020-09-01,26,0,26
"Ashtabula, OH",11780.0,2020-10-01,-51,-38,-13
"Ashtabula, OH",11780.0,2020-11-01,31,-13,44
"Ashtabula, OH",11780.0,2020-12-01,3,-13,16
"Lewiston, ID-WA",30300.0,2019-01-01,39,0,39
"Lewiston, ID-WA",30300.0,2019-02-01,41,0,41
"Lewiston, ID-WA",30300.0,2019-03-01,5,0,5
"Lewiston, ID-WA",30300.0,2019-04-01,1,0,1
"Lewiston, ID-WA",30300.0,2019-05-01,-20,0,-20
"Lewiston, ID-WA",30300.0,2019-06-01,-8,0,-8
"Lewiston, ID-WA",30300.0,2019-07-01,10,0,10
"Lewiston, ID-WA",30300.0,2019-08-01,-3,0,-3
"Lewiston, ID-WA",30300.0,2019-09-01,10,0,10
"Lewiston, ID-WA",30300.0,2019-10-01,3,0,3
"Lewiston, ID-WA",30300.0,2019-11-01,25,0,25
"Lewiston, ID-WA",30300.0,2019-12-01,-11,0,-11
"Lewiston, ID-WA",30300.0,2020-01-01,16,0,16
"Lewiston, ID-WA",30300.0,2020-02-01,0,0,0
"Lewiston, ID-WA",30300.0,2020-03-01,-19,0,-19
"Lewiston, ID-WA",30300.0,2020-04-01,6,0,6
"Lewiston, ID-WA",30300.0,2020-05-01,-1,0,-1
"Lewiston, ID-WA",30300.0,2020-06-01,4,0,4
"Lewiston, ID-WA",30300.0,2020-07-01,-29,0,-29
"Lewiston, ID-WA",30300.0,2020-08-01,-10,0,-10
"Lewiston, ID-WA",30300.0,2020-09-01,-17,0,-17
"Lewiston, ID-WA",30300.0,2020-10-01,21,-11,32
"Lewiston, ID-WA",30300.0,2020-11-01,-4,0,-4
"Lewiston, ID-WA",30300.0,2020-12-01,-34,-11,-23
"San Antonio-New Braunfels, TX",41700.0,2019-01-01,380,-4,384
"San Antonio-New Braunfels, TX",41700.0,2019-02-01,236,0,236
"San Antonio-New Braunfels, TX",41700.0,2019-03-01,462,-1,463
"San Antonio-New Braunfels, TX",41700.0,2019-04-01,311,-13,324
"San Antonio-New Braunfels, TX",41700.0,2019-05-01,997,3,994
"San Antonio-New Braunfels, TX",41700.0,2019-06-01,738,3,735
"San Antonio-New Braunfels, TX",41700.0,2019-07-01,1013,-25,1038
"San Antonio-New Braunfels, TX",41700.0,2019-08-01,561,3,558
"San Antonio-New Braunfels, TX",41700.0,2019-09-01,255,-12,267
"San Antonio-New Braunfels, TX",41700.0,2019-10-01,137,2,135
"San Antonio-New Braunfels, TX",41700.0,2019-11-01,333,0,333
"San Antonio-New Braunfels, TX",41700.0,2019-12-01,175,-11,186
"San Antonio-New Braunfels, TX",41700.0,2020-01-01,37,-141,178
"San Antonio-New Braunfels, TX",41700.0,2020-02-01,44,-11,55
"San Antonio-New Braunfels, TX",41700.0,2020-03-01,517,34,483
"San Antonio-New Braunfels, TX",41700.0,2020-04-01,424,42,382
"San Antonio-New Braunfels, TX",41700.0,2020-05-01,676,57,619
"San Antonio-New Braunfels, TX",41700.0,2020-06-01,748,-7,755
"San Antonio-New Braunfels, TX",41700.0,2020-07-01,980,-6,986
"San Antonio-New Braunfels, TX",41700.0,2020-08-01,818,16,802
"San Antonio-New Braunfels, TX",41700.0,2020-09-01,686,-11,697
"San Antonio-New Braunfels, TX",41700.0,2020-10-01,578,25,553
"San Antonio-New Braunfels, TX",41700.0,2020-11-01,660,28,632
"San Antonio-New Braunfels, TX",41700.0,2020-12-01,776,5,771
"Atchison, KS",11860.0,2019-01-01,-12,0,-12
"Atchison, KS",11860.0,2019-02-01,0,0,0
"Atchison, KS",11860.0,2019-03-01,0,0,0
"Atchison, KS",11860.0,2019-04-01,0,0,0
"Atchison, KS",11860.0,2019-05-01,0,0,0
"Atchison, KS",11860.0,2019-06-01,0,0,0
"Atchison, KS",11860.0,2019-07-01,-23,0,-23
"Atchison, KS",11860.0,2019-08-01,0,0,0
"Atchison, KS",11860.0,2019-09-01,0,0,0
"Atchison, KS",11860.0,2019-10-01,0,0,0
"Atchison, KS",11860.0,2019-11-01,0,0,0
"Atchison, KS",11860.0,2019-12-01,0,0,0
"Atchison, KS",11860.0,2020-01-01,0,0,0
"Atchison, KS",11860.0,2020-02-01,11,0,11
"Atchison, KS",11860.0,2020-03-01,-12,0,-12
"Atchison, KS",11860.0,2020-04-01,0,0,0
"Atchison, KS",11860.0,2020-05-01,0,0,0
"Atchison, KS",11860.0,2020-06-01,-11,0,-11
"Atchison, KS",11860.0,2020-07-01,0,0,0
"Atchison, KS",11860.0,2020-08-01,0,0,0
"Atchison, KS",11860.0,2020-09-01,0,0,0
"Atchison, KS",11860.0,2020-10-01,0,0,0
"Atchison, KS",11860.0,2020-11-01,0,0,0
"Atchison, KS",11860.0,2020-12-01,16,0,16
"Athens, OH",11900.0,2019-01-01,6,0,6
"Athens, OH",11900.0,2019-02-01,-49,0,-49
"Athens, OH",11900.0,2019-03-01,-13,0,-13
"Athens, OH",11900.0,2019-04-01,0,0,0
"Athens, OH",11900.0,2019-05-01,-77,0,-77
"Athens, OH",11900.0,2019-06-01,-21,0,-21
"Athens, OH",11900.0,2019-07-01,-57,0,-57
"Athens, OH",11900.0,2019-08-01,5,0,5
"Athens, OH",11900.0,2019-09-01,21,0,21
"Athens, OH",11900.0,2019-10-01,3,0,3
"Athens, OH",11900.0,2019-11-01,-15,0,-15
"Athens, OH",11900.0,2019-12-01,-32,0,-32
"Athens, OH",11900.0,2020-01-01,-3,0,-3
"Athens, OH",11900.0,2020-02-01,-19,0,-19
"Athens, OH",11900.0,2020-03-01,-13,0,-13
"Athens, OH",11900.0,2020-04-01,-12,0,-12
"Athens, OH",11900.0,2020-05-01,-72,0,-72
"Athens, OH",11900.0,2020-06-01,-13,0,-13
"Athens, OH",11900.0,2020-07-01,-44,0,-44
"Athens, OH",11900.0,2020-08-01,-5,0,-5
"Athens, OH",11900.0,2020-09-01,40,0,40
"Athens, OH",11900.0,2020-10-01,2,0,2
"Athens, OH",11900.0,2020-11-01,-7,0,-7
"Athens, OH",11900.0,2020-12-01,6,0,6
"Douglas, GA",20060.0,2019-01-01,-14,0,-14
"Douglas, GA",20060.0,2019-02-01,0,0,0
"Douglas, GA",20060.0,2019-03-01,0,0,0
"Douglas, GA",20060.0,2019-04-01,0,0,0
"Douglas, GA",20060.0,2019-05-01,0,0,0
"Douglas, GA",20060.0,2019-06-01,0,0,0
"Douglas, GA",20060.0,2019-07-01,0,0,0
"Douglas, GA",20060.0,2019-08-01,0,0,0
"Douglas, GA",20060.0,2019-09-01,-13,0,-13
"Douglas, GA",20060.0,2019-10-01,-12,0,-12
"Douglas, GA",20060.0,2019-11-01,-13,0,-13
"Douglas, GA",20060.0,2019-12-01,0,0,0
"Douglas, GA",20060.0,2020-01-01,11,0,11
"Douglas, GA",20060.0,2020-02-01,0,0,0
"Douglas, GA",20060.0,2020-03-01,0,0,0
"Douglas, GA",20060.0,2020-04-01,-25,0,-25
"Douglas, GA",20060.0,2020-05-01,-12,0,-12
"Douglas, GA",20060.0,2020-06-01,0,0,0
"Douglas, GA",20060.0,2020-07-01,0,0,0
"Douglas, GA",20060.0,2020-08-01,0,0,0
"Douglas, GA",20060.0,2020-09-01,0,0,0
"Douglas, GA",20060.0,2020-10-01,0,0,0
"Douglas, GA",20060.0,2020-11-01,0,0,0
"Douglas, GA",20060.0,2020-12-01,0,0,0
"Atlantic City-Hammonton, NJ",12100.0,2019-01-01,-265,-340,75
"Atlantic City-Hammonton, NJ",12100.0,2019-02-01,21,-29,50
"Atlantic City-Hammonton, NJ",12100.0,2019-03-01,83,2,81
"Atlantic City-Hammonton, NJ",12100.0,2019-04-01,316,179,137
"Atlantic City-Hammonton, NJ",12100.0,2019-05-01,956,761,195
"Atlantic City-Hammonton, NJ",12100.0,2019-06-01,490,419,71
"Atlantic City-Hammonton, NJ",12100.0,2019-07-01,145,56,89
"Atlantic City-Hammonton, NJ",12100.0,2019-08-01,37,15,22
"Atlantic City-Hammonton, NJ",12100.0,2019-09-01,-209,-125,-84
"Atlantic City-Hammonton, NJ",12100.0,2019-10-01,-374,-350,-24
"Atlantic City-Hammonton, NJ",12100.0,2019-11-01,-130,-156,26
"Atlantic City-Hammonton, NJ",12100.0,2019-12-01,-228,-277,49
"Atlantic City-Hammonton, NJ",12100.0,2020-01-01,-140,-218,78
"Atlantic City-Hammonton, NJ",12100.0,2020-02-01,48,-13,61
"Atlantic City-Hammonton, NJ",12100.0,2020-03-01,196,123,73
"Atlantic City-Hammonton, NJ",12100.0,2020-04-01,236,121,115
"Atlantic City-Hammonton, NJ",12100.0,2020-05-01,597,386,211
"Atlantic City-Hammonton, NJ",12100.0,2020-06-01,756,575,181
"Atlantic City-Hammonton, NJ",12100.0,2020-07-01,433,232,201
"Atlantic City-Hammonton, NJ",12100.0,2020-08-01,230,79,151
"Atlantic City-Hammonton, NJ",12100.0,2020-09-01,39,-35,74
"Atlantic City-Hammonton, NJ",12100.0,2020-10-01,-166,-249,83
"Atlantic City-Hammonton, NJ",12100.0,2020-11-01,-64,-143,79
"Atlantic City-Hammonton, NJ",12100.0,2020-12-01,-67,-184,117
"Mexico, MO",33020.0,2019-01-01,34,0,34
"Mexico, MO",33020.0,2019-02-01,-14,0,-14
"Mexico, MO",33020.0,2019-03-01,27,0,27
"Mexico, MO",33020.0,2019-04-01,5,0,5
"Mexico, MO",33020.0,2019-05-01,-4,0,-4
"Mexico, MO",33020.0,2019-06-01,-2,0,-2
"Mexico, MO",33020.0,2019-07-01,10,0,10
"Mexico, MO",33020.0,2019-08-01,-2,0,-2
"Mexico, MO",33020.0,2019-09-01,3,0,3
"Mexico, MO",33020.0,2019-10-01,-4,0,-4
"Mexico, MO",33020.0,2019-11-01,16,0,16
"Mexico, MO",33020.0,2019-12-01,0,0,0
"Mexico, MO",33020.0,2020-01-01,-18,0,-18
"Mexico, MO",33020.0,2020-02-01,-15,0,-15
"Mexico, MO",33020.0,2020-03-01,16,0,16
"Mexico, MO",33020.0,2020-04-01,3,0,3
"Mexico, MO",33020.0,2020-05-01,-7,0,-7
"Mexico, MO",33020.0,2020-06-01,7,0,7
"Mexico, MO",33020.0,2020-07-01,4,0,4
"Mexico, MO",33020.0,2020-08-01,0,0,0
"Mexico, MO",33020.0,2020-09-01,-8,0,-8
"Mexico, MO",33020.0,2020-10-01,17,0,17
"Mexico, MO",33020.0,2020-11-01,0,0,0
"Mexico, MO",33020.0,2020-12-01,-1,0,-1
"Wapakoneta, OH",47540.0,2019-01-01,1,0,1
"Wapakoneta, OH",47540.0,2019-02-01,1,0,1
"Wapakoneta, OH",47540.0,2019-03-01,-7,0,-7
"Wapakoneta, OH",47540.0,2019-04-01,15,0,15
"Wapakoneta, OH",47540.0,2019-05-01,13,0,13
"Wapakoneta, OH",47540.0,2019-06-01,0,0,0
"Wapakoneta, OH",47540.0,2019-07-01,12,0,12
"Wapakoneta, OH",47540.0,2019-08-01,-11,0,-11
"Wapakoneta, OH",47540.0,2019-09-01,26,0,26
"Wapakoneta, OH",47540.0,2019-10-01,-3,0,-3
"Wapakoneta, OH",47540.0,2019-11-01,12,0,12
"Wapakoneta, OH",47540.0,2019-12-01,-16,-11,-5
"Wapakoneta, OH",47540.0,2020-01-01,-12,0,-12
"Wapakoneta, OH",47540.0,2020-02-01,-11,0,-11
"Wapakoneta, OH",47540.0,2020-03-01,-7,0,-7
"Wapakoneta, OH",47540.0,2020-04-01,1,0,1
"Wapakoneta, OH",47540.0,2020-05-01,-3,0,-3
"Wapakoneta, OH",47540.0,2020-06-01,10,0,10
"Wapakoneta, OH",47540.0,2020-07-01,33,0,33
"Wapakoneta, OH",47540.0,2020-08-01,-3,0,-3
"Wapakoneta, OH",47540.0,2020-09-01,25,0,25
"Wapakoneta, OH",47540.0,2020-10-01,-21,0,-21
"Wapakoneta, OH",47540.0,2020-11-01,-7,0,-7
"Wapakoneta, OH",47540.0,2020-12-01,3,-16,19
"Staunton, VA",44420.0,2019-01-01,0,0,0
"Staunton, VA",44420.0,2019-02-01,-22,0,-22
"Staunton, VA",44420.0,2019-03-01,16,0,16
"Staunton, VA",44420.0,2019-04-01,49,0,49
"Staunton, VA",44420.0,2019-05-01,43,0,43
"Staunton, VA",44420.0,2019-06-01,26,0,26
"Staunton, VA",44420.0,2019-07-01,55,0,55
"Staunton, VA",44420.0,2019-08-01,32,0,32
"Staunton, VA",44420.0,2019-09-01,36,0,36
"Staunton, VA",44420.0,2019-10-01,14,0,14
"Staunton, VA",44420.0,2019-11-01,44,0,44
"Staunton, VA",44420.0,2019-12-01,-10,0,-10
"Staunton, VA",44420.0,2020-01-01,13,0,13
"Staunton, VA",44420.0,2020-02-01,4,0,4
"Staunton, VA",44420.0,2020-03-01,19,0,19
"Staunton, VA",44420.0,2020-04-01,60,0,60
"Staunton, VA",44420.0,2020-05-01,2,0,2
"Staunton, VA",44420.0,2020-06-01,53,0,53
"Staunton, VA",44420.0,2020-07-01,41,0,41
"Staunton, VA",44420.0,2020-08-01,30,0,30
"Staunton, VA",44420.0,2020-09-01,32,0,32
"Staunton, VA",44420.0,2020-10-01,14,0,14
"Staunton, VA",44420.0,2020-11-01,41,0,41
"Staunton, VA",44420.0,2020-12-01,5,0,5
"Houston-The Woodlands-Sugar Land, TX",26420.0,2019-01-01,543,-32,575
"Houston-The Woodlands-Sugar Land, TX",26420.0,2019-02-01,646,20,626
"Houston-The Woodlands-Sugar Land, TX",26420.0,2019-03-01,846,-2,848
"Houston-The Woodlands-Sugar Land, TX",26420.0,2019-04-01,699,45,654
"Houston-The Woodlands-Sugar Land, TX",26420.0,2019-05-01,1243,-13,1256
"Houston-The Woodlands-Sugar Land, TX",26420.0,2019-06-01,1197,-22,1219
"Houston-The Woodlands-Sugar Land, TX",26420.0,2019-07-01,2004,44,1960
"Houston-The Woodlands-Sugar Land, TX",26420.0,2019-08-01,1152,7,1145
"Houston-The Woodlands-Sugar Land, TX",26420.0,2019-09-01,691,24,667
"Houston-The Woodlands-Sugar Land, TX",26420.0,2019-10-01,373,38,335
"Houston-The Woodlands-Sugar Land, TX",26420.0,2019-11-01,185,-30,215
"Houston-The Woodlands-Sugar Land, TX",26420.0,2019-12-01,517,29,488
"Houston-The Woodlands-Sugar Land, TX",26420.0,2020-01-01,751,196,555
"Houston-The Woodlands-Sugar Land, TX",26420.0,2020-02-01,644,-11,655
"Houston-The Woodlands-Sugar Land, TX",26420.0,2020-03-01,1454,119,1335
"Houston-The Woodlands-Sugar Land, TX",26420.0,2020-04-01,885,31,854
"Houston-The Woodlands-Sugar Land, TX",26420.0,2020-05-01,1385,151,1234
"Houston-The Woodlands-Sugar Land, TX",26420.0,2020-06-01,1701,85,1616
"Houston-The Woodlands-Sugar Land, TX",26420.0,2020-07-01,2178,17,2161
"Houston-The Woodlands-Sugar Land, TX",26420.0,2020-08-01,1894,201,1693
"Houston-The Woodlands-Sugar Land, TX",26420.0,2020-09-01,1586,181,1405
"Houston-The Woodlands-Sugar Land, TX",26420.0,2020-10-01,1048,85,963
"Houston-The Woodlands-Sugar Land, TX",26420.0,2020-11-01,947,176,771
"Houston-The Woodlands-Sugar Land, TX",26420.0,2020-12-01,1135,104,1031
"Montgomery, AL",33860.0,2019-01-01,-1,0,-1
"Montgomery, AL",33860.0,2019-02-01,-7,0,-7
"Montgomery, AL",33860.0,2019-03-01,23,0,23
"Montgomery, AL",33860.0,2019-04-01,-3,0,-3
"Montgomery, AL",33860.0,2019-05-01,38,0,38
"Montgomery, AL",33860.0,2019-06-01,-174,0,-174
"Montgomery, AL",33860.0,2019-07-01,22,0,22
"Montgomery, AL",33860.0,2019-08-01,-83,0,-83
"Montgomery, AL",33860.0,2019-09-01,-59,0,-59
"Montgomery, AL",33860.0,2019-10-01,-25,0,-25
"Montgomery, AL",33860.0,2019-11-01,-24,0,-24
"Montgomery, AL",33860.0,2019-12-01,12,0,12
"Montgomery, AL",33860.0,2020-01-01,-19,0,-19
"Montgomery, AL",33860.0,2020-02-01,-27,0,-27
"Montgomery, AL",33860.0,2020-03-01,-35,0,-35
"Montgomery, AL",33860.0,2020-04-01,-45,0,-45
"Montgomery, AL",33860.0,2020-05-01,-14,0,-14
"Montgomery, AL",33860.0,2020-06-01,-154,0,-154
"Montgomery, AL",33860.0,2020-07-01,67,0,67
"Montgomery, AL",33860.0,2020-08-01,-14,0,-14
"Montgomery, AL",33860.0,2020-09-01,4,0,4
"Montgomery, AL",33860.0,2020-10-01,-48,0,-48
"Montgomery, AL",33860.0,2020-11-01,-71,0,-71
"Montgomery, AL",33860.0,2020-12-01,-14,0,-14
"Jacksonville, FL",27260.0,2019-01-01,207,116,91
"Jacksonville, FL",27260.0,2019-02-01,255,0,255
"Jacksonville, FL",27260.0,2019-03-01,199,0,199
"Jacksonville, FL",27260.0,2019-04-01,411,39,372
"Jacksonville, FL",27260.0,2019-05-01,275,-198,473
"Jacksonville, FL",27260.0,2019-06-01,740,-61,801
"Jacksonville, FL",27260.0,2019-07-01,560,-11,571
"Jacksonville, FL",27260.0,2019-08-01,533,0,533
"Jacksonville, FL",27260.0,2019-09-01,83,0,83
"Jacksonville, FL",27260.0,2019-10-01,378,113,265
"Jacksonville, FL",27260.0,2019-11-01,306,36,270
"Jacksonville, FL",27260.0,2019-12-01,373,138,235
"Jacksonville, FL",27260.0,2020-01-01,241,158,83
"Jacksonville, FL",27260.0,2020-02-01,254,0,254
"Jacksonville, FL",27260.0,2020-03-01,250,52,198
"Jacksonville, FL",27260.0,2020-04-01,392,62,330
"Jacksonville, FL",27260.0,2020-05-01,584,-31,615
"Jacksonville, FL",27260.0,2020-06-01,655,-92,747
"Jacksonville, FL",27260.0,2020-07-01,987,3,984
"Jacksonville, FL",27260.0,2020-08-01,632,0,632
"Jacksonville, FL",27260.0,2020-09-01,561,14,547
"Jacksonville, FL",27260.0,2020-10-01,616,60,556
"Jacksonville, FL",27260.0,2020-11-01,388,48,340
"Jacksonville, FL",27260.0,2020-12-01,687,120,567
"Daphne-Fairhope-Foley, AL",19300.0,2019-01-01,494,437,57
"Daphne-Fairhope-Foley, AL",19300.0,2019-02-01,65,0,65
"Daphne-Fairhope-Foley, AL",19300.0,2019-03-01,-121,0,-121
"Daphne-Fairhope-Foley, AL",19300.0,2019-04-01,122,0,122
"Daphne-Fairhope-Foley, AL",19300.0,2019-05-01,59,-18,77
"Daphne-Fairhope-Foley, AL",19300.0,2019-06-01,118,0,118
"Daphne-Fairhope-Foley, AL",19300.0,2019-07-01,157,0,157
"Daphne-Fairhope-Foley, AL",19300.0,2019-08-01,82,0,82
"Daphne-Fairhope-Foley, AL",19300.0,2019-09-01,137,0,137
"Daphne-Fairhope-Foley, AL",19300.0,2019-10-01,193,0,193
"Daphne-Fairhope-Foley, AL",19300.0,2019-11-01,71,38,33
"Daphne-Fairhope-Foley, AL",19300.0,2019-12-01,881,804,77
"Daphne-Fairhope-Foley, AL",19300.0,2020-01-01,473,403,70
"Daphne-Fairhope-Foley, AL",19300.0,2020-02-01,81,0,81
"Daphne-Fairhope-Foley, AL",19300.0,2020-03-01,-19,27,-46
"Daphne-Fairhope-Foley, AL",19300.0,2020-04-01,145,16,129
"Daphne-Fairhope-Foley, AL",19300.0,2020-05-01,159,0,159
"Daphne-Fairhope-Foley, AL",19300.0,2020-06-01,191,0,191
"Daphne-Fairhope-Foley, AL",19300.0,2020-07-01,170,0,170
"Daphne-Fairhope-Foley, AL",19300.0,2020-08-01,171,0,171
"Daphne-Fairhope-Foley, AL",19300.0,2020-09-01,138,0,138
"Daphne-Fairhope-Foley, AL",19300.0,2020-10-01,68,14,54
"Daphne-Fairhope-Foley, AL",19300.0,2020-11-01,83,12,71
"Daphne-Fairhope-Foley, AL",19300.0,2020-12-01,240,156,84
"Milledgeville, GA",33300.0,2019-01-01,-17,0,-17
"Milledgeville, GA",33300.0,2019-02-01,-1,0,-1
"Milledgeville, GA",33300.0,2019-03-01,-12,0,-12
"Milledgeville, GA",33300.0,2019-04-01,-10,0,-10
"Milledgeville, GA",33300.0,2019-05-01,-18,0,-18
"Milledgeville, GA",33300.0,2019-06-01,-13,0,-13
"Milledgeville, GA",33300.0,2019-07-01,-23,0,-23
"Milledgeville, GA",33300.0,2019-08-01,3,0,3
"Milledgeville, GA",33300.0,2019-09-01,0,0,0
"Milledgeville, GA",33300.0,2019-10-01,0,0,0
"Milledgeville, GA",33300.0,2019-11-01,23,0,23
"Milledgeville, GA",33300.0,2019-12-01,0,0,0
"Milledgeville, GA",33300.0,2020-01-01,-15,0,-15
"Milledgeville, GA",33300.0,2020-02-01,-5,0,-5
"Milledgeville, GA",33300.0,2020-03-01,-13,0,-13
"Milledgeville, GA",33300.0,2020-04-01,-15,0,-15
"Milledgeville, GA",33300.0,2020-05-01,0,0,0
"Milledgeville, GA",33300.0,2020-06-01,-11,0,-11
"Milledgeville, GA",33300.0,2020-07-01,-11,0,-11
"Milledgeville, GA",33300.0,2020-08-01,23,0,23
"Milledgeville, GA",33300.0,2020-09-01,-1,0,-1
"Milledgeville, GA",33300.0,2020-10-01,0,0,0
"Milledgeville, GA",33300.0,2020-11-01,0,0,0
"Milledgeville, GA",33300.0,2020-12-01,0,0,0
"Paducah, KY-IL",37140.0,2019-01-01,-14,0,-14
"Paducah, KY-IL",37140.0,2019-02-01,-11,0,-11
"Paducah, KY-IL",37140.0,2019-03-01,11,0,11
"Paducah, KY-IL",37140.0,2019-04-01,-2,0,-2
"Paducah, KY-IL",37140.0,2019-05-01,19,0,19
"Paducah, KY-IL",37140.0,2019-06-01,21,0,21
"Paducah, KY-IL",37140.0,2019-07-01,-2,0,-2
"Paducah, KY-IL",37140.0,2019-08-01,5,0,5
"Paducah, KY-IL",37140.0,2019-09-01,-5,0,-5
"Paducah, KY-IL",37140.0,2019-10-01,6,0,6
"Paducah, KY-IL",37140.0,2019-11-01,-24,0,-24
"Paducah, KY-IL",37140.0,2019-12-01,-16,-14,-2
"Paducah, KY-IL",37140.0,2020-01-01,-43,0,-43
"Paducah, KY-IL",37140.0,2020-02-01,16,0,16
"Paducah, KY-IL",37140.0,2020-03-01,-5,0,-5
"Paducah, KY-IL",37140.0,2020-04-01,29,0,29
"Paducah, KY-IL",37140.0,2020-05-01,-16,0,-16
"Paducah, KY-IL",37140.0,2020-06-01,20,0,20
"Paducah, KY-IL",37140.0,2020-07-01,-11,0,-11
"Paducah, KY-IL",37140.0,2020-08-01,-46,0,-46
"Paducah, KY-IL",37140.0,2020-09-01,-18,0,-18
"Paducah, KY-IL",37140.0,2020-10-01,-23,0,-23
"Paducah, KY-IL",37140.0,2020-11-01,-8,0,-8
"Paducah, KY-IL",37140.0,2020-12-01,9,0,9
"Pocatello, ID",38540.0,2019-01-01,-7,0,-7
"Pocatello, ID",38540.0,2019-02-01,-22,0,-22
"Pocatello, ID",38540.0,2019-03-01,-18,0,-18
"Pocatello, ID",38540.0,2019-04-01,-7,0,-7
"Pocatello, ID",38540.0,2019-05-01,-16,0,-16
"Pocatello, ID",38540.0,2019-06-01,-27,0,-27
"Pocatello, ID",38540.0,2019-07-01,14,0,14
"Pocatello, ID",38540.0,2019-08-01,-23,0,-23
"Pocatello, ID",38540.0,2019-09-01,-3,0,-3
"Pocatello, ID",38540.0,2019-10-01,-84,-101,17
"Pocatello, ID",38540.0,2019-11-01,-34,-24,-10
"Pocatello, ID",38540.0,2019-12-01,-9,-25,16
"Pocatello, ID",38540.0,2020-01-01,6,0,6
"Pocatello, ID",38540.0,2020-02-01,-14,0,-14
"Pocatello, ID",38540.0,2020-03-01,-30,0,-30
"Pocatello, ID",38540.0,2020-04-01,26,0,26
"Pocatello, ID",38540.0,2020-05-01,-36,0,-36
"Pocatello, ID",38540.0,2020-06-01,26,0,26
"Pocatello, ID",38540.0,2020-07-01,48,0,48
"Pocatello, ID",38540.0,2020-08-01,-3,0,-3
"Pocatello, ID",38540.0,2020-09-01,6,0,6
"Pocatello, ID",38540.0,2020-10-01,-85,-64,-21
"Pocatello, ID",38540.0,2020-11-01,-57,-40,-17
"Pocatello, ID",38540.0,2020-12-01,-3,0,-3
"Eufaula, AL-GA",21640.0,2019-01-01,-11,0,-11
"Eufaula, AL-GA",21640.0,2019-02-01,0,0,0
"Eufaula, AL-GA",21640.0,2019-03-01,0,0,0
"Eufaula, AL-GA",21640.0,2019-04-01,0,0,0
"Eufaula, AL-GA",21640.0,2019-05-01,0,0,0
"Eufaula, AL-GA",21640.0,2019-06-01,0,0,0
"Eufaula, AL-GA",21640.0,2019-07-01,0,0,0
"Eufaula, AL-GA",21640.0,2019-08-01,0,0,0
"Eufaula, AL-GA",21640.0,2019-09-01,0,0,0
"Eufaula, AL-GA",21640.0,2019-10-01,0,0,0
"Eufaula, AL-GA",21640.0,2019-11-01,0,0,0
"Eufaula, AL-GA",21640.0,2019-12-01,0,0,0
"Eufaula, AL-GA",21640.0,2020-01-01,11,0,11
"Eufaula, AL-GA",21640.0,2020-02-01,0,0,0
"Eufaula, AL-GA",21640.0,2020-03-01,0,0,0
"Eufaula, AL-GA",21640.0,2020-04-01,-1,0,-1
"Eufaula, AL-GA",21640.0,2020-05-01,-11,0,-11
"Eufaula, AL-GA",21640.0,2020-06-01,-11,0,-11
"Eufaula, AL-GA",21640.0,2020-07-01,0,0,0
"Eufaula, AL-GA",21640.0,2020-08-01,12,0,12
"Eufaula, AL-GA",21640.0,2020-09-01,0,0,0
"Eufaula, AL-GA",21640.0,2020-10-01,0,0,0
"Eufaula, AL-GA",21640.0,2020-11-01,0,0,0
"Eufaula, AL-GA",21640.0,2020-12-01,11,0,11
"San Juan-Bayamón-Caguas, PR",41980.0,2019-01-01,27,0,27
"San Juan-Bayamón-Caguas, PR",41980.0,2019-02-01,0,0,0
"San Juan-Bayamón-Caguas, PR",41980.0,2019-03-01,12,0,12
"San Juan-Bayamón-Caguas, PR",41980.0,2019-04-01,0,0,0
"San Juan-Bayamón-Caguas, PR",41980.0,2019-05-01,-12,0,-12
"San Juan-Bayamón-Caguas, PR",41980.0,2019-06-01,75,0,75
"San Juan-Bayamón-Caguas, PR",41980.0,2019-07-01,23,0,23
"San Juan-Bayamón-Caguas, PR",41980.0,2019-08-01,57,0,57
"San Juan-Bayamón-Caguas, PR",41980.0,2019-09-01,-5,0,-5
"San Juan-Bayamón-Caguas, PR",41980.0,2019-10-01,-12,0,-12
"San Juan-Bayamón-Caguas, PR",41980.0,2019-11-01,0,0,0
"San Juan-Bayamón-Caguas, PR",41980.0,2019-12-01,11,0,11
"San Juan-Bayamón-Caguas, PR",41980.0,2020-01-01,0,0,0
"San Juan-Bayamón-Caguas, PR",41980.0,2020-02-01,12,0,12
"San Juan-Bayamón-Caguas, PR",41980.0,2020-03-01,3,0,3
"San Juan-Bayamón-Caguas, PR",41980.0,2020-04-01,-12,0,-12
"San Juan-Bayamón-Caguas, PR",41980.0,2020-05-01,11,11,0
"San Juan-Bayamón-Caguas, PR",41980.0,2020-06-01,23,0,23
"San Juan-Bayamón-Caguas, PR",41980.0,2020-07-01,-18,0,-18
"San Juan-Bayamón-Caguas, PR",41980.0,2020-08-01,40,0,40
"San Juan-Bayamón-Caguas, PR",41980.0,2020-09-01,-13,0,-13
"San Juan-Bayamón-Caguas, PR",41980.0,2020-10-01,-14,0,-14
"San Juan-Bayamón-Caguas, PR",41980.0,2020-11-01,13,0,13
"San Juan-Bayamón-Caguas, PR",41980.0,2020-12-01,31,0,31
"Barnstable Town, MA",12700.0,2019-01-01,-1511,-1505,-6
"Barnstable Town, MA",12700.0,2019-02-01,-354,-378,24
"Barnstable Town, MA",12700.0,2019-03-01,135,-104,239
"Barnstable Town, MA",12700.0,2019-04-01,1508,988,520
"Barnstable Town, MA",12700.0,2019-05-01,3963,3386,577
"Barnstable Town, MA",12700.0,2019-06-01,2736,2334,402
"Barnstable Town, MA",12700.0,2019-07-01,699,464,235
"Barnstable Town, MA",12700.0,2019-08-01,99,33,66
"Barnstable Town, MA",12700.0,2019-09-01,-991,-706,-285
"Barnstable Town, MA",12700.0,2019-10-01,-2912,-2510,-402
"Barnstable Town, MA",12700.0,2019-11-01,-1312,-1253,-59
"Barnstable Town, MA",12700.0,2019-12-01,-1718,-1724,6
"Barnstable Town, MA",12700.0,2020-01-01,-1485,-1522,37
"Barnstable Town, MA",12700.0,2020-02-01,-299,-277,-22
"Barnstable Town, MA",12700.0,2020-03-01,1395,823,572
"Barnstable Town, MA",12700.0,2020-04-01,1000,513,487
"Barnstable Town, MA",12700.0,2020-05-01,3126,2488,638
"Barnstable Town, MA",12700.0,2020-06-01,4149,3561,588
"Barnstable Town, MA",12700.0,2020-07-01,1580,1135,445
"Barnstable Town, MA",12700.0,2020-08-01,826,409,417
"Barnstable Town, MA",12700.0,2020-09-01,34,-41,75
"Barnstable Town, MA",12700.0,2020-10-01,-2114,-1937,-177
"Barnstable Town, MA",12700.0,2020-11-01,-899,-991,92
"Barnstable Town, MA",12700.0,2020-12-01,-1036,-1176,140
"Glasgow, KY",23980.0,2019-01-01,6,0,6
"Glasgow, KY",23980.0,2019-02-01,44,0,44
"Glasgow, KY",23980.0,2019-03-01,-10,0,-10
"Glasgow, KY",23980.0,2019-04-01,-17,0,-17
"Glasgow, KY",23980.0,2019-05-01,-5,0,-5
"Glasgow, KY",23980.0,2019-06-01,1,0,1
"Glasgow, KY",23980.0,2019-07-01,22,0,22
"Glasgow, KY",23980.0,2019-08-01,-11,0,-11
"Glasgow, KY",23980.0,2019-09-01,-11,0,-11
"Glasgow, KY",23980.0,2019-10-01,-3,0,-3
"Glasgow, KY",23980.0,2019-11-01,-7,0,-7
"Glasgow, KY",23980.0,2019-12-01,16,0,16
"Glasgow, KY",23980.0,2020-01-01,32,0,32
"Glasgow, KY",23980.0,2020-02-01,4,0,4
"Glasgow, KY",23980.0,2020-03-01,13,0,13
"Glasgow, KY",23980.0,2020-04-01,12,0,12
"Glasgow, KY",23980.0,2020-05-01,12,0,12
"Glasgow, KY",23980.0,2020-06-01,16,0,16
"Glasgow, KY",23980.0,2020-07-01,18,0,18
"Glasgow, KY",23980.0,2020-08-01,19,0,19
"Glasgow, KY",23980.0,2020-09-01,-18,0,-18
"Glasgow, KY",23980.0,2020-10-01,35,0,35
"Glasgow, KY",23980.0,2020-11-01,-9,0,-9
"Glasgow, KY",23980.0,2020-12-01,27,0,27
"Atlanta-Sandy Springs-Alpharetta, GA",12060.0,2019-01-01,288,-36,324
"Atlanta-Sandy Springs-Alpharetta, GA",12060.0,2019-02-01,359,14,345
"Atlanta-Sandy Springs-Alpharetta, GA",12060.0,2019-03-01,380,14,366
"Atlanta-Sandy Springs-Alpharetta, GA",12060.0,2019-04-01,515,56,459
"Atlanta-Sandy Springs-Alpharetta, GA",12060.0,2019-05-01,381,29,352
"Atlanta-Sandy Springs-Alpharetta, GA",12060.0,2019-06-01,1220,94,1126
"Atlanta-Sandy Springs-Alpharetta, GA",12060.0,2019-07-01,1477,44,1433
"Atlanta-Sandy Springs-Alpharetta, GA",12060.0,2019-08-01,690,12,678
"Atlanta-Sandy Springs-Alpharetta, GA",12060.0,2019-09-01,361,14,347
"Atlanta-Sandy Springs-Alpharetta, GA",12060.0,2019-10-01,409,-2,411
"Atlanta-Sandy Springs-Alpharetta, GA",12060.0,2019-11-01,407,5,402
"Atlanta-Sandy Springs-Alpharetta, GA",12060.0,2019-12-01,413,23,390
"Atlanta-Sandy Springs-Alpharetta, GA",12060.0,2020-01-01,274,3,271
"Atlanta-Sandy Springs-Alpharetta, GA",12060.0,2020-02-01,434,19,415
"Atlanta-Sandy Springs-Alpharetta, GA",12060.0,2020-03-01,565,273,292
"Atlanta-Sandy Springs-Alpharetta, GA",12060.0,2020-04-01,590,233,357
"Atlanta-Sandy Springs-Alpharetta, GA",12060.0,2020-05-01,786,183,603
"Atlanta-Sandy Springs-Alpharetta, GA",12060.0,2020-06-01,1379,215,1164
"Atlanta-Sandy Springs-Alpharetta, GA",12060.0,2020-07-01,1639,215,1424
"Atlanta-Sandy Springs-Alpharetta, GA",12060.0,2020-08-01,1481,317,1164
"Atlanta-Sandy Springs-Alpharetta, GA",12060.0,2020-09-01,1196,127,1069
"Atlanta-Sandy Springs-Alpharetta, GA",12060.0,2020-10-01,792,12,780
"Atlanta-Sandy Springs-Alpharetta, GA",12060.0,2020-11-01,835,131,704
"Atlanta-Sandy Springs-Alpharetta, GA",12060.0,2020-12-01,664,48,616
"Columbus, IN",18020.0,2019-01-01,-12,-12,0
"Columbus, IN",18020.0,2019-02-01,-17,0,-17
"Columbus, IN",18020.0,2019-03-01,-8,0,-8
"Columbus, IN",18020.0,2019-04-01,30,13,17
"Columbus, IN",18020.0,2019-05-01,12,0,12
"Columbus, IN",18020.0,2019-06-01,-62,0,-62
"Columbus, IN",18020.0,2019-07-01,-45,0,-45
"Columbus, IN",18020.0,2019-08-01,-17,0,-17
"Columbus, IN",18020.0,2019-09-01,-32,0,-32
"Columbus, IN",18020.0,2019-10-01,-7,-15,8
"Columbus, IN",18020.0,2019-11-01,-44,0,-44
"Columbus, IN",18020.0,2019-12-01,-59,-27,-32
"Columbus, IN",18020.0,2020-01-01,-38,0,-38
"Columbus, IN",18020.0,2020-02-01,17,0,17
"Columbus, IN",18020.0,2020-03-01,42,0,42
"Columbus, IN",18020.0,2020-04-01,23,11,12
"Columbus, IN",18020.0,2020-05-01,15,0,15
"Columbus, IN",18020.0,2020-06-01,12,0,12
"Columbus, IN",18020.0,2020-07-01,40,0,40
"Columbus, IN",18020.0,2020-08-01,11,0,11
"Columbus, IN",18020.0,2020-09-01,-10,0,-10
"Columbus, IN",18020.0,2020-10-01,-20,-15,-5
"Columbus, IN",18020.0,2020-11-01,17,0,17
"Columbus, IN",18020.0,2020-12-01,9,-12,21
"Great Bend, KS",24460.0,2019-01-01,0,0,0
"Great Bend, KS",24460.0,2019-02-01,0,0,0
"Great Bend, KS",24460.0,2019-03-01,0,0,0
"Great Bend, KS",24460.0,2019-04-01,-11,0,-11
"Great Bend, KS",24460.0,2019-05-01,12,0,12
"Great Bend, KS",24460.0,2019-06-01,0,0,0
"Great Bend, KS",24460.0,2019-07-01,0,0,0
"Great Bend, KS",24460.0,2019-08-01,-13,0,-13
"Great Bend, KS",24460.0,2019-09-01,0,0,0
"Great Bend, KS",24460.0,2019-10-01,-11,0,-11
"Great Bend, KS",24460.0,2019-11-01,0,0,0
"Great Bend, KS",24460.0,2019-12-01,0,0,0
"Great Bend, KS",24460.0,2020-01-01,0,0,0
"Great Bend, KS",24460.0,2020-02-01,0,0,0
"Great Bend, KS",24460.0,2020-03-01,0,0,0
"Great Bend, KS",24460.0,2020-04-01,0,0,0
"Great Bend, KS",24460.0,2020-05-01,0,0,0
"Great Bend, KS",24460.0,2020-06-01,-14,0,-14
"Great Bend, KS",24460.0,2020-07-01,-13,0,-13
"Great Bend, KS",24460.0,2020-08-01,0,0,0
"Great Bend, KS",24460.0,2020-09-01,0,0,0
"Great Bend, KS",24460.0,2020-10-01,-13,0,-13
"Great Bend, KS",24460.0,2020-11-01,0,0,0
"Great Bend, KS",24460.0,2020-12-01,-14,0,-14
"Austin-Round Rock-Georgetown, TX",12420.0,2019-01-01,795,56,739
"Austin-Round Rock-Georgetown, TX",12420.0,2019-02-01,523,17,506
"Austin-Round Rock-Georgetown, TX",12420.0,2019-03-01,1055,40,1015
"Austin-Round Rock-Georgetown, TX",12420.0,2019-04-01,720,-26,746
"Austin-Round Rock-Georgetown, TX",12420.0,2019-05-01,963,-95,1058
"Austin-Round Rock-Georgetown, TX",12420.0,2019-06-01,1145,-127,1272
"Austin-Round Rock-Georgetown, TX",12420.0,2019-07-01,1187,0,1187
"Austin-Round Rock-Georgetown, TX",12420.0,2019-08-01,1747,6,1741
"Austin-Round Rock-Georgetown, TX",12420.0,2019-09-01,1221,-8,1229
"Austin-Round Rock-Georgetown, TX",12420.0,2019-10-01,1184,8,1176
"Austin-Round Rock-Georgetown, TX",12420.0,2019-11-01,1008,29,979
"Austin-Round Rock-Georgetown, TX",12420.0,2019-12-01,824,10,814
"Austin-Round Rock-Georgetown, TX",12420.0,2020-01-01,1050,-5,1055
"Austin-Round Rock-Georgetown, TX",12420.0,2020-02-01,626,11,615
"Austin-Round Rock-Georgetown, TX",12420.0,2020-03-01,876,-15,891
"Austin-Round Rock-Georgetown, TX",12420.0,2020-04-01,631,78,553
"Austin-Round Rock-Georgetown, TX",12420.0,2020-05-01,834,93,741
"Austin-Round Rock-Georgetown, TX",12420.0,2020-06-01,950,7,943
"Austin-Round Rock-Georgetown, TX",12420.0,2020-07-01,1265,-20,1285
"Austin-Round Rock-Georgetown, TX",12420.0,2020-08-01,1903,-8,1911
"Austin-Round Rock-Georgetown, TX",12420.0,2020-09-01,1394,13,1381
"Austin-Round Rock-Georgetown, TX",12420.0,2020-10-01,1727,37,1690
"Austin-Round Rock-Georgetown, TX",12420.0,2020-11-01,1383,79,1304
"Austin-Round Rock-Georgetown, TX",12420.0,2020-12-01,1549,35,1514
"Kansas City, MO-KS",28140.0,2019-01-01,-170,-234,64
"Kansas City, MO-KS",28140.0,2019-02-01,84,0,84
"Kansas City, MO-KS",28140.0,2019-03-01,129,25,104
"Kansas City, MO-KS",28140.0,2019-04-01,426,164,262
"Kansas City, MO-KS",28140.0,2019-05-01,549,133,416
"Kansas City, MO-KS",28140.0,2019-06-01,247,18,229
"Kansas City, MO-KS",28140.0,2019-07-01,618,12,606
"Kansas City, MO-KS",28140.0,2019-08-01,255,0,255
"Kansas City, MO-KS",28140.0,2019-09-01,-99,-14,-85
"Kansas City, MO-KS",28140.0,2019-10-01,-108,-146,38
"Kansas City, MO-KS",28140.0,2019-11-01,10,-113,123
"Kansas City, MO-KS",28140.0,2019-12-01,-300,-347,47
"Kansas City, MO-KS",28140.0,2020-01-01,-130,-236,106
"Kansas City, MO-KS",28140.0,2020-02-01,59,-16,75
"Kansas City, MO-KS",28140.0,2020-03-01,345,57,288
"Kansas City, MO-KS",28140.0,2020-04-01,202,52,150
"Kansas City, MO-KS",28140.0,2020-05-01,495,143,352
"Kansas City, MO-KS",28140.0,2020-06-01,134,58,76
"Kansas City, MO-KS",28140.0,2020-07-01,735,11,724
"Kansas City, MO-KS",28140.0,2020-08-01,437,20,417
"Kansas City, MO-KS",28140.0,2020-09-01,-36,14,-50
"Kansas City, MO-KS",28140.0,2020-10-01,-65,-126,61
"Kansas City, MO-KS",28140.0,2020-11-01,-60,-75,15
"Kansas City, MO-KS",28140.0,2020-12-01,-105,-288,183
"Mount Sterling, KY",34460.0,2019-01-01,3,0,3
"Mount Sterling, KY",34460.0,2019-02-01,11,0,11
"Mount Sterling, KY",34460.0,2019-03-01,26,0,26
"Mount Sterling, KY",34460.0,2019-04-01,-23,0,-23
"Mount Sterling, KY",34460.0,2019-05-01,27,0,27
"Mount Sterling, KY",34460.0,2019-06-01,12,0,12
"Mount Sterling, KY",34460.0,2019-07-01,41,0,41
"Mount Sterling, KY",34460.0,2019-08-01,36,0,36
"Mount Sterling, KY",34460.0,2019-09-01,41,0,41
"Mount Sterling, KY",34460.0,2019-10-01,-6,0,-6
"Mount Sterling, KY",34460.0,2019-11-01,0,0,0
"Mount Sterling, KY",34460.0,2019-12-01,25,0,25
"Mount Sterling, KY",34460.0,2020-01-01,25,0,25
"Mount Sterling, KY",34460.0,2020-02-01,22,0,22
"Mount Sterling, KY",34460.0,2020-03-01,-26,0,-26
"Mount Sterling, KY",34460.0,2020-04-01,9,0,9
"Mount Sterling, KY",34460.0,2020-05-01,-1,0,-1
"Mount Sterling, KY",34460.0,2020-06-01,-41,0,-41
"Mount Sterling, KY",34460.0,2020-07-01,23,0,23
"Mount Sterling, KY",34460.0,2020-08-01,3,0,3
"Mount Sterling, KY",34460.0,2020-09-01,-7,0,-7
"Mount Sterling, KY",34460.0,2020-10-01,17,0,17
"Mount Sterling, KY",34460.0,2020-11-01,11,0,11
"Mount Sterling, KY",34460.0,2020-12-01,33,0,33
"Mountain Home, AR",34260.0,2019-01-01,6,0,6
"Mountain Home, AR",34260.0,2019-02-01,6,0,6
"Mountain Home, AR",34260.0,2019-03-01,-5,0,-5
"Mountain Home, AR",34260.0,2019-04-01,-27,0,-27
"Mountain Home, AR",34260.0,2019-05-01,-2,0,-2
"Mountain Home, AR",34260.0,2019-06-01,6,0,6
"Mountain Home, AR",34260.0,2019-07-01,-2,0,-2
"Mountain Home, AR",34260.0,2019-08-01,8,0,8
"Mountain Home, AR",34260.0,2019-09-01,-7,0,-7
"Mountain Home, AR",34260.0,2019-10-01,5,0,5
"Mountain Home, AR",34260.0,2019-11-01,3,0,3
"Mountain Home, AR",34260.0,2019-12-01,0,0,0
"Mountain Home, AR",34260.0,2020-01-01,3,0,3
"Mountain Home, AR",34260.0,2020-02-01,2,0,2
"Mountain Home, AR",34260.0,2020-03-01,12,0,12
"Mountain Home, AR",34260.0,2020-04-01,-18,0,-18
"Mountain Home, AR",34260.0,2020-05-01,4,0,4
"Mountain Home, AR",34260.0,2020-06-01,0,0,0
"Mountain Home, AR",34260.0,2020-07-01,-15,0,-15
"Mountain Home, AR",34260.0,2020-08-01,-4,0,-4
"Mountain Home, AR",34260.0,2020-09-01,6,0,6
"Mountain Home, AR",34260.0,2020-10-01,-1,0,-1
"Mountain Home, AR",34260.0,2020-11-01,-5,0,-5
"Mountain Home, AR",34260.0,2020-12-01,-1,0,-1
"Panama City, FL",37460.0,2019-01-01,-483,2,-485
"Panama City, FL",37460.0,2019-02-01,-260,0,-260
"Panama City, FL",37460.0,2019-03-01,-260,0,-260
"Panama City, FL",37460.0,2019-04-01,-232,-11,-221
"Panama City, FL",37460.0,2019-05-01,-102,0,-102
"Panama City, FL",37460.0,2019-06-01,-125,0,-125
"Panama City, FL",37460.0,2019-07-01,-152,0,-152
"Panama City, FL",37460.0,2019-08-01,-65,0,-65
"Panama City, FL",37460.0,2019-09-01,-58,0,-58
"Panama City, FL",37460.0,2019-10-01,-11,0,-11
"Panama City, FL",37460.0,2019-11-01,-58,0,-58
"Panama City, FL",37460.0,2019-12-01,173,184,-11
"Panama City, FL",37460.0,2020-01-01,8,37,-29
"Panama City, FL",37460.0,2020-02-01,64,0,64
"Panama City, FL",37460.0,2020-03-01,-11,0,-11
"Panama City, FL",37460.0,2020-04-01,-66,0,-66
"Panama City, FL",37460.0,2020-05-01,74,0,74
"Panama City, FL",37460.0,2020-06-01,10,0,10
"Panama City, FL",37460.0,2020-07-01,15,0,15
"Panama City, FL",37460.0,2020-08-01,67,0,67
"Panama City, FL",37460.0,2020-09-01,-25,0,-25
"Panama City, FL",37460.0,2020-10-01,103,0,103
"Panama City, FL",37460.0,2020-11-01,68,0,68
"Panama City, FL",37460.0,2020-12-01,61,50,11
"Bay City, MI",13020.0,2019-01-01,-90,-75,-15
"Bay City, MI",13020.0,2019-02-01,7,0,7
"Bay City, MI",13020.0,2019-03-01,33,0,33
"Bay City, MI",13020.0,2019-04-01,119,91,28
"Bay City, MI",13020.0,2019-05-01,94,65,29
"Bay City, MI",13020.0,2019-06-01,9,0,9
"Bay City, MI",13020.0,2019-07-01,-21,0,-21
"Bay City, MI",13020.0,2019-08-01,-33,0,-33
"Bay City, MI",13020.0,2019-09-01,-26,0,-26
"Bay City, MI",13020.0,2019-10-01,-54,-71,17
"Bay City, MI",13020.0,2019-11-01,-57,-72,15
"Bay City, MI",13020.0,2019-12-01,-155,-119,-36
"Bay City, MI",13020.0,2020-01-01,-90,-91,1
"Bay City, MI",13020.0,2020-02-01,-44,0,-44
"Bay City, MI",13020.0,2020-03-01,7,-1,8
"Bay City, MI",13020.0,2020-04-01,28,12,16
"Bay City, MI",13020.0,2020-05-01,40,44,-4
"Bay City, MI",13020.0,2020-06-01,-1,0,-1
"Bay City, MI",13020.0,2020-07-01,16,0,16
"Bay City, MI",13020.0,2020-08-01,-47,0,-47
"Bay City, MI",13020.0,2020-09-01,-2,0,-2
"Bay City, MI",13020.0,2020-10-01,-55,-82,27
"Bay City, MI",13020.0,2020-11-01,-101,-88,-13
"Bay City, MI",13020.0,2020-12-01,-98,-96,-2
"Huron, SD",26700.0,2019-01-01,0,0,0
"Huron, SD",26700.0,2019-02-01,0,0,0
"Huron, SD",26700.0,2019-03-01,0,0,0
"Huron, SD",26700.0,2019-04-01,0,0,0
"Huron, SD",26700.0,2019-05-01,0,0,0
"Huron, SD",26700.0,2019-06-01,0,0,0
"Huron, SD",26700.0,2019-07-01,0,0,0
"Huron, SD",26700.0,2019-08-01,0,0,0
"Huron, SD",26700.0,2019-09-01,0,0,0
"Huron, SD",26700.0,2019-10-01,0,0,0
"Huron, SD",26700.0,2019-11-01,0,0,0
"Huron, SD",26700.0,2019-12-01,0,0,0
"Huron, SD",26700.0,2020-01-01,0,0,0
"Huron, SD",26700.0,2020-02-01,0,0,0
"Huron, SD",26700.0,2020-03-01,11,0,11
"Huron, SD",26700.0,2020-04-01,0,0,0
"Huron, SD",26700.0,2020-05-01,0,0,0
"Huron, SD",26700.0,2020-06-01,0,0,0
"Huron, SD",26700.0,2020-07-01,-13,0,-13
"Huron, SD",26700.0,2020-08-01,0,0,0
"Huron, SD",26700.0,2020-09-01,0,0,0
"Huron, SD",26700.0,2020-10-01,0,0,0
"Huron, SD",26700.0,2020-11-01,0,0,0
"Huron, SD",26700.0,2020-12-01,0,0,0
"Washington, NC",47820.0,2019-01-01,-25,0,-25
"Washington, NC",47820.0,2019-02-01,11,0,11
"Washington, NC",47820.0,2019-03-01,-2,0,-2
"Washington, NC",47820.0,2019-04-01,12,0,12
"Washington, NC",47820.0,2019-05-01,3,0,3
"Washington, NC",47820.0,2019-06-01,18,0,18
"Washington, NC",47820.0,2019-07-01,17,0,17
"Washington, NC",47820.0,2019-08-01,-8,0,-8
"Washington, NC",47820.0,2019-09-01,-3,0,-3
"Washington, NC",47820.0,2019-10-01,4,0,4
"Washington, NC",47820.0,2019-11-01,-7,0,-7
"Washington, NC",47820.0,2019-12-01,-1,0,-1
"Washington, NC",47820.0,2020-01-01,-24,0,-24
"Washington, NC",47820.0,2020-02-01,16,0,16
"Washington, NC",47820.0,2020-03-01,7,0,7
"Washington, NC",47820.0,2020-04-01,0,0,0
"Washington, NC",47820.0,2020-05-01,10,0,10
"Washington, NC",47820.0,2020-06-01,14,0,14
"Washington, NC",47820.0,2020-07-01,-7,0,-7
"Washington, NC",47820.0,2020-08-01,-12,0,-12
"Washington, NC",47820.0,2020-09-01,5,0,5
"Washington, NC",47820.0,2020-10-01,7,0,7
"Washington, NC",47820.0,2020-11-01,17,0,17
"Washington, NC",47820.0,2020-12-01,-7,0,-7
"Hilton Head Island-Bluffton, SC",25940.0,2019-01-01,357,376,-19
"Hilton Head Island-Bluffton, SC",25940.0,2019-02-01,33,0,33
"Hilton Head Island-Bluffton, SC",25940.0,2019-03-01,20,0,20
"Hilton Head Island-Bluffton, SC",25940.0,2019-04-01,53,-18,71
"Hilton Head Island-Bluffton, SC",25940.0,2019-05-01,-246,-264,18
"Hilton Head Island-Bluffton, SC",25940.0,2019-06-01,-13,-87,74
"Hilton Head Island-Bluffton, SC",25940.0,2019-07-01,89,0,89
"Hilton Head Island-Bluffton, SC",25940.0,2019-08-01,88,0,88
"Hilton Head Island-Bluffton, SC",25940.0,2019-09-01,88,24,64
"Hilton Head Island-Bluffton, SC",25940.0,2019-10-01,95,56,39
"Hilton Head Island-Bluffton, SC",25940.0,2019-11-01,13,0,13
"Hilton Head Island-Bluffton, SC",25940.0,2019-12-01,111,109,2
"Hilton Head Island-Bluffton, SC",25940.0,2020-01-01,368,334,34
"Hilton Head Island-Bluffton, SC",25940.0,2020-02-01,-16,0,-16
"Hilton Head Island-Bluffton, SC",25940.0,2020-03-01,139,82,57
"Hilton Head Island-Bluffton, SC",25940.0,2020-04-01,123,56,67
"Hilton Head Island-Bluffton, SC",25940.0,2020-05-01,68,-54,122
"Hilton Head Island-Bluffton, SC",25940.0,2020-06-01,9,-141,150
"Hilton Head Island-Bluffton, SC",25940.0,2020-07-01,87,-23,110
"Hilton Head Island-Bluffton, SC",25940.0,2020-08-01,169,0,169
"Hilton Head Island-Bluffton, SC",25940.0,2020-09-01,102,12,90
"Hilton Head Island-Bluffton, SC",25940.0,2020-10-01,265,125,140
"Hilton Head Island-Bluffton, SC",25940.0,2020-11-01,125,37,88
"Hilton Head Island-Bluffton, SC",25940.0,2020-12-01,325,250,75
"DeRidder, LA",19760.0,2019-01-01,-13,0,-13
"DeRidder, LA",19760.0,2019-02-01,13,0,13
"DeRidder, LA",19760.0,2019-03-01,17,0,17
"DeRidder, LA",19760.0,2019-04-01,38,0,38
"DeRidder, LA",19760.0,2019-05-01,13,0,13
"DeRidder, LA",19760.0,2019-06-01,11,0,11
"DeRidder, LA",19760.0,2019-07-01,25,0,25
"DeRidder, LA",19760.0,2019-08-01,4,0,4
"DeRidder, LA",19760.0,2019-09-01,-12,0,-12
"DeRidder, LA",19760.0,2019-10-01,19,0,19
"DeRidder, LA",19760.0,2019-11-01,9,0,9
"DeRidder, LA",19760.0,2019-12-01,13,0,13
"DeRidder, LA",19760.0,2020-01-01,10,0,10
"DeRidder, LA",19760.0,2020-02-01,-3,0,-3
"DeRidder, LA",19760.0,2020-03-01,9,0,9
"DeRidder, LA",19760.0,2020-04-01,-7,0,-7
"DeRidder, LA",19760.0,2020-05-01,-10,0,-10
"DeRidder, LA",19760.0,2020-06-01,-1,0,-1
"DeRidder, LA",19760.0,2020-07-01,-7,0,-7
"DeRidder, LA",19760.0,2020-08-01,16,0,16
"DeRidder, LA",19760.0,2020-09-01,30,0,30
"DeRidder, LA",19760.0,2020-10-01,-6,0,-6
"DeRidder, LA",19760.0,2020-11-01,43,0,43
"DeRidder, LA",19760.0,2020-12-01,3,0,3
"Elk City, OK",21120.0,2019-01-01,0,0,0
"Elk City, OK",21120.0,2019-02-01,2,0,2
"Elk City, OK",21120.0,2019-03-01,0,0,0
"Elk City, OK",21120.0,2019-04-01,2,0,2
"Elk City, OK",21120.0,2019-05-01,0,0,0
"Elk City, OK",21120.0,2019-06-01,-24,0,-24
"Elk City, OK",21120.0,2019-07-01,-16,0,-16
"Elk City, OK",21120.0,2019-08-01,0,0,0
"Elk City, OK",21120.0,2019-09-01,0,0,0
"Elk City, OK",21120.0,2019-10-01,-12,0,-12
"Elk City, OK",21120.0,2019-11-01,11,0,11
"Elk City, OK",21120.0,2019-12-01,-13,0,-13
"Elk City, OK",21120.0,2020-01-01,-2,0,-2
"Elk City, OK",21120.0,2020-02-01,0,0,0
"Elk City, OK",21120.0,2020-03-01,-12,0,-12
"Elk City, OK",21120.0,2020-04-01,12,0,12
"Elk City, OK",21120.0,2020-05-01,0,0,0
"Elk City, OK",21120.0,2020-06-01,-11,0,-11
"Elk City, OK",21120.0,2020-07-01,-13,0,-13
"Elk City, OK",21120.0,2020-08-01,-19,0,-19
"Elk City, OK",21120.0,2020-09-01,-11,0,-11
"Elk City, OK",21120.0,2020-10-01,0,0,0
"Elk City, OK",21120.0,2020-11-01,0,0,0
"Elk City, OK",21120.0,2020-12-01,-27,-12,-15
"Shelbyville, TN",43180.0,2019-01-01,18,0,18
"Shelbyville, TN",43180.0,2019-02-01,10,0,10
"Shelbyville, TN",43180.0,2019-03-01,-19,0,-19
"Shelbyville, TN",43180.0,2019-04-01,31,0,31
"Shelbyville, TN",43180.0,2019-05-01,13,0,13
"Shelbyville, TN",43180.0,2019-06-01,23,0,23
"Shelbyville, TN",43180.0,2019-07-01,41,0,41
"Shelbyville, TN",43180.0,2019-08-01,21,0,21
"Shelbyville, TN",43180.0,2019-09-01,4,0,4
"Shelbyville, TN",43180.0,2019-10-01,-5,0,-5
"Shelbyville, TN",43180.0,2019-11-01,17,0,17
"Shelbyville, TN",43180.0,2019-12-01,-9,0,-9
"Shelbyville, TN",43180.0,2020-01-01,-19,0,-19
"Shelbyville, TN",43180.0,2020-02-01,-17,0,-17
"Shelbyville, TN",43180.0,2020-03-01,25,0,25
"Shelbyville, TN",43180.0,2020-04-01,27,0,27
"Shelbyville, TN",43180.0,2020-05-01,27,0,27
"Shelbyville, TN",43180.0,2020-06-01,-4,0,-4
"Shelbyville, TN",43180.0,2020-07-01,18,0,18
"Shelbyville, TN",43180.0,2020-08-01,53,0,53
"Shelbyville, TN",43180.0,2020-09-01,11,0,11
"Shelbyville, TN",43180.0,2020-10-01,21,0,21
"Shelbyville, TN",43180.0,2020-11-01,-1,0,-1
"Shelbyville, TN",43180.0,2020-12-01,0,0,0
"Beeville, TX",13300.0,2019-01-01,-38,0,-38
"Beeville, TX",13300.0,2019-02-01,24,0,24
"Beeville, TX",13300.0,2019-03-01,-26,0,-26
"Beeville, TX",13300.0,2019-04-01,0,0,0
"Beeville, TX",13300.0,2019-05-01,-1,0,-1
"Beeville, TX",13300.0,2019-06-01,11,0,11
"Beeville, TX",13300.0,2019-07-01,-5,0,-5
"Beeville, TX",13300.0,2019-08-01,0,0,0
"Beeville, TX",13300.0,2019-09-01,0,0,0
"Beeville, TX",13300.0,2019-10-01,0,0,0
"Beeville, TX",13300.0,2019-11-01,0,0,0
"Beeville, TX",13300.0,2019-12-01,0,0,0
"Beeville, TX",13300.0,2020-01-01,0,0,0
"Beeville, TX",13300.0,2020-02-01,11,0,11
"Beeville, TX",13300.0,2020-03-01,-12,0,-12
"Beeville, TX",13300.0,2020-04-01,0,0,0
"Beeville, TX",13300.0,2020-05-01,0,0,0
"Beeville, TX",13300.0,2020-06-01,0,0,0
"Beeville, TX",13300.0,2020-07-01,4,0,4
"Beeville, TX",13300.0,2020-08-01,0,0,0
"Beeville, TX",13300.0,2020-09-01,0,0,0
"Beeville, TX",13300.0,2020-10-01,0,0,0
"Beeville, TX",13300.0,2020-11-01,0,0,0
"Beeville, TX",13300.0,2020-12-01,0,0,0
"Laconia, NH",29060.0,2019-01-01,-96,-109,13
"Laconia, NH",29060.0,2019-02-01,39,0,39
"Laconia, NH",29060.0,2019-03-01,8,0,8
"Laconia, NH",29060.0,2019-04-01,205,171,34
"Laconia, NH",29060.0,2019-05-01,528,459,69
"Laconia, NH",29060.0,2019-06-01,243,160,83
"Laconia, NH",29060.0,2019-07-01,27,15,12
"Laconia, NH",29060.0,2019-08-01,54,0,54
"Laconia, NH",29060.0,2019-09-01,-41,-50,9
"Laconia, NH",29060.0,2019-10-01,-347,-354,7
"Laconia, NH",29060.0,2019-11-01,-168,-176,8
"Laconia, NH",29060.0,2019-12-01,-111,-153,42
"Laconia, NH",29060.0,2020-01-01,-93,-95,2
"Laconia, NH",29060.0,2020-02-01,-14,0,-14
"Laconia, NH",29060.0,2020-03-01,41,12,29
"Laconia, NH",29060.0,2020-04-01,146,85,61
"Laconia, NH",29060.0,2020-05-01,340,272,68
"Laconia, NH",29060.0,2020-06-01,277,216,61
"Laconia, NH",29060.0,2020-07-01,54,0,54
"Laconia, NH",29060.0,2020-08-01,127,17,110
"Laconia, NH",29060.0,2020-09-01,29,0,29
"Laconia, NH",29060.0,2020-10-01,-273,-315,42
"Laconia, NH",29060.0,2020-11-01,-52,-163,111
"Laconia, NH",29060.0,2020-12-01,-21,-94,73
"Middlesborough, KY",33180.0,2019-01-01,-2,0,-2
"Middlesborough, KY",33180.0,2019-02-01,0,0,0
"Middlesborough, KY",33180.0,2019-03-01,0,0,0
"Middlesborough, KY",33180.0,2019-04-01,-16,0,-16
"Middlesborough, KY",33180.0,2019-05-01,0,0,0
"Middlesborough, KY",33180.0,2019-06-01,-14,0,-14
"Middlesborough, KY",33180.0,2019-07-01,-21,0,-21
"Middlesborough, KY",33180.0,2019-08-01,-2,0,-2
"Middlesborough, KY",33180.0,2019-09-01,0,0,0
"Middlesborough, KY",33180.0,2019-10-01,-18,0,-18
"Middlesborough, KY",33180.0,2019-11-01,-11,0,-11
"Middlesborough, KY",33180.0,2019-12-01,12,0,12
"Middlesborough, KY",33180.0,2020-01-01,-8,0,-8
"Middlesborough, KY",33180.0,2020-02-01,-1,0,-1
"Middlesborough, KY",33180.0,2020-03-01,-5,0,-5
"Middlesborough, KY",33180.0,2020-04-01,4,0,4
"Middlesborough, KY",33180.0,2020-05-01,20,0,20
"Middlesborough, KY",33180.0,2020-06-01,4,0,4
"Middlesborough, KY",33180.0,2020-07-01,0,0,0
"Middlesborough, KY",33180.0,2020-08-01,12,0,12
"Middlesborough, KY",33180.0,2020-09-01,0,0,0
"Middlesborough, KY",33180.0,2020-10-01,0,0,0
"Middlesborough, KY",33180.0,2020-11-01,-11,0,-11
"Middlesborough, KY",33180.0,2020-12-01,-1,0,-1
"Killeen-Temple, TX",28660.0,2019-01-01,80,0,80
"Killeen-Temple, TX",28660.0,2019-02-01,10,0,10
"Killeen-Temple, TX",28660.0,2019-03-01,54,0,54
"Killeen-Temple, TX",28660.0,2019-04-01,91,0,91
"Killeen-Temple, TX",28660.0,2019-05-01,78,-12,90
"Killeen-Temple, TX",28660.0,2019-06-01,2,-11,13
"Killeen-Temple, TX",28660.0,2019-07-01,122,0,122
"Killeen-Temple, TX",28660.0,2019-08-01,-8,0,-8
"Killeen-Temple, TX",28660.0,2019-09-01,15,0,15
"Killeen-Temple, TX",28660.0,2019-10-01,34,0,34
"Killeen-Temple, TX",28660.0,2019-11-01,14,-12,26
"Killeen-Temple, TX",28660.0,2019-12-01,76,0,76
"Killeen-Temple, TX",28660.0,2020-01-01,72,2,70
"Killeen-Temple, TX",28660.0,2020-02-01,121,0,121
"Killeen-Temple, TX",28660.0,2020-03-01,157,0,157
"Killeen-Temple, TX",28660.0,2020-04-01,142,0,142
"Killeen-Temple, TX",28660.0,2020-05-01,192,0,192
"Killeen-Temple, TX",28660.0,2020-06-01,277,0,277
"Killeen-Temple, TX",28660.0,2020-07-01,304,0,304
"Killeen-Temple, TX",28660.0,2020-08-01,4,0,4
"Killeen-Temple, TX",28660.0,2020-09-01,61,0,61
"Killeen-Temple, TX",28660.0,2020-10-01,173,0,173
"Killeen-Temple, TX",28660.0,2020-11-01,73,0,73
"Killeen-Temple, TX",28660.0,2020-12-01,10,0,10
"Wheeling, WV-OH",48540.0,2019-01-01,-22,-12,-10
"Wheeling, WV-OH",48540.0,2019-02-01,-24,0,-24
"Wheeling, WV-OH",48540.0,2019-03-01,-4,0,-4
"Wheeling, WV-OH",48540.0,2019-04-01,6,0,6
"Wheeling, WV-OH",48540.0,2019-05-01,-14,0,-14
"Wheeling, WV-OH",48540.0,2019-06-01,-17,0,-17
"Wheeling, WV-OH",48540.0,2019-07-01,5,0,5
"Wheeling, WV-OH",48540.0,2019-08-01,-22,0,-22
"Wheeling, WV-OH",48540.0,2019-09-01,-31,0,-31
"Wheeling, WV-OH",48540.0,2019-10-01,8,0,8
"Wheeling, WV-OH",48540.0,2019-11-01,-8,0,-8
"Wheeling, WV-OH",48540.0,2019-12-01,4,-11,15
"Wheeling, WV-OH",48540.0,2020-01-01,35,0,35
"Wheeling, WV-OH",48540.0,2020-02-01,5,0,5
"Wheeling, WV-OH",48540.0,2020-03-01,-5,0,-5
"Wheeling, WV-OH",48540.0,2020-04-01,-5,0,-5
"Wheeling, WV-OH",48540.0,2020-05-01,-19,0,-19
"Wheeling, WV-OH",48540.0,2020-06-01,-7,0,-7
"Wheeling, WV-OH",48540.0,2020-07-01,9,0,9
"Wheeling, WV-OH",48540.0,2020-08-01,9,0,9
"Wheeling, WV-OH",48540.0,2020-09-01,-25,0,-25
"Wheeling, WV-OH",48540.0,2020-10-01,3,0,3
"Wheeling, WV-OH",48540.0,2020-11-01,-15,0,-15
"Wheeling, WV-OH",48540.0,2020-12-01,0,0,0
"Bemidji, MN",13420.0,2019-01-01,-27,-27,0
"Bemidji, MN",13420.0,2019-02-01,0,0,0
"Bemidji, MN",13420.0,2019-03-01,-12,0,-12
"Bemidji, MN",13420.0,2019-04-01,60,47,13
"Bemidji, MN",13420.0,2019-05-01,28,36,-8
"Bemidji, MN",13420.0,2019-06-01,29,0,29
"Bemidji, MN",13420.0,2019-07-01,0,0,0
"Bemidji, MN",13420.0,2019-08-01,-5,0,-5
"Bemidji, MN",13420.0,2019-09-01,-28,0,-28
"Bemidji, MN",13420.0,2019-10-01,-85,-55,-30
"Bemidji, MN",13420.0,2019-11-01,-28,-28,0
"Bemidji, MN",13420.0,2019-12-01,-35,-21,-14
"Bemidji, MN",13420.0,2020-01-01,-35,-35,0
"Bemidji, MN",13420.0,2020-02-01,-11,0,-11
"Bemidji, MN",13420.0,2020-03-01,11,0,11
"Bemidji, MN",13420.0,2020-04-01,34,18,16
"Bemidji, MN",13420.0,2020-05-01,11,29,-18
"Bemidji, MN",13420.0,2020-06-01,-12,11,-23
"Bemidji, MN",13420.0,2020-07-01,-42,0,-42
"Bemidji, MN",13420.0,2020-08-01,19,0,19
"Bemidji, MN",13420.0,2020-09-01,-21,0,-21
"Bemidji, MN",13420.0,2020-10-01,-47,-48,1
"Bemidji, MN",13420.0,2020-11-01,-11,-38,27
"Bemidji, MN",13420.0,2020-12-01,-26,-26,0
"Fitzgerald, GA",22340.0,2019-01-01,14,0,14
"Fitzgerald, GA",22340.0,2019-02-01,0,0,0
"Fitzgerald, GA",22340.0,2019-03-01,11,0,11
"Fitzgerald, GA",22340.0,2019-04-01,13,0,13
"Fitzgerald, GA",22340.0,2019-05-01,15,0,15
"Fitzgerald, GA",22340.0,2019-06-01,0,0,0
"Fitzgerald, GA",22340.0,2019-07-01,0,0,0
"Fitzgerald, GA",22340.0,2019-08-01,0,0,0
"Fitzgerald, GA",22340.0,2019-09-01,0,0,0
"Fitzgerald, GA",22340.0,2019-10-01,0,0,0
"Fitzgerald, GA",22340.0,2019-11-01,0,0,0
"Fitzgerald, GA",22340.0,2019-12-01,0,0,0
"Fitzgerald, GA",22340.0,2020-01-01,0,0,0
"Fitzgerald, GA",22340.0,2020-02-01,3,0,3
"Fitzgerald, GA",22340.0,2020-03-01,0,0,0
"Fitzgerald, GA",22340.0,2020-04-01,7,0,7
"Fitzgerald, GA",22340.0,2020-05-01,0,0,0
"Fitzgerald, GA",22340.0,2020-06-01,0,0,0
"Fitzgerald, GA",22340.0,2020-07-01,-11,0,-11
"Fitzgerald, GA",22340.0,2020-08-01,0,0,0
"Fitzgerald, GA",22340.0,2020-09-01,-12,0,-12
"Fitzgerald, GA",22340.0,2020-10-01,12,0,12
"Fitzgerald, GA",22340.0,2020-11-01,-13,0,-13
"Fitzgerald, GA",22340.0,2020-12-01,0,0,0
"Bennington, VT",13540.0,2019-01-01,2,0,2
"Bennington, VT",13540.0,2019-02-01,12,0,12
"Bennington, VT",13540.0,2019-03-01,11,0,11
"Bennington, VT",13540.0,2019-04-01,22,11,11
"Bennington, VT",13540.0,2019-05-01,91,93,-2
"Bennington, VT",13540.0,2019-06-01,38,22,16
"Bennington, VT",13540.0,2019-07-01,11,0,11
"Bennington, VT",13540.0,2019-08-01,-8,0,-8
"Bennington, VT",13540.0,2019-09-01,0,0,0
"Bennington, VT",13540.0,2019-10-01,-59,-70,11
"Bennington, VT",13540.0,2019-11-01,-13,-11,-2
"Bennington, VT",13540.0,2019-12-01,-16,-28,12
"Bennington, VT",13540.0,2020-01-01,0,0,0
"Bennington, VT",13540.0,2020-02-01,13,0,13
"Bennington, VT",13540.0,2020-03-01,74,72,2
"Bennington, VT",13540.0,2020-04-01,47,47,0
"Bennington, VT",13540.0,2020-05-01,135,108,27
"Bennington, VT",13540.0,2020-06-01,106,93,13
"Bennington, VT",13540.0,2020-07-01,16,17,-1
"Bennington, VT",13540.0,2020-08-01,66,26,40
"Bennington, VT",13540.0,2020-09-01,15,15,0
"Bennington, VT",13540.0,2020-10-01,-28,-56,28
"Bennington, VT",13540.0,2020-11-01,46,12,34
"Bennington, VT",13540.0,2020-12-01,-12,-12,0
"Fayetteville-Springdale-Rogers, AR",22220.0,2019-01-01,100,0,100
"Fayetteville-Springdale-Rogers, AR",22220.0,2019-02-01,-2,0,-2
"Fayetteville-Springdale-Rogers, AR",22220.0,2019-03-01,8,0,8
"Fayetteville-Springdale-Rogers, AR",22220.0,2019-04-01,45,0,45
"Fayetteville-Springdale-Rogers, AR",22220.0,2019-05-01,34,11,23
"Fayetteville-Springdale-Rogers, AR",22220.0,2019-06-01,151,11,140
"Fayetteville-Springdale-Rogers, AR",22220.0,2019-07-01,43,0,43
"Fayetteville-Springdale-Rogers, AR",22220.0,2019-08-01,96,0,96
"Fayetteville-Springdale-Rogers, AR",22220.0,2019-09-01,144,0,144
"Fayetteville-Springdale-Rogers, AR",22220.0,2019-10-01,113,0,113
"Fayetteville-Springdale-Rogers, AR",22220.0,2019-11-01,28,0,28
"Fayetteville-Springdale-Rogers, AR",22220.0,2019-12-01,40,-14,54
"Fayetteville-Springdale-Rogers, AR",22220.0,2020-01-01,21,0,21
"Fayetteville-Springdale-Rogers, AR",22220.0,2020-02-01,71,0,71
"Fayetteville-Springdale-Rogers, AR",22220.0,2020-03-01,112,0,112
"Fayetteville-Springdale-Rogers, AR",22220.0,2020-04-01,124,12,112
"Fayetteville-Springdale-Rogers, AR",22220.0,2020-05-01,102,13,89
"Fayetteville-Springdale-Rogers, AR",22220.0,2020-06-01,217,0,217
"Fayetteville-Springdale-Rogers, AR",22220.0,2020-07-01,-34,0,-34
"Fayetteville-Springdale-Rogers, AR",22220.0,2020-08-01,69,0,69
"Fayetteville-Springdale-Rogers, AR",22220.0,2020-09-01,136,0,136
"Fayetteville-Springdale-Rogers, AR",22220.0,2020-10-01,59,0,59
"Fayetteville-Springdale-Rogers, AR",22220.0,2020-11-01,106,0,106
"Fayetteville-Springdale-Rogers, AR",22220.0,2020-12-01,-7,0,-7
"Cedar Rapids, IA",16300.0,2019-01-01,-140,-154,14
"Cedar Rapids, IA",16300.0,2019-02-01,7,-11,18
"Cedar Rapids, IA",16300.0,2019-03-01,90,11,79
"Cedar Rapids, IA",16300.0,2019-04-01,193,104,89
"Cedar Rapids, IA",16300.0,2019-05-01,147,72,75
"Cedar Rapids, IA",16300.0,2019-06-01,74,0,74
"Cedar Rapids, IA",16300.0,2019-07-01,56,0,56
"Cedar Rapids, IA",16300.0,2019-08-01,0,0,0
"Cedar Rapids, IA",16300.0,2019-09-01,-18,-12,-6
"Cedar Rapids, IA",16300.0,2019-10-01,-183,-138,-45
"Cedar Rapids, IA",16300.0,2019-11-01,-162,-170,8
"Cedar Rapids, IA",16300.0,2019-12-01,-285,-290,5
"Cedar Rapids, IA",16300.0,2020-01-01,-139,-148,9
"Cedar Rapids, IA",16300.0,2020-02-01,-49,0,-49
"Cedar Rapids, IA",16300.0,2020-03-01,80,16,64
"Cedar Rapids, IA",16300.0,2020-04-01,94,47,47
"Cedar Rapids, IA",16300.0,2020-05-01,175,74,101
"Cedar Rapids, IA",16300.0,2020-06-01,86,31,55
"Cedar Rapids, IA",16300.0,2020-07-01,106,0,106
"Cedar Rapids, IA",16300.0,2020-08-01,-150,-16,-134
"Cedar Rapids, IA",16300.0,2020-09-01,-63,0,-63
"Cedar Rapids, IA",16300.0,2020-10-01,-231,-143,-88
"Cedar Rapids, IA",16300.0,2020-11-01,-249,-164,-85
"Cedar Rapids, IA",16300.0,2020-12-01,-306,-227,-79
"Lafayette-West Lafayette, IN",29200.0,2019-01-01,-114,-27,-87
"Lafayette-West Lafayette, IN",29200.0,2019-02-01,-15,0,-15
"Lafayette-West Lafayette, IN",29200.0,2019-03-01,-3,0,-3
"Lafayette-West Lafayette, IN",29200.0,2019-04-01,6,26,-20
"Lafayette-West Lafayette, IN",29200.0,2019-05-01,-114,32,-146
"Lafayette-West Lafayette, IN",29200.0,2019-06-01,-92,0,-92
"Lafayette-West Lafayette, IN",29200.0,2019-07-01,-237,0,-237
"Lafayette-West Lafayette, IN",29200.0,2019-08-01,-70,0,-70
"Lafayette-West Lafayette, IN",29200.0,2019-09-01,-26,0,-26
"Lafayette-West Lafayette, IN",29200.0,2019-10-01,-17,-24,7
"Lafayette-West Lafayette, IN",29200.0,2019-11-01,17,-27,44
"Lafayette-West Lafayette, IN",29200.0,2019-12-01,-103,-100,-3
"Lafayette-West Lafayette, IN",29200.0,2020-01-01,-40,-41,1
"Lafayette-West Lafayette, IN",29200.0,2020-02-01,-35,0,-35
"Lafayette-West Lafayette, IN",29200.0,2020-03-01,36,0,36
"Lafayette-West Lafayette, IN",29200.0,2020-04-01,-68,0,-68
"Lafayette-West Lafayette, IN",29200.0,2020-05-01,-90,16,-106
"Lafayette-West Lafayette, IN",29200.0,2020-06-01,-123,0,-123
"Lafayette-West Lafayette, IN",29200.0,2020-07-01,-233,0,-233
"Lafayette-West Lafayette, IN",29200.0,2020-08-01,93,0,93
"Lafayette-West Lafayette, IN",29200.0,2020-09-01,-24,0,-24
"Lafayette-West Lafayette, IN",29200.0,2020-10-01,-36,-31,-5
"Lafayette-West Lafayette, IN",29200.0,2020-11-01,-39,-32,-7
"Lafayette-West Lafayette, IN",29200.0,2020-12-01,-184,-130,-54
"St. Cloud, MN",41060.0,2019-01-01,-185,-165,-20
"St. Cloud, MN",41060.0,2019-02-01,1,-14,15
"St. Cloud, MN",41060.0,2019-03-01,64,0,64
"St. Cloud, MN",41060.0,2019-04-01,267,153,114
"St. Cloud, MN",41060.0,2019-05-01,66,87,-21
"St. Cloud, MN",41060.0,2019-06-01,-66,18,-84
"St. Cloud, MN",41060.0,2019-07-01,-28,0,-28
"St. Cloud, MN",41060.0,2019-08-01,-24,0,-24
"St. Cloud, MN",41060.0,2019-09-01,-31,-14,-17
"St. Cloud, MN",41060.0,2019-10-01,-175,-172,-3
"St. Cloud, MN",41060.0,2019-11-01,-249,-160,-89
"St. Cloud, MN",41060.0,2019-12-01,-264,-210,-54
"St. Cloud, MN",41060.0,2020-01-01,-169,-112,-57
"St. Cloud, MN",41060.0,2020-02-01,-36,-14,-22
"St. Cloud, MN",41060.0,2020-03-01,102,38,64
"St. Cloud, MN",41060.0,2020-04-01,94,74,20
"St. Cloud, MN",41060.0,2020-05-01,40,96,-56
"St. Cloud, MN",41060.0,2020-06-01,-9,15,-24
"St. Cloud, MN",41060.0,2020-07-01,59,13,46
"St. Cloud, MN",41060.0,2020-08-01,25,0,25
"St. Cloud, MN",41060.0,2020-09-01,-7,-14,7
"St. Cloud, MN",41060.0,2020-10-01,-132,-168,36
"St. Cloud, MN",41060.0,2020-11-01,-73,-128,55
"St. Cloud, MN",41060.0,2020-12-01,-139,-154,15
"Corvallis, OR",18700.0,2019-01-01,-86,0,-86
"Corvallis, OR",18700.0,2019-02-01,-67,0,-67
"Corvallis, OR",18700.0,2019-03-01,-101,0,-101
"Corvallis, OR",18700.0,2019-04-01,-75,0,-75
"Corvallis, OR",18700.0,2019-05-01,-49,16,-65
"Corvallis, OR",18700.0,2019-06-01,-369,0,-369
"Corvallis, OR",18700.0,2019-07-01,-268,0,-268
"Corvallis, OR",18700.0,2019-08-01,-143,0,-143
"Corvallis, OR",18700.0,2019-09-01,-35,0,-35
"Corvallis, OR",18700.0,2019-10-01,-32,-13,-19
"Corvallis, OR",18700.0,2019-11-01,-65,0,-65
"Corvallis, OR",18700.0,2019-12-01,-50,0,-50
"Corvallis, OR",18700.0,2020-01-01,-80,0,-80
"Corvallis, OR",18700.0,2020-02-01,-113,0,-113
"Corvallis, OR",18700.0,2020-03-01,-81,-11,-70
"Corvallis, OR",18700.0,2020-04-01,-126,0,-126
"Corvallis, OR",18700.0,2020-05-01,-80,0,-80
"Corvallis, OR",18700.0,2020-06-01,-287,0,-287
"Corvallis, OR",18700.0,2020-07-01,-164,0,-164
"Corvallis, OR",18700.0,2020-08-01,-33,0,-33
"Corvallis, OR",18700.0,2020-09-01,40,0,40
"Corvallis, OR",18700.0,2020-10-01,-47,0,-47
"Corvallis, OR",18700.0,2020-11-01,10,0,10
"Corvallis, OR",18700.0,2020-12-01,-46,0,-46
"Kennewick-Richland, WA",28420.0,2019-01-01,15,-16,31
"Kennewick-Richland, WA",28420.0,2019-02-01,47,0,47
"Kennewick-Richland, WA",28420.0,2019-03-01,146,0,146
"Kennewick-Richland, WA",28420.0,2019-04-01,174,45,129
"Kennewick-Richland, WA",28420.0,2019-05-01,217,24,193
"Kennewick-Richland, WA",28420.0,2019-06-01,79,0,79
"Kennewick-Richland, WA",28420.0,2019-07-01,139,0,139
"Kennewick-Richland, WA",28420.0,2019-08-01,131,0,131
"Kennewick-Richland, WA",28420.0,2019-09-01,25,-15,40
"Kennewick-Richland, WA",28420.0,2019-10-01,-33,-131,98
"Kennewick-Richland, WA",28420.0,2019-11-01,24,-71,95
"Kennewick-Richland, WA",28420.0,2019-12-01,-5,-36,31
"Kennewick-Richland, WA",28420.0,2020-01-01,-21,-43,22
"Kennewick-Richland, WA",28420.0,2020-02-01,13,0,13
"Kennewick-Richland, WA",28420.0,2020-03-01,153,25,128
"Kennewick-Richland, WA",28420.0,2020-04-01,103,-12,115
"Kennewick-Richland, WA",28420.0,2020-05-01,192,22,170
"Kennewick-Richland, WA",28420.0,2020-06-01,177,13,164
"Kennewick-Richland, WA",28420.0,2020-07-01,81,0,81
"Kennewick-Richland, WA",28420.0,2020-08-01,60,0,60
"Kennewick-Richland, WA",28420.0,2020-09-01,100,-11,111
"Kennewick-Richland, WA",28420.0,2020-10-01,68,-95,163
"Kennewick-Richland, WA",28420.0,2020-11-01,65,-35,100
"Kennewick-Richland, WA",28420.0,2020-12-01,62,-29,91
"Traverse City, MI",45900.0,2019-01-01,-193,-239,46
"Traverse City, MI",45900.0,2019-02-01,28,-12,40
"Traverse City, MI",45900.0,2019-03-01,14,0,14
"Traverse City, MI",45900.0,2019-04-01,342,263,79
"Traverse City, MI",45900.0,2019-05-01,594,595,-1
"Traverse City, MI",45900.0,2019-06-01,203,146,57
"Traverse City, MI",45900.0,2019-07-01,51,0,51
"Traverse City, MI",45900.0,2019-08-01,-25,0,-25
"Traverse City, MI",45900.0,2019-09-01,-20,-23,3
"Traverse City, MI",45900.0,2019-10-01,-626,-589,-37
"Traverse City, MI",45900.0,2019-11-01,-340,-381,41
"Traverse City, MI",45900.0,2019-12-01,-253,-286,33
"Traverse City, MI",45900.0,2020-01-01,-252,-224,-28
"Traverse City, MI",45900.0,2020-02-01,-23,-13,-10
"Traverse City, MI",45900.0,2020-03-01,70,32,38
"Traverse City, MI",45900.0,2020-04-01,215,85,130
"Traverse City, MI",45900.0,2020-05-01,385,343,42
"Traverse City, MI",45900.0,2020-06-01,353,282,71
"Traverse City, MI",45900.0,2020-07-01,60,11,49
"Traverse City, MI",45900.0,2020-08-01,35,0,35
"Traverse City, MI",45900.0,2020-09-01,42,0,42
"Traverse City, MI",45900.0,2020-10-01,-664,-589,-75
"Traverse City, MI",45900.0,2020-11-01,-345,-344,-1
"Traverse City, MI",45900.0,2020-12-01,-218,-265,47
"New York-Newark-Jersey City, NY-NJ-PA",35620.0,2019-01-01,-16335,-10859,-5476
"New York-Newark-Jersey City, NY-NJ-PA",35620.0,2019-02-01,-5288,-1239,-4049
"New York-Newark-Jersey City, NY-NJ-PA",35620.0,2019-03-01,-2795,795,-3590
"New York-Newark-Jersey City, NY-NJ-PA",35620.0,2019-04-01,6272,7577,-1305
"New York-Newark-Jersey City, NY-NJ-PA",35620.0,2019-05-01,9871,13416,-3545
"New York-Newark-Jersey City, NY-NJ-PA",35620.0,2019-06-01,-5237,4095,-9332
"New York-Newark-Jersey City, NY-NJ-PA",35620.0,2019-07-01,-9680,1124,-10804
"New York-Newark-Jersey City, NY-NJ-PA",35620.0,2019-08-01,-9439,487,-9926
"New York-Newark-Jersey City, NY-NJ-PA",35620.0,2019-09-01,-8406,-706,-7700
"New York-Newark-Jersey City, NY-NJ-PA",35620.0,2019-10-01,-13688,-5887,-7801
"New York-Newark-Jersey City, NY-NJ-PA",35620.0,2019-11-01,-8945,-3287,-5658
"New York-Newark-Jersey City, NY-NJ-PA",35620.0,2019-12-01,-15418,-9697,-5721
"New York-Newark-Jersey City, NY-NJ-PA",35620.0,2020-01-01,-14940,-9319,-5621
"New York-Newark-Jersey City, NY-NJ-PA",35620.0,2020-02-01,-5402,-1232,-4170
"New York-Newark-Jersey City, NY-NJ-PA",35620.0,2020-03-01,-25069,-16726,-8343
"New York-Newark-Jersey City, NY-NJ-PA",35620.0,2020-04-01,-24932,-15905,-9027
"New York-Newark-Jersey City, NY-NJ-PA",35620.0,2020-05-01,-19688,-8005,-11683
"New York-Newark-Jersey City, NY-NJ-PA",35620.0,2020-06-01,-15750,669,-16419
"New York-Newark-Jersey City, NY-NJ-PA",35620.0,2020-07-01,-19148,-51,-19097
"New York-Newark-Jersey City, NY-NJ-PA",35620.0,2020-08-01,-20555,-1424,-19131
"New York-Newark-Jersey City, NY-NJ-PA",35620.0,2020-09-01,-19955,-2749,-17206
"New York-Newark-Jersey City, NY-NJ-PA",35620.0,2020-10-01,-23014,-7059,-15955
"New York-Newark-Jersey City, NY-NJ-PA",35620.0,2020-11-01,-20454,-7846,-12608
"New York-Newark-Jersey City, NY-NJ-PA",35620.0,2020-12-01,-24522,-11937,-12585
"Charleston-North Charleston, SC",16700.0,2019-01-01,123,22,101
"Charleston-North Charleston, SC",16700.0,2019-02-01,-7,0,-7
"Charleston-North Charleston, SC",16700.0,2019-03-01,85,0,85
"Charleston-North Charleston, SC",16700.0,2019-04-01,49,0,49
"Charleston-North Charleston, SC",16700.0,2019-05-01,45,-14,59
"Charleston-North Charleston, SC",16700.0,2019-06-01,2,-17,19
"Charleston-North Charleston, SC",16700.0,2019-07-01,134,0,134
"Charleston-North Charleston, SC",16700.0,2019-08-01,117,0,117
"Charleston-North Charleston, SC",16700.0,2019-09-01,-32,0,-32
"Charleston-North Charleston, SC",16700.0,2019-10-01,20,23,-3
"Charleston-North Charleston, SC",16700.0,2019-11-01,98,0,98
"Charleston-North Charleston, SC",16700.0,2019-12-01,-74,0,-74
"Charleston-North Charleston, SC",16700.0,2020-01-01,5,51,-46
"Charleston-North Charleston, SC",16700.0,2020-02-01,48,11,37
"Charleston-North Charleston, SC",16700.0,2020-03-01,40,100,-60
"Charleston-North Charleston, SC",16700.0,2020-04-01,161,103,58
"Charleston-North Charleston, SC",16700.0,2020-05-01,159,63,96
"Charleston-North Charleston, SC",16700.0,2020-06-01,50,17,33
"Charleston-North Charleston, SC",16700.0,2020-07-01,155,34,121
"Charleston-North Charleston, SC",16700.0,2020-08-01,147,15,132
"Charleston-North Charleston, SC",16700.0,2020-09-01,289,27,262
"Charleston-North Charleston, SC",16700.0,2020-10-01,134,36,98
"Charleston-North Charleston, SC",16700.0,2020-11-01,146,56,90
"Charleston-North Charleston, SC",16700.0,2020-12-01,-42,89,-131
"Hagerstown-Martinsburg, MD-WV",25180.0,2019-01-01,104,0,104
"Hagerstown-Martinsburg, MD-WV",25180.0,2019-02-01,129,0,129
"Hagerstown-Martinsburg, MD-WV",25180.0,2019-03-01,111,0,111
"Hagerstown-Martinsburg, MD-WV",25180.0,2019-04-01,130,0,130
"Hagerstown-Martinsburg, MD-WV",25180.0,2019-05-01,154,0,154
"Hagerstown-Martinsburg, MD-WV",25180.0,2019-06-01,226,0,226
"Hagerstown-Martinsburg, MD-WV",25180.0,2019-07-01,162,0,162
"Hagerstown-Martinsburg, MD-WV",25180.0,2019-08-01,164,0,164
"Hagerstown-Martinsburg, MD-WV",25180.0,2019-09-01,93,0,93
"Hagerstown-Martinsburg, MD-WV",25180.0,2019-10-01,166,0,166
"Hagerstown-Martinsburg, MD-WV",25180.0,2019-11-01,117,0,117
"Hagerstown-Martinsburg, MD-WV",25180.0,2019-12-01,109,0,109
"Hagerstown-Martinsburg, MD-WV",25180.0,2020-01-01,80,0,80
"Hagerstown-Martinsburg, MD-WV",25180.0,2020-02-01,122,0,122
"Hagerstown-Martinsburg, MD-WV",25180.0,2020-03-01,108,0,108
"Hagerstown-Martinsburg, MD-WV",25180.0,2020-04-01,183,0,183
"Hagerstown-Martinsburg, MD-WV",25180.0,2020-05-01,240,0,240
"Hagerstown-Martinsburg, MD-WV",25180.0,2020-06-01,160,0,160
"Hagerstown-Martinsburg, MD-WV",25180.0,2020-07-01,185,0,185
"Hagerstown-Martinsburg, MD-WV",25180.0,2020-08-01,273,0,273
"Hagerstown-Martinsburg, MD-WV",25180.0,2020-09-01,263,0,263
"Hagerstown-Martinsburg, MD-WV",25180.0,2020-10-01,263,0,263
"Hagerstown-Martinsburg, MD-WV",25180.0,2020-11-01,127,0,127
"Hagerstown-Martinsburg, MD-WV",25180.0,2020-12-01,256,0,256
"Reading, PA",39740.0,2019-01-01,-83,-96,13
"Reading, PA",39740.0,2019-02-01,-15,0,-15
"Reading, PA",39740.0,2019-03-01,-3,0,-3
"Reading, PA",39740.0,2019-04-01,180,26,154
"Reading, PA",39740.0,2019-05-01,72,45,27
"Reading, PA",39740.0,2019-06-01,-25,0,-25
"Reading, PA",39740.0,2019-07-01,-2,0,-2
"Reading, PA",39740.0,2019-08-01,6,0,6
"Reading, PA",39740.0,2019-09-01,112,0,112
"Reading, PA",39740.0,2019-10-01,13,-27,40
"Reading, PA",39740.0,2019-11-01,77,-11,88
"Reading, PA",39740.0,2019-12-01,-41,-79,38
"Reading, PA",39740.0,2020-01-01,39,-107,146
"Reading, PA",39740.0,2020-02-01,56,0,56
"Reading, PA",39740.0,2020-03-01,94,13,81
"Reading, PA",39740.0,2020-04-01,74,35,39
"Reading, PA",39740.0,2020-05-01,109,26,83
"Reading, PA",39740.0,2020-06-01,159,12,147
"Reading, PA",39740.0,2020-07-01,14,0,14
"Reading, PA",39740.0,2020-08-01,66,0,66
"Reading, PA",39740.0,2020-09-01,96,0,96
"Reading, PA",39740.0,2020-10-01,82,-12,94
"Reading, PA",39740.0,2020-11-01,19,-11,30
"Reading, PA",39740.0,2020-12-01,77,-39,116
"Pittsfield, MA",38340.0,2019-01-01,-186,-167,-19
"Pittsfield, MA",38340.0,2019-02-01,-7,0,-7
"Pittsfield, MA",38340.0,2019-03-01,-36,-12,-24
"Pittsfield, MA",38340.0,2019-04-01,204,185,19
"Pittsfield, MA",38340.0,2019-05-01,608,561,47
"Pittsfield, MA",38340.0,2019-06-01,374,335,39
"Pittsfield, MA",38340.0,2019-07-01,72,55,17
"Pittsfield, MA",38340.0,2019-08-01,-32,-26,-6
"Pittsfield, MA",38340.0,2019-09-01,-225,-108,-117
"Pittsfield, MA",38340.0,2019-10-01,-486,-417,-69
"Pittsfield, MA",38340.0,2019-11-01,-142,-132,-10
"Pittsfield, MA",38340.0,2019-12-01,-211,-186,-25
"Pittsfield, MA",38340.0,2020-01-01,-175,-174,-1
"Pittsfield, MA",38340.0,2020-02-01,-7,0,-7
"Pittsfield, MA",38340.0,2020-03-01,619,540,79
"Pittsfield, MA",38340.0,2020-04-01,401,375,26
"Pittsfield, MA",38340.0,2020-05-01,599,498,101
"Pittsfield, MA",38340.0,2020-06-01,586,513,73
"Pittsfield, MA",38340.0,2020-07-01,292,190,102
"Pittsfield, MA",38340.0,2020-08-01,224,108,116
"Pittsfield, MA",38340.0,2020-09-01,201,151,50
"Pittsfield, MA",38340.0,2020-10-01,-223,-227,4
"Pittsfield, MA",38340.0,2020-11-01,-19,-54,35
"Pittsfield, MA",38340.0,2020-12-01,-21,-86,65
"Albuquerque, NM",10740.0,2019-01-01,0,-27,27
"Albuquerque, NM",10740.0,2019-02-01,52,0,52
"Albuquerque, NM",10740.0,2019-03-01,68,0,68
"Albuquerque, NM",10740.0,2019-04-01,63,19,44
"Albuquerque, NM",10740.0,2019-05-01,168,30,138
"Albuquerque, NM",10740.0,2019-06-01,-37,12,-49
"Albuquerque, NM",10740.0,2019-07-01,37,0,37
"Albuquerque, NM",10740.0,2019-08-01,42,0,42
"Albuquerque, NM",10740.0,2019-09-01,-29,0,-29
"Albuquerque, NM",10740.0,2019-10-01,-114,-22,-92
"Albuquerque, NM",10740.0,2019-11-01,19,-17,36
"Albuquerque, NM",10740.0,2019-12-01,36,-6,42
"Albuquerque, NM",10740.0,2020-01-01,4,-39,43
"Albuquerque, NM",10740.0,2020-02-01,-25,-2,-23
"Albuquerque, NM",10740.0,2020-03-01,96,34,62
"Albuquerque, NM",10740.0,2020-04-01,130,42,88
"Albuquerque, NM",10740.0,2020-05-01,73,50,23
"Albuquerque, NM",10740.0,2020-06-01,43,24,19
"Albuquerque, NM",10740.0,2020-07-01,212,14,198
"Albuquerque, NM",10740.0,2020-08-01,-122,-16,-106
"Albuquerque, NM",10740.0,2020-09-01,6,12,-6
"Albuquerque, NM",10740.0,2020-10-01,34,-28,62
"Albuquerque, NM",10740.0,2020-11-01,63,3,60
"Albuquerque, NM",10740.0,2020-12-01,76,-6,82
"Niles, MI",35660.0,2019-01-01,-102,-109,7
"Niles, MI",35660.0,2019-02-01,-2,0,-2
"Niles, MI",35660.0,2019-03-01,20,0,20
"Niles, MI",35660.0,2019-04-01,204,182,22
"Niles, MI",35660.0,2019-05-01,157,192,-35
"Niles, MI",35660.0,2019-06-01,89,64,25
"Niles, MI",35660.0,2019-07-01,-9,0,-9
"Niles, MI",35660.0,2019-08-01,1,0,1
"Niles, MI",35660.0,2019-09-01,-25,-11,-14
"Niles, MI",35660.0,2019-10-01,-260,-248,-12
"Niles, MI",35660.0,2019-11-01,-209,-214,5
"Niles, MI",35660.0,2019-12-01,-261,-243,-18
"Niles, MI",35660.0,2020-01-01,-120,-126,6
"Niles, MI",35660.0,2020-02-01,-8,0,-8
"Niles, MI",35660.0,2020-03-01,69,85,-16
"Niles, MI",35660.0,2020-04-01,170,105,65
"Niles, MI",35660.0,2020-05-01,265,210,55
"Niles, MI",35660.0,2020-06-01,163,157,6
"Niles, MI",35660.0,2020-07-01,56,21,35
"Niles, MI",35660.0,2020-08-01,77,19,58
"Niles, MI",35660.0,2020-09-01,72,10,62
"Niles, MI",35660.0,2020-10-01,-166,-186,20
"Niles, MI",35660.0,2020-11-01,-154,-185,31
"Niles, MI",35660.0,2020-12-01,-175,-156,-19
"Birmingham-Hoover, AL",13820.0,2019-01-01,41,12,29
"Birmingham-Hoover, AL",13820.0,2019-02-01,-37,0,-37
"Birmingham-Hoover, AL",13820.0,2019-03-01,-75,0,-75
"Birmingham-Hoover, AL",13820.0,2019-04-01,-23,-12,-11
"Birmingham-Hoover, AL",13820.0,2019-05-01,-65,0,-65
"Birmingham-Hoover, AL",13820.0,2019-06-01,138,0,138
"Birmingham-Hoover, AL",13820.0,2019-07-01,83,0,83
"Birmingham-Hoover, AL",13820.0,2019-08-01,-81,0,-81
"Birmingham-Hoover, AL",13820.0,2019-09-01,-39,0,-39
"Birmingham-Hoover, AL",13820.0,2019-10-01,-31,0,-31
"Birmingham-Hoover, AL",13820.0,2019-11-01,-41,0,-41
"Birmingham-Hoover, AL",13820.0,2019-12-01,-33,0,-33
"Birmingham-Hoover, AL",13820.0,2020-01-01,71,0,71
"Birmingham-Hoover, AL",13820.0,2020-02-01,-21,0,-21
"Birmingham-Hoover, AL",13820.0,2020-03-01,-189,-17,-172
"Birmingham-Hoover, AL",13820.0,2020-04-01,-198,0,-198
"Birmingham-Hoover, AL",13820.0,2020-05-01,-265,-14,-251
"Birmingham-Hoover, AL",13820.0,2020-06-01,-45,0,-45
"Birmingham-Hoover, AL",13820.0,2020-07-01,10,0,10
"Birmingham-Hoover, AL",13820.0,2020-08-01,-77,0,-77
"Birmingham-Hoover, AL",13820.0,2020-09-01,-212,0,-212
"Birmingham-Hoover, AL",13820.0,2020-10-01,-26,0,-26
"Birmingham-Hoover, AL",13820.0,2020-11-01,-47,0,-47
"Birmingham-Hoover, AL",13820.0,2020-12-01,19,0,19
"Macon-Bibb County, GA",31420.0,2019-01-01,37,0,37
"Macon-Bibb County, GA",31420.0,2019-02-01,-6,0,-6
"Macon-Bibb County, GA",31420.0,2019-03-01,-48,0,-48
"Macon-Bibb County, GA",31420.0,2019-04-01,24,0,24
"Macon-Bibb County, GA",31420.0,2019-05-01,-31,0,-31
"Macon-Bibb County, GA",31420.0,2019-06-01,-45,0,-45
"Macon-Bibb County, GA",31420.0,2019-07-01,19,0,19
"Macon-Bibb County, GA",31420.0,2019-08-01,-41,0,-41
"Macon-Bibb County, GA",31420.0,2019-09-01,-16,0,-16
"Macon-Bibb County, GA",31420.0,2019-10-01,26,0,26
"Macon-Bibb County, GA",31420.0,2019-11-01,-53,0,-53
"Macon-Bibb County, GA",31420.0,2019-12-01,-11,0,-11
"Macon-Bibb County, GA",31420.0,2020-01-01,-85,0,-85
"Macon-Bibb County, GA",31420.0,2020-02-01,-65,0,-65
"Macon-Bibb County, GA",31420.0,2020-03-01,18,0,18
"Macon-Bibb County, GA",31420.0,2020-04-01,-36,0,-36
"Macon-Bibb County, GA",31420.0,2020-05-01,-15,0,-15
"Macon-Bibb County, GA",31420.0,2020-06-01,-31,0,-31
"Macon-Bibb County, GA",31420.0,2020-07-01,-18,-28,10
"Macon-Bibb County, GA",31420.0,2020-08-01,-26,0,-26
"Macon-Bibb County, GA",31420.0,2020-09-01,-25,0,-25
"Macon-Bibb County, GA",31420.0,2020-10-01,-5,0,-5
"Macon-Bibb County, GA",31420.0,2020-11-01,-70,0,-70
"Macon-Bibb County, GA",31420.0,2020-12-01,6,0,6
"Blackfoot, ID",13940.0,2019-01-01,-8,0,-8
"Blackfoot, ID",13940.0,2019-02-01,-6,0,-6
"Blackfoot, ID",13940.0,2019-03-01,-6,0,-6
"Blackfoot, ID",13940.0,2019-04-01,5,0,5
"Blackfoot, ID",13940.0,2019-05-01,30,0,30
"Blackfoot, ID",13940.0,2019-06-01,-22,0,-22
"Blackfoot, ID",13940.0,2019-07-01,19,0,19
"Blackfoot, ID",13940.0,2019-08-01,-3,0,-3
"Blackfoot, ID",13940.0,2019-09-01,-8,0,-8
"Blackfoot, ID",13940.0,2019-10-01,-26,-17,-9
"Blackfoot, ID",13940.0,2019-11-01,-4,0,-4
"Blackfoot, ID",13940.0,2019-12-01,-2,0,-2
"Blackfoot, ID",13940.0,2020-01-01,6,0,6
"Blackfoot, ID",13940.0,2020-02-01,-2,0,-2
"Blackfoot, ID",13940.0,2020-03-01,-10,0,-10
"Blackfoot, ID",13940.0,2020-04-01,-6,0,-6
"Blackfoot, ID",13940.0,2020-05-01,6,0,6
"Blackfoot, ID",13940.0,2020-06-01,12,0,12
"Blackfoot, ID",13940.0,2020-07-01,13,0,13
"Blackfoot, ID",13940.0,2020-08-01,12,0,12
"Blackfoot, ID",13940.0,2020-09-01,36,0,36
"Blackfoot, ID",13940.0,2020-10-01,-4,-38,34
"Blackfoot, ID",13940.0,2020-11-01,7,0,7
"Blackfoot, ID",13940.0,2020-12-01,11,0,11
"Waterloo-Cedar Falls, IA",47940.0,2019-01-01,-90,-70,-20
"Waterloo-Cedar Falls, IA",47940.0,2019-02-01,-43,0,-43
"Waterloo-Cedar Falls, IA",47940.0,2019-03-01,-19,0,-19
"Waterloo-Cedar Falls, IA",47940.0,2019-04-01,99,33,66
"Waterloo-Cedar Falls, IA",47940.0,2019-05-01,-174,12,-186
"Waterloo-Cedar Falls, IA",47940.0,2019-06-01,-88,0,-88
"Waterloo-Cedar Falls, IA",47940.0,2019-07-01,-34,0,-34
"Waterloo-Cedar Falls, IA",47940.0,2019-08-01,-16,0,-16
"Waterloo-Cedar Falls, IA",47940.0,2019-09-01,-24,0,-24
"Waterloo-Cedar Falls, IA",47940.0,2019-10-01,-137,-110,-27
"Waterloo-Cedar Falls, IA",47940.0,2019-11-01,-134,-95,-39
"Waterloo-Cedar Falls, IA",47940.0,2019-12-01,-110,-138,28
"Waterloo-Cedar Falls, IA",47940.0,2020-01-01,-103,-74,-29
"Waterloo-Cedar Falls, IA",47940.0,2020-02-01,-20,0,-20
"Waterloo-Cedar Falls, IA",47940.0,2020-03-01,-41,0,-41
"Waterloo-Cedar Falls, IA",47940.0,2020-04-01,-1,0,-1
"Waterloo-Cedar Falls, IA",47940.0,2020-05-01,-155,0,-155
"Waterloo-Cedar Falls, IA",47940.0,2020-06-01,-5,0,-5
"Waterloo-Cedar Falls, IA",47940.0,2020-07-01,-61,0,-61
"Waterloo-Cedar Falls, IA",47940.0,2020-08-01,-44,0,-44
"Waterloo-Cedar Falls, IA",47940.0,2020-09-01,-31,0,-31
"Waterloo-Cedar Falls, IA",47940.0,2020-10-01,-81,-79,-2
"Waterloo-Cedar Falls, IA",47940.0,2020-11-01,-69,-82,13
"Waterloo-Cedar Falls, IA",47940.0,2020-12-01,-108,-92,-16
"Hailey, ID",25200.0,2019-01-01,9,9,0
"Hailey, ID",25200.0,2019-02-01,0,0,0
"Hailey, ID",25200.0,2019-03-01,-38,-27,-11
"Hailey, ID",25200.0,2019-04-01,-37,-37,0
"Hailey, ID",25200.0,2019-05-01,57,44,13
"Hailey, ID",25200.0,2019-06-01,66,78,-12
"Hailey, ID",25200.0,2019-07-01,1,16,-15
"Hailey, ID",25200.0,2019-08-01,-16,0,-16
"Hailey, ID",25200.0,2019-09-01,-28,-12,-16
"Hailey, ID",25200.0,2019-10-01,-72,-66,-6
"Hailey, ID",25200.0,2019-11-01,-75,-58,-17
"Hailey, ID",25200.0,2019-12-01,35,35,0
"Hailey, ID",25200.0,2020-01-01,0,0,0
"Hailey, ID",25200.0,2020-02-01,-14,0,-14
"Hailey, ID",25200.0,2020-03-01,10,21,-11
"Hailey, ID",25200.0,2020-04-01,-15,0,-15
"Hailey, ID",25200.0,2020-05-01,25,39,-14
"Hailey, ID",25200.0,2020-06-01,62,73,-11
"Hailey, ID",25200.0,2020-07-01,-1,-1,0
"Hailey, ID",25200.0,2020-08-01,46,21,25
"Hailey, ID",25200.0,2020-09-01,25,14,11
"Hailey, ID",25200.0,2020-10-01,-16,-33,17
"Hailey, ID",25200.0,2020-11-01,-18,-18,0
"Hailey, ID",25200.0,2020-12-01,45,45,0
"Altoona, PA",11020.0,2019-01-01,-16,-12,-4
"Altoona, PA",11020.0,2019-02-01,-9,0,-9
"Altoona, PA",11020.0,2019-03-01,26,0,26
"Altoona, PA",11020.0,2019-04-01,46,0,46
"Altoona, PA",11020.0,2019-05-01,16,0,16
"Altoona, PA",11020.0,2019-06-01,25,0,25
"Altoona, PA",11020.0,2019-07-01,19,0,19
"Altoona, PA",11020.0,2019-08-01,-16,0,-16
"Altoona, PA",11020.0,2019-09-01,4,0,4
"Altoona, PA",11020.0,2019-10-01,0,0,0
"Altoona, PA",11020.0,2019-11-01,-18,0,-18
"Altoona, PA",11020.0,2019-12-01,-61,-34,-27
"Altoona, PA",11020.0,2020-01-01,4,0,4
"Altoona, PA",11020.0,2020-02-01,-10,0,-10
"Altoona, PA",11020.0,2020-03-01,-3,0,-3
"Altoona, PA",11020.0,2020-04-01,37,0,37
"Altoona, PA",11020.0,2020-05-01,29,0,29
"Altoona, PA",11020.0,2020-06-01,2,0,2
"Altoona, PA",11020.0,2020-07-01,-1,0,-1
"Altoona, PA",11020.0,2020-08-01,7,0,7
"Altoona, PA",11020.0,2020-09-01,-23,-11,-12
"Altoona, PA",11020.0,2020-10-01,51,0,51
"Altoona, PA",11020.0,2020-11-01,-27,0,-27
"Altoona, PA",11020.0,2020-12-01,23,0,23
"Mankato, MN",31860.0,2019-01-01,-94,-40,-54
"Mankato, MN",31860.0,2019-02-01,14,0,14
"Mankato, MN",31860.0,2019-03-01,-5,0,-5
"Mankato, MN",31860.0,2019-04-01,56,18,38
"Mankato, MN",31860.0,2019-05-01,-165,22,-187
"Mankato, MN",31860.0,2019-06-01,-37,0,-37
"Mankato, MN",31860.0,2019-07-01,-121,0,-121
"Mankato, MN",31860.0,2019-08-01,-34,0,-34
"Mankato, MN",31860.0,2019-09-01,-3,0,-3
"Mankato, MN",31860.0,2019-10-01,-106,-84,-22
"Mankato, MN",31860.0,2019-11-01,-71,-73,2
"Mankato, MN",31860.0,2019-12-01,-118,-89,-29
"Mankato, MN",31860.0,2020-01-01,-42,-46,4
"Mankato, MN",31860.0,2020-02-01,-17,0,-17
"Mankato, MN",31860.0,2020-03-01,-157,0,-157
"Mankato, MN",31860.0,2020-04-01,-5,13,-18
"Mankato, MN",31860.0,2020-05-01,-35,13,-48
"Mankato, MN",31860.0,2020-06-01,-28,0,-28
"Mankato, MN",31860.0,2020-07-01,-236,0,-236
"Mankato, MN",31860.0,2020-08-01,-21,0,-21
"Mankato, MN",31860.0,2020-09-01,-14,0,-14
"Mankato, MN",31860.0,2020-10-01,-72,-66,-6
"Mankato, MN",31860.0,2020-11-01,-107,-53,-54
"Mankato, MN",31860.0,2020-12-01,-127,-29,-98
"Cleveland, MS",17380.0,2019-01-01,0,0,0
"Cleveland, MS",17380.0,2019-02-01,18,0,18
"Cleveland, MS",17380.0,2019-03-01,0,0,0
"Cleveland, MS",17380.0,2019-04-01,0,0,0
"Cleveland, MS",17380.0,2019-05-01,0,0,0
"Cleveland, MS",17380.0,2019-06-01,0,0,0
"Cleveland, MS",17380.0,2019-07-01,1,0,1
"Cleveland, MS",17380.0,2019-08-01,0,0,0
"Cleveland, MS",17380.0,2019-09-01,0,0,0
"Cleveland, MS",17380.0,2019-10-01,-11,0,-11
"Cleveland, MS",17380.0,2019-11-01,0,0,0
"Cleveland, MS",17380.0,2019-12-01,-17,0,-17
"Cleveland, MS",17380.0,2020-01-01,0,0,0
"Cleveland, MS",17380.0,2020-02-01,0,0,0
"Cleveland, MS",17380.0,2020-03-01,0,0,0
"Cleveland, MS",17380.0,2020-04-01,0,0,0
"Cleveland, MS",17380.0,2020-05-01,-11,0,-11
"Cleveland, MS",17380.0,2020-06-01,-13,0,-13
"Cleveland, MS",17380.0,2020-07-01,-11,0,-11
"Cleveland, MS",17380.0,2020-08-01,-11,0,-11
"Cleveland, MS",17380.0,2020-09-01,0,0,0
"Cleveland, MS",17380.0,2020-10-01,0,0,0
"Cleveland, MS",17380.0,2020-11-01,0,0,0
"Cleveland, MS",17380.0,2020-12-01,0,0,0
"St. Louis, MO-IL",41180.0,2019-01-01,-639,-529,-110
"St. Louis, MO-IL",41180.0,2019-02-01,-17,-29,12
"St. Louis, MO-IL",41180.0,2019-03-01,32,24,8
"St. Louis, MO-IL",41180.0,2019-04-01,588,416,172
"St. Louis, MO-IL",41180.0,2019-05-01,531,362,169
"St. Louis, MO-IL",41180.0,2019-06-01,92,9,83
"St. Louis, MO-IL",41180.0,2019-07-01,-107,48,-155
"St. Louis, MO-IL",41180.0,2019-08-01,-142,10,-152
"St. Louis, MO-IL",41180.0,2019-09-01,-121,-69,-52
"St. Louis, MO-IL",41180.0,2019-10-01,-432,-276,-156
"St. Louis, MO-IL",41180.0,2019-11-01,-175,-100,-75
"St. Louis, MO-IL",41180.0,2019-12-01,-626,-590,-36
"St. Louis, MO-IL",41180.0,2020-01-01,-580,-494,-86
"St. Louis, MO-IL",41180.0,2020-02-01,17,-26,43
"St. Louis, MO-IL",41180.0,2020-03-01,414,181,233
"St. Louis, MO-IL",41180.0,2020-04-01,355,232,123
"St. Louis, MO-IL",41180.0,2020-05-01,329,377,-48
"St. Louis, MO-IL",41180.0,2020-06-01,159,175,-16
"St. Louis, MO-IL",41180.0,2020-07-01,29,57,-28
"St. Louis, MO-IL",41180.0,2020-08-01,-155,31,-186
"St. Louis, MO-IL",41180.0,2020-09-01,-84,-30,-54
"St. Louis, MO-IL",41180.0,2020-10-01,-544,-249,-295
"St. Louis, MO-IL",41180.0,2020-11-01,-191,-155,-36
"St. Louis, MO-IL",41180.0,2020-12-01,-577,-459,-118
"Sandpoint, ID",41760.0,2019-01-01,0,-14,14
"Sandpoint, ID",41760.0,2019-02-01,-13,0,-13
"Sandpoint, ID",41760.0,2019-03-01,-10,0,-10
"Sandpoint, ID",41760.0,2019-04-01,83,75,8
"Sandpoint, ID",41760.0,2019-05-01,106,110,-4
"Sandpoint, ID",41760.0,2019-06-01,69,52,17
"Sandpoint, ID",41760.0,2019-07-01,53,0,53
"Sandpoint, ID",41760.0,2019-08-01,56,12,44
"Sandpoint, ID",41760.0,2019-09-01,-25,-25,0
"Sandpoint, ID",41760.0,2019-10-01,-258,-239,-19
"Sandpoint, ID",41760.0,2019-11-01,-62,-81,19
"Sandpoint, ID",41760.0,2019-12-01,-36,-16,-20
"Sandpoint, ID",41760.0,2020-01-01,10,0,10
"Sandpoint, ID",41760.0,2020-02-01,-7,0,-7
"Sandpoint, ID",41760.0,2020-03-01,70,30,40
"Sandpoint, ID",41760.0,2020-04-01,64,31,33
"Sandpoint, ID",41760.0,2020-05-01,156,137,19
"Sandpoint, ID",41760.0,2020-06-01,116,68,48
"Sandpoint, ID",41760.0,2020-07-01,91,22,69
"Sandpoint, ID",41760.0,2020-08-01,33,0,33
"Sandpoint, ID",41760.0,2020-09-01,20,-38,58
"Sandpoint, ID",41760.0,2020-10-01,-208,-234,26
"Sandpoint, ID",41760.0,2020-11-01,-71,-85,14
"Sandpoint, ID",41760.0,2020-12-01,9,-13,22
"Idaho Falls, ID",26820.0,2019-01-01,16,-30,46
"Idaho Falls, ID",26820.0,2019-02-01,35,0,35
"Idaho Falls, ID",26820.0,2019-03-01,37,0,37
"Idaho Falls, ID",26820.0,2019-04-01,123,41,82
"Idaho Falls, ID",26820.0,2019-05-01,102,40,62
"Idaho Falls, ID",26820.0,2019-06-01,49,0,49
"Idaho Falls, ID",26820.0,2019-07-01,51,0,51
"Idaho Falls, ID",26820.0,2019-08-01,50,0,50
"Idaho Falls, ID",26820.0,2019-09-01,25,0,25
"Idaho Falls, ID",26820.0,2019-10-01,-174,-172,-2
"Idaho Falls, ID",26820.0,2019-11-01,-136,-115,-21
"Idaho Falls, ID",26820.0,2019-12-01,-32,-22,-10
"Idaho Falls, ID",26820.0,2020-01-01,13,-20,33
"Idaho Falls, ID",26820.0,2020-02-01,41,0,41
"Idaho Falls, ID",26820.0,2020-03-01,80,0,80
"Idaho Falls, ID",26820.0,2020-04-01,20,23,-3
"Idaho Falls, ID",26820.0,2020-05-01,79,46,33
"Idaho Falls, ID",26820.0,2020-06-01,71,0,71
"Idaho Falls, ID",26820.0,2020-07-01,12,0,12
"Idaho Falls, ID",26820.0,2020-08-01,19,0,19
"Idaho Falls, ID",26820.0,2020-09-01,65,0,65
"Idaho Falls, ID",26820.0,2020-10-01,-156,-172,16
"Idaho Falls, ID",26820.0,2020-11-01,-26,-103,77
"Idaho Falls, ID",26820.0,2020-12-01,-1,-42,41
"Harrison, AR",25460.0,2019-01-01,-13,0,-13
"Harrison, AR",25460.0,2019-02-01,-12,0,-12
"Harrison, AR",25460.0,2019-03-01,-14,0,-14
"Harrison, AR",25460.0,2019-04-01,7,0,7
"Harrison, AR",25460.0,2019-05-01,23,0,23
"Harrison, AR",25460.0,2019-06-01,-1,0,-1
"Harrison, AR",25460.0,2019-07-01,-11,0,-11
"Harrison, AR",25460.0,2019-08-01,14,0,14
"Harrison, AR",25460.0,2019-09-01,14,0,14
"Harrison, AR",25460.0,2019-10-01,11,0,11
"Harrison, AR",25460.0,2019-11-01,0,0,0
"Harrison, AR",25460.0,2019-12-01,0,0,0
"Harrison, AR",25460.0,2020-01-01,-14,0,-14
"Harrison, AR",25460.0,2020-02-01,-13,0,-13
"Harrison, AR",25460.0,2020-03-01,9,0,9
"Harrison, AR",25460.0,2020-04-01,-4,0,-4
"Harrison, AR",25460.0,2020-05-01,-18,0,-18
"Harrison, AR",25460.0,2020-06-01,-11,0,-11
"Harrison, AR",25460.0,2020-07-01,-13,0,-13
"Harrison, AR",25460.0,2020-08-01,0,0,0
"Harrison, AR",25460.0,2020-09-01,-11,0,-11
"Harrison, AR",25460.0,2020-10-01,27,0,27
"Harrison, AR",25460.0,2020-11-01,8,0,8
"Harrison, AR",25460.0,2020-12-01,11,0,11
"Ames, IA",11180.0,2019-01-01,-51,-17,-34
"Ames, IA",11180.0,2019-02-01,-19,0,-19
"Ames, IA",11180.0,2019-03-01,1,0,1
"Ames, IA",11180.0,2019-04-01,12,16,-4
"Ames, IA",11180.0,2019-05-01,-321,-29,-292
"Ames, IA",11180.0,2019-06-01,-143,0,-143
"Ames, IA",11180.0,2019-07-01,-600,-20,-580
"Ames, IA",11180.0,2019-08-01,-40,0,-40
"Ames, IA",11180.0,2019-09-01,2,0,2
"Ames, IA",11180.0,2019-10-01,104,-38,142
"Ames, IA",11180.0,2019-11-01,-57,-38,-19
"Ames, IA",11180.0,2019-12-01,-107,-68,-39
"Ames, IA",11180.0,2020-01-01,-36,-20,-16
"Ames, IA",11180.0,2020-02-01,2,0,2
"Ames, IA",11180.0,2020-03-01,-73,-13,-60
"Ames, IA",11180.0,2020-04-01,-126,0,-126
"Ames, IA",11180.0,2020-05-01,-59,22,-81
"Ames, IA",11180.0,2020-06-01,-115,0,-115
"Ames, IA",11180.0,2020-07-01,-36,0,-36
"Ames, IA",11180.0,2020-08-01,113,17,96
"Ames, IA",11180.0,2020-09-01,-7,0,-7
"Ames, IA",11180.0,2020-10-01,-34,-15,-19
"Ames, IA",11180.0,2020-11-01,-53,-30,-23
"Ames, IA",11180.0,2020-12-01,-76,-51,-25
"Rockford, IL",40420.0,2019-01-01,-36,-141,105
"Rockford, IL",40420.0,2019-02-01,71,0,71
"Rockford, IL",40420.0,2019-03-01,116,0,116
"Rockford, IL",40420.0,2019-04-01,204,151,53
"Rockford, IL",40420.0,2019-05-01,230,131,99
"Rockford, IL",40420.0,2019-06-01,174,21,153
"Rockford, IL",40420.0,2019-07-01,-43,0,-43
"Rockford, IL",40420.0,2019-08-01,85,0,85
"Rockford, IL",40420.0,2019-09-01,60,0,60
"Rockford, IL",40420.0,2019-10-01,-152,-212,60
"Rockford, IL",40420.0,2019-11-01,-112,-120,8
"Rockford, IL",40420.0,2019-12-01,-142,-191,49
"Rockford, IL",40420.0,2020-01-01,-90,-150,60
"Rockford, IL",40420.0,2020-02-01,45,0,45
"Rockford, IL",40420.0,2020-03-01,106,11,95
"Rockford, IL",40420.0,2020-04-01,165,31,134
"Rockford, IL",40420.0,2020-05-01,211,112,99
"Rockford, IL",40420.0,2020-06-01,215,32,183
"Rockford, IL",40420.0,2020-07-01,106,0,106
"Rockford, IL",40420.0,2020-08-01,140,0,140
"Rockford, IL",40420.0,2020-09-01,53,0,53
"Rockford, IL",40420.0,2020-10-01,-83,-170,87
"Rockford, IL",40420.0,2020-11-01,60,-79,139
"Rockford, IL",40420.0,2020-12-01,-27,-139,112
"Indianapolis-Carmel-Anderson, IN",26900.0,2019-01-01,-728,-749,21
"Indianapolis-Carmel-Anderson, IN",26900.0,2019-02-01,-32,-39,7
"Indianapolis-Carmel-Anderson, IN",26900.0,2019-03-01,311,33,278
"Indianapolis-Carmel-Anderson, IN",26900.0,2019-04-01,1209,750,459
"Indianapolis-Carmel-Anderson, IN",26900.0,2019-05-01,644,482,162
"Indianapolis-Carmel-Anderson, IN",26900.0,2019-06-01,225,87,138
"Indianapolis-Carmel-Anderson, IN",26900.0,2019-07-01,461,35,426
"Indianapolis-Carmel-Anderson, IN",26900.0,2019-08-01,190,12,178
"Indianapolis-Carmel-Anderson, IN",26900.0,2019-09-01,-187,-27,-160
"Indianapolis-Carmel-Anderson, IN",26900.0,2019-10-01,-762,-637,-125
"Indianapolis-Carmel-Anderson, IN",26900.0,2019-11-01,-301,-324,23
"Indianapolis-Carmel-Anderson, IN",26900.0,2019-12-01,-1033,-1276,243
"Indianapolis-Carmel-Anderson, IN",26900.0,2020-01-01,-710,-849,139
"Indianapolis-Carmel-Anderson, IN",26900.0,2020-02-01,-151,-56,-95
"Indianapolis-Carmel-Anderson, IN",26900.0,2020-03-01,391,134,257
"Indianapolis-Carmel-Anderson, IN",26900.0,2020-04-01,370,200,170
"Indianapolis-Carmel-Anderson, IN",26900.0,2020-05-01,789,474,315
"Indianapolis-Carmel-Anderson, IN",26900.0,2020-06-01,388,206,182
"Indianapolis-Carmel-Anderson, IN",26900.0,2020-07-01,529,16,513
"Indianapolis-Carmel-Anderson, IN",26900.0,2020-08-01,433,11,422
"Indianapolis-Carmel-Anderson, IN",26900.0,2020-09-01,68,-16,84
"Indianapolis-Carmel-Anderson, IN",26900.0,2020-10-01,-687,-567,-120
"Indianapolis-Carmel-Anderson, IN",26900.0,2020-11-01,-364,-413,49
"Indianapolis-Carmel-Anderson, IN",26900.0,2020-12-01,-1057,-1162,105
"Cincinnati, OH-KY-IN",17140.0,2019-01-01,-720,-648,-72
"Cincinnati, OH-KY-IN",17140.0,2019-02-01,3,0,3
"Cincinnati, OH-KY-IN",17140.0,2019-03-01,99,15,84
"Cincinnati, OH-KY-IN",17140.0,2019-04-01,683,553,130
"Cincinnati, OH-KY-IN",17140.0,2019-05-01,592,548,44
"Cincinnati, OH-KY-IN",17140.0,2019-06-01,32,49,-17
"Cincinnati, OH-KY-IN",17140.0,2019-07-01,12,14,-2
"Cincinnati, OH-KY-IN",17140.0,2019-08-01,-71,11,-82
"Cincinnati, OH-KY-IN",17140.0,2019-09-01,72,-22,94
"Cincinnati, OH-KY-IN",17140.0,2019-10-01,-455,-487,32
"Cincinnati, OH-KY-IN",17140.0,2019-11-01,-58,-109,51
"Cincinnati, OH-KY-IN",17140.0,2019-12-01,-832,-839,7
"Cincinnati, OH-KY-IN",17140.0,2020-01-01,-497,-572,75
"Cincinnati, OH-KY-IN",17140.0,2020-02-01,-88,-11,-77
"Cincinnati, OH-KY-IN",17140.0,2020-03-01,207,151,56
"Cincinnati, OH-KY-IN",17140.0,2020-04-01,453,297,156
"Cincinnati, OH-KY-IN",17140.0,2020-05-01,494,431,63
"Cincinnati, OH-KY-IN",17140.0,2020-06-01,334,205,129
"Cincinnati, OH-KY-IN",17140.0,2020-07-01,208,26,182
"Cincinnati, OH-KY-IN",17140.0,2020-08-01,5,27,-22
"Cincinnati, OH-KY-IN",17140.0,2020-09-01,-168,-23,-145
"Cincinnati, OH-KY-IN",17140.0,2020-10-01,-687,-456,-231
"Cincinnati, OH-KY-IN",17140.0,2020-11-01,-326,-275,-51
"Cincinnati, OH-KY-IN",17140.0,2020-12-01,-721,-669,-52
"Columbia, MO",17860.0,2019-01-01,-45,0,-45
"Columbia, MO",17860.0,2019-02-01,1,0,1
"Columbia, MO",17860.0,2019-03-01,-40,0,-40
"Columbia, MO",17860.0,2019-04-01,0,0,0
"Columbia, MO",17860.0,2019-05-01,-184,0,-184
"Columbia, MO",17860.0,2019-06-01,-138,0,-138
"Columbia, MO",17860.0,2019-07-01,-198,0,-198
"Columbia, MO",17860.0,2019-08-01,-22,0,-22
"Columbia, MO",17860.0,2019-09-01,50,0,50
"Columbia, MO",17860.0,2019-10-01,44,0,44
"Columbia, MO",17860.0,2019-11-01,34,0,34
"Columbia, MO",17860.0,2019-12-01,-70,0,-70
"Columbia, MO",17860.0,2020-01-01,-21,0,-21
"Columbia, MO",17860.0,2020-02-01,-57,0,-57
"Columbia, MO",17860.0,2020-03-01,-101,0,-101
"Columbia, MO",17860.0,2020-04-01,-80,0,-80
"Columbia, MO",17860.0,2020-05-01,-53,0,-53
"Columbia, MO",17860.0,2020-06-01,-112,0,-112
"Columbia, MO",17860.0,2020-07-01,-233,0,-233
"Columbia, MO",17860.0,2020-08-01,35,0,35
"Columbia, MO",17860.0,2020-09-01,20,0,20
"Columbia, MO",17860.0,2020-10-01,-28,0,-28
"Columbia, MO",17860.0,2020-11-01,-18,0,-18
"Columbia, MO",17860.0,2020-12-01,23,0,23
"Charleston, WV",16620.0,2019-01-01,-9,-11,2
"Charleston, WV",16620.0,2019-02-01,-22,0,-22
"Charleston, WV",16620.0,2019-03-01,-8,0,-8
"Charleston, WV",16620.0,2019-04-01,-36,0,-36
"Charleston, WV",16620.0,2019-05-01,19,0,19
"Charleston, WV",16620.0,2019-06-01,-18,0,-18
"Charleston, WV",16620.0,2019-07-01,36,0,36
"Charleston, WV",16620.0,2019-08-01,-54,0,-54
"Charleston, WV",16620.0,2019-09-01,16,0,16
"Charleston, WV",16620.0,2019-10-01,-9,0,-9
"Charleston, WV",16620.0,2019-11-01,2,0,2
"Charleston, WV",16620.0,2019-12-01,0,0,0
"Charleston, WV",16620.0,2020-01-01,-31,0,-31
"Charleston, WV",16620.0,2020-02-01,-17,0,-17
"Charleston, WV",16620.0,2020-03-01,-61,-13,-48
"Charleston, WV",16620.0,2020-04-01,48,0,48
"Charleston, WV",16620.0,2020-05-01,37,0,37
"Charleston, WV",16620.0,2020-06-01,41,0,41
"Charleston, WV",16620.0,2020-07-01,32,0,32
"Charleston, WV",16620.0,2020-08-01,-22,0,-22
"Charleston, WV",16620.0,2020-09-01,-59,0,-59
"Charleston, WV",16620.0,2020-10-01,16,0,16
"Charleston, WV",16620.0,2020-11-01,-38,0,-38
"Charleston, WV",16620.0,2020-12-01,-43,0,-43
"Shreveport-Bossier City, LA",43340.0,2019-01-01,-33,0,-33
"Shreveport-Bossier City, LA",43340.0,2019-02-01,-17,0,-17
"Shreveport-Bossier City, LA",43340.0,2019-03-01,44,0,44
"Shreveport-Bossier City, LA",43340.0,2019-04-01,28,0,28
"Shreveport-Bossier City, LA",43340.0,2019-05-01,-12,0,-12
"Shreveport-Bossier City, LA",43340.0,2019-06-01,-12,0,-12
"Shreveport-Bossier City, LA",43340.0,2019-07-01,-95,0,-95
"Shreveport-Bossier City, LA",43340.0,2019-08-01,15,0,15
"Shreveport-Bossier City, LA",43340.0,2019-09-01,8,0,8
"Shreveport-Bossier City, LA",43340.0,2019-10-01,-1,0,-1
"Shreveport-Bossier City, LA",43340.0,2019-11-01,-7,0,-7
"Shreveport-Bossier City, LA",43340.0,2019-12-01,14,0,14
"Shreveport-Bossier City, LA",43340.0,2020-01-01,7,0,7
"Shreveport-Bossier City, LA",43340.0,2020-02-01,-32,0,-32
"Shreveport-Bossier City, LA",43340.0,2020-03-01,-47,0,-47
"Shreveport-Bossier City, LA",43340.0,2020-04-01,-19,0,-19
"Shreveport-Bossier City, LA",43340.0,2020-05-01,40,0,40
"Shreveport-Bossier City, LA",43340.0,2020-06-01,66,0,66
"Shreveport-Bossier City, LA",43340.0,2020-07-01,19,0,19
"Shreveport-Bossier City, LA",43340.0,2020-08-01,-66,0,-66
"Shreveport-Bossier City, LA",43340.0,2020-09-01,-19,0,-19
"Shreveport-Bossier City, LA",43340.0,2020-10-01,-29,0,-29
"Shreveport-Bossier City, LA",43340.0,2020-11-01,-14,0,-14
"Shreveport-Bossier City, LA",43340.0,2020-12-01,-52,0,-52
"Roanoke, VA",40220.0,2019-01-01,-15,0,-15
"Roanoke, VA",40220.0,2019-02-01,26,0,26
"Roanoke, VA",40220.0,2019-03-01,18,0,18
"Roanoke, VA",40220.0,2019-04-01,-8,0,-8
"Roanoke, VA",40220.0,2019-05-01,8,0,8
"Roanoke, VA",40220.0,2019-06-01,46,0,46
"Roanoke, VA",40220.0,2019-07-01,49,0,49
"Roanoke, VA",40220.0,2019-08-01,-7,0,-7
"Roanoke, VA",40220.0,2019-09-01,25,0,25
"Roanoke, VA",40220.0,2019-10-01,5,0,5
"Roanoke, VA",40220.0,2019-11-01,-6,0,-6
"Roanoke, VA",40220.0,2019-12-01,17,0,17
"Roanoke, VA",40220.0,2020-01-01,0,0,0
"Roanoke, VA",40220.0,2020-02-01,58,0,58
"Roanoke, VA",40220.0,2020-03-01,-16,0,-16
"Roanoke, VA",40220.0,2020-04-01,-2,0,-2
"Roanoke, VA",40220.0,2020-05-01,72,0,72
"Roanoke, VA",40220.0,2020-06-01,40,0,40
"Roanoke, VA",40220.0,2020-07-01,79,0,79
"Roanoke, VA",40220.0,2020-08-01,-6,0,-6
"Roanoke, VA",40220.0,2020-09-01,0,0,0
"Roanoke, VA",40220.0,2020-10-01,-3,0,-3
"Roanoke, VA",40220.0,2020-11-01,19,0,19
"Roanoke, VA",40220.0,2020-12-01,-14,0,-14
"Boulder, CO",14500.0,2019-01-01,-175,-28,-147
"Boulder, CO",14500.0,2019-02-01,-98,0,-98
"Boulder, CO",14500.0,2019-03-01,3,0,3
"Boulder, CO",14500.0,2019-04-01,-47,67,-114
"Boulder, CO",14500.0,2019-05-01,13,129,-116
"Boulder, CO",14500.0,2019-06-01,-173,46,-219
"Boulder, CO",14500.0,2019-07-01,-608,12,-620
"Boulder, CO",14500.0,2019-08-01,-488,-37,-451
"Boulder, CO",14500.0,2019-09-01,-182,0,-182
"Boulder, CO",14500.0,2019-10-01,-205,-142,-63
"Boulder, CO",14500.0,2019-11-01,-103,-69,-34
"Boulder, CO",14500.0,2019-12-01,-121,-57,-64
"Boulder, CO",14500.0,2020-01-01,-89,-36,-53
"Boulder, CO",14500.0,2020-02-01,-165,-13,-152
"Boulder, CO",14500.0,2020-03-01,-54,-27,-27
"Boulder, CO",14500.0,2020-04-01,-89,41,-130
"Boulder, CO",14500.0,2020-05-01,-13,116,-129
"Boulder, CO",14500.0,2020-06-01,-225,23,-248
"Boulder, CO",14500.0,2020-07-01,-638,10,-648
"Boulder, CO",14500.0,2020-08-01,-256,-24,-232
"Boulder, CO",14500.0,2020-09-01,-41,-4,-37
"Boulder, CO",14500.0,2020-10-01,78,-52,130
"Boulder, CO",14500.0,2020-11-01,-120,-140,20
"Boulder, CO",14500.0,2020-12-01,-70,-108,38
"Lexington-Fayette, KY",30460.0,2019-01-01,-119,-61,-58
"Lexington-Fayette, KY",30460.0,2019-02-01,-37,0,-37
"Lexington-Fayette, KY",30460.0,2019-03-01,-119,0,-119
"Lexington-Fayette, KY",30460.0,2019-04-01,81,82,-1
"Lexington-Fayette, KY",30460.0,2019-05-01,-9,75,-84
"Lexington-Fayette, KY",30460.0,2019-06-01,-271,0,-271
"Lexington-Fayette, KY",30460.0,2019-07-01,-210,0,-210
"Lexington-Fayette, KY",30460.0,2019-08-01,-151,0,-151
"Lexington-Fayette, KY",30460.0,2019-09-01,-165,0,-165
"Lexington-Fayette, KY",30460.0,2019-10-01,-78,-26,-52
"Lexington-Fayette, KY",30460.0,2019-11-01,-88,-50,-38
"Lexington-Fayette, KY",30460.0,2019-12-01,-206,-102,-104
"Lexington-Fayette, KY",30460.0,2020-01-01,-169,-78,-91
"Lexington-Fayette, KY",30460.0,2020-02-01,-3,0,-3
"Lexington-Fayette, KY",30460.0,2020-03-01,-17,0,-17
"Lexington-Fayette, KY",30460.0,2020-04-01,236,46,190
"Lexington-Fayette, KY",30460.0,2020-05-01,-33,49,-82
"Lexington-Fayette, KY",30460.0,2020-06-01,-103,13,-116
"Lexington-Fayette, KY",30460.0,2020-07-01,-258,0,-258
"Lexington-Fayette, KY",30460.0,2020-08-01,-191,0,-191
"Lexington-Fayette, KY",30460.0,2020-09-01,-132,0,-132
"Lexington-Fayette, KY",30460.0,2020-10-01,-149,-59,-90
"Lexington-Fayette, KY",30460.0,2020-11-01,-182,-40,-142
"Lexington-Fayette, KY",30460.0,2020-12-01,-191,-89,-102
"Texarkana, TX-AR",45500.0,2019-01-01,0,0,0
"Texarkana, TX-AR",45500.0,2019-02-01,7,0,7
"Texarkana, TX-AR",45500.0,2019-03-01,41,0,41
"Texarkana, TX-AR",45500.0,2019-04-01,20,0,20
"Texarkana, TX-AR",45500.0,2019-05-01,-7,0,-7
"Texarkana, TX-AR",45500.0,2019-06-01,-12,0,-12
"Texarkana, TX-AR",45500.0,2019-07-01,12,0,12
"Texarkana, TX-AR",45500.0,2019-08-01,-7,0,-7
"Texarkana, TX-AR",45500.0,2019-09-01,0,0,0
"Texarkana, TX-AR",45500.0,2019-10-01,15,0,15
"Texarkana, TX-AR",45500.0,2019-11-01,11,0,11
"Texarkana, TX-AR",45500.0,2019-12-01,-15,0,-15
"Texarkana, TX-AR",45500.0,2020-01-01,-3,0,-3
"Texarkana, TX-AR",45500.0,2020-02-01,-14,0,-14
"Texarkana, TX-AR",45500.0,2020-03-01,-19,0,-19
"Texarkana, TX-AR",45500.0,2020-04-01,13,0,13
"Texarkana, TX-AR",45500.0,2020-05-01,-24,0,-24
"Texarkana, TX-AR",45500.0,2020-06-01,13,0,13
"Texarkana, TX-AR",45500.0,2020-07-01,9,0,9
"Texarkana, TX-AR",45500.0,2020-08-01,4,0,4
"Texarkana, TX-AR",45500.0,2020-09-01,-14,0,-14
"Texarkana, TX-AR",45500.0,2020-10-01,-5,0,-5
"Texarkana, TX-AR",45500.0,2020-11-01,-10,0,-10
"Texarkana, TX-AR",45500.0,2020-12-01,10,0,10
"Ogden-Clearfield, UT",36260.0,2019-01-01,98,-38,136
"Ogden-Clearfield, UT",36260.0,2019-02-01,199,-12,211
"Ogden-Clearfield, UT",36260.0,2019-03-01,200,14,186
"Ogden-Clearfield, UT",36260.0,2019-04-01,349,78,271
"Ogden-Clearfield, UT",36260.0,2019-05-01,430,97,333
"Ogden-Clearfield, UT",36260.0,2019-06-01,262,47,215
"Ogden-Clearfield, UT",36260.0,2019-07-01,75,12,63
"Ogden-Clearfield, UT",36260.0,2019-08-01,136,12,124
"Ogden-Clearfield, UT",36260.0,2019-09-01,126,2,124
"Ogden-Clearfield, UT",36260.0,2019-10-01,-88,-165,77
"Ogden-Clearfield, UT",36260.0,2019-11-01,-4,-54,50
"Ogden-Clearfield, UT",36260.0,2019-12-01,49,-87,136
"Ogden-Clearfield, UT",36260.0,2020-01-01,20,-90,110
"Ogden-Clearfield, UT",36260.0,2020-02-01,54,-13,67
"Ogden-Clearfield, UT",36260.0,2020-03-01,159,1,158
"Ogden-Clearfield, UT",36260.0,2020-04-01,271,44,227
"Ogden-Clearfield, UT",36260.0,2020-05-01,348,88,260
"Ogden-Clearfield, UT",36260.0,2020-06-01,267,33,234
"Ogden-Clearfield, UT",36260.0,2020-07-01,273,14,259
"Ogden-Clearfield, UT",36260.0,2020-08-01,343,20,323
"Ogden-Clearfield, UT",36260.0,2020-09-01,201,-28,229
"Ogden-Clearfield, UT",36260.0,2020-10-01,-15,-139,124
"Ogden-Clearfield, UT",36260.0,2020-11-01,-16,-106,90
"Ogden-Clearfield, UT",36260.0,2020-12-01,86,-52,138
"Huntington-Ashland, WV-KY-OH",26580.0,2019-01-01,-9,0,-9
"Huntington-Ashland, WV-KY-OH",26580.0,2019-02-01,47,0,47
"Huntington-Ashland, WV-KY-OH",26580.0,2019-03-01,18,0,18
"Huntington-Ashland, WV-KY-OH",26580.0,2019-04-01,14,0,14
"Huntington-Ashland, WV-KY-OH",26580.0,2019-05-01,29,0,29
"Huntington-Ashland, WV-KY-OH",26580.0,2019-06-01,26,0,26
"Huntington-Ashland, WV-KY-OH",26580.0,2019-07-01,32,0,32
"Huntington-Ashland, WV-KY-OH",26580.0,2019-08-01,5,0,5
"Huntington-Ashland, WV-KY-OH",26580.0,2019-09-01,48,0,48
"Huntington-Ashland, WV-KY-OH",26580.0,2019-10-01,64,0,64
"Huntington-Ashland, WV-KY-OH",26580.0,2019-11-01,-2,0,-2
"Huntington-Ashland, WV-KY-OH",26580.0,2019-12-01,0,0,0
"Huntington-Ashland, WV-KY-OH",26580.0,2020-01-01,51,0,51
"Huntington-Ashland, WV-KY-OH",26580.0,2020-02-01,15,0,15
"Huntington-Ashland, WV-KY-OH",26580.0,2020-03-01,27,13,14
"Huntington-Ashland, WV-KY-OH",26580.0,2020-04-01,-77,0,-77
"Huntington-Ashland, WV-KY-OH",26580.0,2020-05-01,-48,0,-48
"Huntington-Ashland, WV-KY-OH",26580.0,2020-06-01,36,0,36
"Huntington-Ashland, WV-KY-OH",26580.0,2020-07-01,-9,0,-9
"Huntington-Ashland, WV-KY-OH",26580.0,2020-08-01,-9,0,-9
"Huntington-Ashland, WV-KY-OH",26580.0,2020-09-01,37,0,37
"Huntington-Ashland, WV-KY-OH",26580.0,2020-10-01,36,0,36
"Huntington-Ashland, WV-KY-OH",26580.0,2020-11-01,0,0,0
"Huntington-Ashland, WV-KY-OH",26580.0,2020-12-01,32,0,32
"Danville, KY",19220.0,2019-01-01,25,0,25
"Danville, KY",19220.0,2019-02-01,-3,0,-3
"Danville, KY",19220.0,2019-03-01,-15,0,-15
"Danville, KY",19220.0,2019-04-01,-11,0,-11
"Danville, KY",19220.0,2019-05-01,-10,0,-10
"Danville, KY",19220.0,2019-06-01,43,0,43
"Danville, KY",19220.0,2019-07-01,-18,0,-18
"Danville, KY",19220.0,2019-08-01,39,0,39
"Danville, KY",19220.0,2019-09-01,6,0,6
"Danville, KY",19220.0,2019-10-01,15,0,15
"Danville, KY",19220.0,2019-11-01,27,0,27
"Danville, KY",19220.0,2019-12-01,31,0,31
"Danville, KY",19220.0,2020-01-01,4,0,4
"Danville, KY",19220.0,2020-02-01,11,0,11
"Danville, KY",19220.0,2020-03-01,58,0,58
"Danville, KY",19220.0,2020-04-01,-1,0,-1
"Danville, KY",19220.0,2020-05-01,1,0,1
"Danville, KY",19220.0,2020-06-01,3,0,3
"Danville, KY",19220.0,2020-07-01,-15,0,-15
"Danville, KY",19220.0,2020-08-01,24,0,24
"Danville, KY",19220.0,2020-09-01,44,0,44
"Danville, KY",19220.0,2020-10-01,-27,0,-27
"Danville, KY",19220.0,2020-11-01,23,0,23
"Danville, KY",19220.0,2020-12-01,34,0,34
"Sayre, PA",42380.0,2019-01-01,-34,-12,-22
"Sayre, PA",42380.0,2019-02-01,-20,0,-20
"Sayre, PA",42380.0,2019-03-01,-18,0,-18
"Sayre, PA",42380.0,2019-04-01,16,12,4
"Sayre, PA",42380.0,2019-05-01,6,0,6
"Sayre, PA",42380.0,2019-06-01,-12,0,-12
"Sayre, PA",42380.0,2019-07-01,9,0,9
"Sayre, PA",42380.0,2019-08-01,-19,0,-19
"Sayre, PA",42380.0,2019-09-01,7,0,7
"Sayre, PA",42380.0,2019-10-01,-2,0,-2
"Sayre, PA",42380.0,2019-11-01,11,0,11
"Sayre, PA",42380.0,2019-12-01,-12,-23,11
"Sayre, PA",42380.0,2020-01-01,5,-12,17
"Sayre, PA",42380.0,2020-02-01,0,0,0
"Sayre, PA",42380.0,2020-03-01,18,0,18
"Sayre, PA",42380.0,2020-04-01,12,0,12
"Sayre, PA",42380.0,2020-05-01,30,0,30
"Sayre, PA",42380.0,2020-06-01,-3,0,-3
"Sayre, PA",42380.0,2020-07-01,-35,0,-35
"Sayre, PA",42380.0,2020-08-01,27,0,27
"Sayre, PA",42380.0,2020-09-01,-34,0,-34
"Sayre, PA",42380.0,2020-10-01,24,0,24
"Sayre, PA",42380.0,2020-11-01,20,0,20
"Sayre, PA",42380.0,2020-12-01,-20,-11,-9
"Cleveland, TN",17420.0,2019-01-01,24,0,24
"Cleveland, TN",17420.0,2019-02-01,23,0,23
"Cleveland, TN",17420.0,2019-03-01,-55,0,-55
"Cleveland, TN",17420.0,2019-04-01,-3,0,-3
"Cleveland, TN",17420.0,2019-05-01,-54,0,-54
"Cleveland, TN",17420.0,2019-06-01,-2,0,-2
"Cleveland, TN",17420.0,2019-07-01,24,0,24
"Cleveland, TN",17420.0,2019-08-01,5,0,5
"Cleveland, TN",17420.0,2019-09-01,-7,0,-7
"Cleveland, TN",17420.0,2019-10-01,-8,0,-8
"Cleveland, TN",17420.0,2019-11-01,1,0,1
"Cleveland, TN",17420.0,2019-12-01,1,0,1
"Cleveland, TN",17420.0,2020-01-01,0,0,0
"Cleveland, TN",17420.0,2020-02-01,-10,0,-10
"Cleveland, TN",17420.0,2020-03-01,-1,0,-1
"Cleveland, TN",17420.0,2020-04-01,29,0,29
"Cleveland, TN",17420.0,2020-05-01,-7,0,-7
"Cleveland, TN",17420.0,2020-06-01,-10,0,-10
"Cleveland, TN",17420.0,2020-07-01,20,0,20
"Cleveland, TN",17420.0,2020-08-01,-17,0,-17
"Cleveland, TN",17420.0,2020-09-01,60,0,60
"Cleveland, TN",17420.0,2020-10-01,56,0,56
"Cleveland, TN",17420.0,2020-11-01,16,0,16
"Cleveland, TN",17420.0,2020-12-01,-9,0,-9
"Coldwater, MI",17740.0,2019-01-01,-13,-24,11
"Coldwater, MI",17740.0,2019-02-01,-16,0,-16
"Coldwater, MI",17740.0,2019-03-01,28,0,28
"Coldwater, MI",17740.0,2019-04-01,12,11,1
"Coldwater, MI",17740.0,2019-05-01,36,36,0
"Coldwater, MI",17740.0,2019-06-01,-23,0,-23
"Coldwater, MI",17740.0,2019-07-01,-6,0,-6
"Coldwater, MI",17740.0,2019-08-01,-8,0,-8
"Coldwater, MI",17740.0,2019-09-01,10,0,10
"Coldwater, MI",17740.0,2019-10-01,17,-14,31
"Coldwater, MI",17740.0,2019-11-01,-27,-46,19
"Coldwater, MI",17740.0,2019-12-01,-60,-60,0
"Coldwater, MI",17740.0,2020-01-01,-40,0,-40
"Coldwater, MI",17740.0,2020-02-01,-10,0,-10
"Coldwater, MI",17740.0,2020-03-01,7,0,7
"Coldwater, MI",17740.0,2020-04-01,13,13,0
"Coldwater, MI",17740.0,2020-05-01,36,12,24
"Coldwater, MI",17740.0,2020-06-01,7,0,7
"Coldwater, MI",17740.0,2020-07-01,18,0,18
"Coldwater, MI",17740.0,2020-08-01,-1,0,-1
"Coldwater, MI",17740.0,2020-09-01,28,0,28
"Coldwater, MI",17740.0,2020-10-01,-33,-39,6
"Coldwater, MI",17740.0,2020-11-01,-19,-12,-7
"Coldwater, MI",17740.0,2020-12-01,-52,-25,-27
"Brunswick, GA",15260.0,2019-01-01,-22,0,-22
"Brunswick, GA",15260.0,2019-02-01,-25,0,-25
"Brunswick, GA",15260.0,2019-03-01,1,0,1
"Brunswick, GA",15260.0,2019-04-01,0,0,0
"Brunswick, GA",15260.0,2019-05-01,-24,0,-24
"Brunswick, GA",15260.0,2019-06-01,-64,0,-64
"Brunswick, GA",15260.0,2019-07-01,39,0,39
"Brunswick, GA",15260.0,2019-08-01,14,0,14
"Brunswick, GA",15260.0,2019-09-01,0,0,0
"Brunswick, GA",15260.0,2019-10-01,-17,0,-17
"Brunswick, GA",15260.0,2019-11-01,10,0,10
"Brunswick, GA",15260.0,2019-12-01,1,0,1
"Brunswick, GA",15260.0,2020-01-01,36,0,36
"Brunswick, GA",15260.0,2020-02-01,0,0,0
"Brunswick, GA",15260.0,2020-03-01,6,0,6
"Brunswick, GA",15260.0,2020-04-01,-4,0,-4
"Brunswick, GA",15260.0,2020-05-01,26,0,26
"Brunswick, GA",15260.0,2020-06-01,-20,0,-20
"Brunswick, GA",15260.0,2020-07-01,17,0,17
"Brunswick, GA",15260.0,2020-08-01,9,0,9
"Brunswick, GA",15260.0,2020-09-01,23,0,23
"Brunswick, GA",15260.0,2020-10-01,39,0,39
"Brunswick, GA",15260.0,2020-11-01,10,0,10
"Brunswick, GA",15260.0,2020-12-01,15,0,15
"College Station-Bryan, TX",17780.0,2019-01-01,-149,0,-149
"College Station-Bryan, TX",17780.0,2019-02-01,14,0,14
"College Station-Bryan, TX",17780.0,2019-03-01,-39,0,-39
"College Station-Bryan, TX",17780.0,2019-04-01,-72,0,-72
"College Station-Bryan, TX",17780.0,2019-05-01,-591,-28,-563
"College Station-Bryan, TX",17780.0,2019-06-01,-376,0,-376
"College Station-Bryan, TX",17780.0,2019-07-01,-794,-13,-781
"College Station-Bryan, TX",17780.0,2019-08-01,27,24,3
"College Station-Bryan, TX",17780.0,2019-09-01,-25,0,-25
"College Station-Bryan, TX",17780.0,2019-10-01,-5,0,-5
"College Station-Bryan, TX",17780.0,2019-11-01,-65,0,-65
"College Station-Bryan, TX",17780.0,2019-12-01,-127,0,-127
"College Station-Bryan, TX",17780.0,2020-01-01,-145,0,-145
"College Station-Bryan, TX",17780.0,2020-02-01,-27,0,-27
"College Station-Bryan, TX",17780.0,2020-03-01,-103,11,-114
"College Station-Bryan, TX",17780.0,2020-04-01,-189,0,-189
"College Station-Bryan, TX",17780.0,2020-05-01,-277,0,-277
"College Station-Bryan, TX",17780.0,2020-06-01,-293,-11,-282
"College Station-Bryan, TX",17780.0,2020-07-01,-552,-12,-540
"College Station-Bryan, TX",17780.0,2020-08-01,-123,11,-134
"College Station-Bryan, TX",17780.0,2020-09-01,12,0,12
"College Station-Bryan, TX",17780.0,2020-10-01,-22,0,-22
"College Station-Bryan, TX",17780.0,2020-11-01,2,0,2
"College Station-Bryan, TX",17780.0,2020-12-01,-81,0,-81
"Palm Bay-Melbourne-Titusville, FL",37340.0,2019-01-01,1384,1291,93
"Palm Bay-Melbourne-Titusville, FL",37340.0,2019-02-01,183,95,88
"Palm Bay-Melbourne-Titusville, FL",37340.0,2019-03-01,42,-17,59
"Palm Bay-Melbourne-Titusville, FL",37340.0,2019-04-01,-842,-773,-69
"Palm Bay-Melbourne-Titusville, FL",37340.0,2019-05-01,-1399,-1544,145
"Palm Bay-Melbourne-Titusville, FL",37340.0,2019-06-01,13,-371,384
"Palm Bay-Melbourne-Titusville, FL",37340.0,2019-07-01,405,-15,420
"Palm Bay-Melbourne-Titusville, FL",37340.0,2019-08-01,452,-1,453
"Palm Bay-Melbourne-Titusville, FL",37340.0,2019-09-01,316,69,247
"Palm Bay-Melbourne-Titusville, FL",37340.0,2019-10-01,1291,893,398
"Palm Bay-Melbourne-Titusville, FL",37340.0,2019-11-01,977,730,247
"Palm Bay-Melbourne-Titusville, FL",37340.0,2019-12-01,1336,1214,122
"Palm Bay-Melbourne-Titusville, FL",37340.0,2020-01-01,1606,1314,292
"Palm Bay-Melbourne-Titusville, FL",37340.0,2020-02-01,295,59,236
"Palm Bay-Melbourne-Titusville, FL",37340.0,2020-03-01,145,33,112
"Palm Bay-Melbourne-Titusville, FL",37340.0,2020-04-01,157,-19,176
"Palm Bay-Melbourne-Titusville, FL",37340.0,2020-05-01,-375,-690,315
"Palm Bay-Melbourne-Titusville, FL",37340.0,2020-06-01,-191,-687,496
"Palm Bay-Melbourne-Titusville, FL",37340.0,2020-07-01,557,-104,661
"Palm Bay-Melbourne-Titusville, FL",37340.0,2020-08-01,600,-13,613
"Palm Bay-Melbourne-Titusville, FL",37340.0,2020-09-01,481,0,481
"Palm Bay-Melbourne-Titusville, FL",37340.0,2020-10-01,1227,706,521
"Palm Bay-Melbourne-Titusville, FL",37340.0,2020-11-01,777,585,192
"Palm Bay-Melbourne-Titusville, FL",37340.0,2020-12-01,1283,848,435
"Providence-Warwick, RI-MA",39300.0,2019-01-01,-1356,-1518,162
"Providence-Warwick, RI-MA",39300.0,2019-02-01,69,-114,183
"Providence-Warwick, RI-MA",39300.0,2019-03-01,351,-7,358
"Providence-Warwick, RI-MA",39300.0,2019-04-01,1930,1200,730
"Providence-Warwick, RI-MA",39300.0,2019-05-01,3083,2673,410
"Providence-Warwick, RI-MA",39300.0,2019-06-01,1680,832,848
"Providence-Warwick, RI-MA",39300.0,2019-07-01,366,39,327
"Providence-Warwick, RI-MA",39300.0,2019-08-01,412,28,384
"Providence-Warwick, RI-MA",39300.0,2019-09-01,-147,-256,109
"Providence-Warwick, RI-MA",39300.0,2019-10-01,-1803,-1649,-154
"Providence-Warwick, RI-MA",39300.0,2019-11-01,-375,-550,175
"Providence-Warwick, RI-MA",39300.0,2019-12-01,-1122,-1381,259
"Providence-Warwick, RI-MA",39300.0,2020-01-01,-1176,-1494,318
"Providence-Warwick, RI-MA",39300.0,2020-02-01,59,-75,134
"Providence-Warwick, RI-MA",39300.0,2020-03-01,1117,617,500
"Providence-Warwick, RI-MA",39300.0,2020-04-01,1101,626,475
"Providence-Warwick, RI-MA",39300.0,2020-05-01,2380,1694,686
"Providence-Warwick, RI-MA",39300.0,2020-06-01,2550,1855,695
"Providence-Warwick, RI-MA",39300.0,2020-07-01,1141,439,702
"Providence-Warwick, RI-MA",39300.0,2020-08-01,777,62,715
"Providence-Warwick, RI-MA",39300.0,2020-09-01,330,19,311
"Providence-Warwick, RI-MA",39300.0,2020-10-01,-951,-1094,143
"Providence-Warwick, RI-MA",39300.0,2020-11-01,-374,-667,293
"Providence-Warwick, RI-MA",39300.0,2020-12-01,-957,-1241,284
"Kingsport-Bristol, TN-VA",28700.0,2019-01-01,87,0,87
"Kingsport-Bristol, TN-VA",28700.0,2019-02-01,23,0,23
"Kingsport-Bristol, TN-VA",28700.0,2019-03-01,-26,0,-26
"Kingsport-Bristol, TN-VA",28700.0,2019-04-01,24,0,24
"Kingsport-Bristol, TN-VA",28700.0,2019-05-01,32,0,32
"Kingsport-Bristol, TN-VA",28700.0,2019-06-01,34,0,34
"Kingsport-Bristol, TN-VA",28700.0,2019-07-01,5,0,5
"Kingsport-Bristol, TN-VA",28700.0,2019-08-01,19,0,19
"Kingsport-Bristol, TN-VA",28700.0,2019-09-01,51,0,51
"Kingsport-Bristol, TN-VA",28700.0,2019-10-01,39,0,39
"Kingsport-Bristol, TN-VA",28700.0,2019-11-01,7,0,7
"Kingsport-Bristol, TN-VA",28700.0,2019-12-01,-1,0,-1
"Kingsport-Bristol, TN-VA",28700.0,2020-01-01,34,0,34
"Kingsport-Bristol, TN-VA",28700.0,2020-02-01,-20,0,-20
"Kingsport-Bristol, TN-VA",28700.0,2020-03-01,22,0,22
"Kingsport-Bristol, TN-VA",28700.0,2020-04-01,36,0,36
"Kingsport-Bristol, TN-VA",28700.0,2020-05-01,17,0,17
"Kingsport-Bristol, TN-VA",28700.0,2020-06-01,86,0,86
"Kingsport-Bristol, TN-VA",28700.0,2020-07-01,76,0,76
"Kingsport-Bristol, TN-VA",28700.0,2020-08-01,48,0,48
"Kingsport-Bristol, TN-VA",28700.0,2020-09-01,64,0,64
"Kingsport-Bristol, TN-VA",28700.0,2020-10-01,20,0,20
"Kingsport-Bristol, TN-VA",28700.0,2020-11-01,74,0,74
"Kingsport-Bristol, TN-VA",28700.0,2020-12-01,49,0,49
"Weirton-Steubenville, WV-OH",48260.0,2019-01-01,33,0,33
"Weirton-Steubenville, WV-OH",48260.0,2019-02-01,3,0,3
"Weirton-Steubenville, WV-OH",48260.0,2019-03-01,-13,0,-13
"Weirton-Steubenville, WV-OH",48260.0,2019-04-01,53,0,53
"Weirton-Steubenville, WV-OH",48260.0,2019-05-01,35,0,35
"Weirton-Steubenville, WV-OH",48260.0,2019-06-01,-18,0,-18
"Weirton-Steubenville, WV-OH",48260.0,2019-07-01,-30,0,-30
"Weirton-Steubenville, WV-OH",48260.0,2019-08-01,25,0,25
"Weirton-Steubenville, WV-OH",48260.0,2019-09-01,-5,0,-5
"Weirton-Steubenville, WV-OH",48260.0,2019-10-01,19,0,19
"Weirton-Steubenville, WV-OH",48260.0,2019-11-01,9,0,9
"Weirton-Steubenville, WV-OH",48260.0,2019-12-01,-15,0,-15
"Weirton-Steubenville, WV-OH",48260.0,2020-01-01,-44,0,-44
"Weirton-Steubenville, WV-OH",48260.0,2020-02-01,13,0,13
"Weirton-Steubenville, WV-OH",48260.0,2020-03-01,4,0,4
"Weirton-Steubenville, WV-OH",48260.0,2020-04-01,27,0,27
"Weirton-Steubenville, WV-OH",48260.0,2020-05-01,54,0,54
"Weirton-Steubenville, WV-OH",48260.0,2020-06-01,0,0,0
"Weirton-Steubenville, WV-OH",48260.0,2020-07-01,5,0,5
"Weirton-Steubenville, WV-OH",48260.0,2020-08-01,-8,0,-8
"Weirton-Steubenville, WV-OH",48260.0,2020-09-01,13,0,13
"Weirton-Steubenville, WV-OH",48260.0,2020-10-01,20,0,20
"Weirton-Steubenville, WV-OH",48260.0,2020-11-01,-16,0,-16
"Weirton-Steubenville, WV-OH",48260.0,2020-12-01,0,0,0
"Brookings, SD",15100.0,2019-01-01,-4,0,-4
"Brookings, SD",15100.0,2019-02-01,-17,0,-17
"Brookings, SD",15100.0,2019-03-01,-23,0,-23
"Brookings, SD",15100.0,2019-04-01,-13,0,-13
"Brookings, SD",15100.0,2019-05-01,-62,0,-62
"Brookings, SD",15100.0,2019-06-01,-30,0,-30
"Brookings, SD",15100.0,2019-07-01,-11,0,-11
"Brookings, SD",15100.0,2019-08-01,-15,0,-15
"Brookings, SD",15100.0,2019-09-01,-16,0,-16
"Brookings, SD",15100.0,2019-10-01,-19,0,-19
"Brookings, SD",15100.0,2019-11-01,-29,-15,-14
"Brookings, SD",15100.0,2019-12-01,-14,-14,0
"Brookings, SD",15100.0,2020-01-01,-15,0,-15
"Brookings, SD",15100.0,2020-02-01,-15,0,-15
"Brookings, SD",15100.0,2020-03-01,11,0,11
"Brookings, SD",15100.0,2020-04-01,-35,0,-35
"Brookings, SD",15100.0,2020-05-01,-55,0,-55
"Brookings, SD",15100.0,2020-06-01,-18,0,-18
"Brookings, SD",15100.0,2020-07-01,8,0,8
"Brookings, SD",15100.0,2020-08-01,-3,0,-3
"Brookings, SD",15100.0,2020-09-01,-10,0,-10
"Brookings, SD",15100.0,2020-10-01,-7,0,-7
"Brookings, SD",15100.0,2020-11-01,-17,-17,0
"Brookings, SD",15100.0,2020-12-01,-25,-13,-12
"Valdosta, GA",46660.0,2019-01-01,21,0,21
"Valdosta, GA",46660.0,2019-02-01,35,0,35
"Valdosta, GA",46660.0,2019-03-01,-25,0,-25
"Valdosta, GA",46660.0,2019-04-01,19,0,19
"Valdosta, GA",46660.0,2019-05-01,-34,0,-34
"Valdosta, GA",46660.0,2019-06-01,25,0,25
"Valdosta, GA",46660.0,2019-07-01,8,0,8
"Valdosta, GA",46660.0,2019-08-01,60,0,60
"Valdosta, GA",46660.0,2019-09-01,-4,0,-4
"Valdosta, GA",46660.0,2019-10-01,-12,0,-12
"Valdosta, GA",46660.0,2019-11-01,23,0,23
"Valdosta, GA",46660.0,2019-12-01,7,0,7
"Valdosta, GA",46660.0,2020-01-01,-31,0,-31
"Valdosta, GA",46660.0,2020-02-01,60,0,60
"Valdosta, GA",46660.0,2020-03-01,27,0,27
"Valdosta, GA",46660.0,2020-04-01,-1,0,-1
"Valdosta, GA",46660.0,2020-05-01,-43,0,-43
"Valdosta, GA",46660.0,2020-06-01,48,0,48
"Valdosta, GA",46660.0,2020-07-01,17,0,17
"Valdosta, GA",46660.0,2020-08-01,4,0,4
"Valdosta, GA",46660.0,2020-09-01,-29,0,-29
"Valdosta, GA",46660.0,2020-10-01,5,0,5
"Valdosta, GA",46660.0,2020-11-01,29,0,29
"Valdosta, GA",46660.0,2020-12-01,-46,0,-46
"Binghamton, NY",13780.0,2019-01-01,-204,-189,-15
"Binghamton, NY",13780.0,2019-02-01,-5,-14,9
"Binghamton, NY",13780.0,2019-03-01,-8,0,-8
"Binghamton, NY",13780.0,2019-04-01,194,111,83
"Binghamton, NY",13780.0,2019-05-01,191,151,40
"Binghamton, NY",13780.0,2019-06-01,29,11,18
"Binghamton, NY",13780.0,2019-07-01,31,-14,45
"Binghamton, NY",13780.0,2019-08-01,38,0,38
"Binghamton, NY",13780.0,2019-09-01,-30,0,-30
"Binghamton, NY",13780.0,2019-10-01,-162,-129,-33
"Binghamton, NY",13780.0,2019-11-01,-113,-90,-23
"Binghamton, NY",13780.0,2019-12-01,-232,-191,-41
"Binghamton, NY",13780.0,2020-01-01,-160,-210,50
"Binghamton, NY",13780.0,2020-02-01,30,0,30
"Binghamton, NY",13780.0,2020-03-01,118,30,88
"Binghamton, NY",13780.0,2020-04-01,82,44,38
"Binghamton, NY",13780.0,2020-05-01,144,99,45
"Binghamton, NY",13780.0,2020-06-01,94,47,47
"Binghamton, NY",13780.0,2020-07-01,97,-13,110
"Binghamton, NY",13780.0,2020-08-01,14,0,14
"Binghamton, NY",13780.0,2020-09-01,58,-12,70
"Binghamton, NY",13780.0,2020-10-01,-73,-80,7
"Binghamton, NY",13780.0,2020-11-01,-74,-95,21
"Binghamton, NY",13780.0,2020-12-01,-100,-97,-3
"Miami-Fort Lauderdale-Pompano Beach, FL",33100.0,2019-01-01,9347,10624,-1277
"Miami-Fort Lauderdale-Pompano Beach, FL",33100.0,2019-02-01,-156,1296,-1452
"Miami-Fort Lauderdale-Pompano Beach, FL",33100.0,2019-03-01,-4412,-805,-3607
"Miami-Fort Lauderdale-Pompano Beach, FL",33100.0,2019-04-01,-16760,-9692,-7068
"Miami-Fort Lauderdale-Pompano Beach, FL",33100.0,2019-05-01,-22304,-18195,-4109
"Miami-Fort Lauderdale-Pompano Beach, FL",33100.0,2019-06-01,-8661,-6517,-2144
"Miami-Fort Lauderdale-Pompano Beach, FL",33100.0,2019-07-01,-2901,-1777,-1124
"Miami-Fort Lauderdale-Pompano Beach, FL",33100.0,2019-08-01,-1524,-649,-875
"Miami-Fort Lauderdale-Pompano Beach, FL",33100.0,2019-09-01,1457,1095,362
"Miami-Fort Lauderdale-Pompano Beach, FL",33100.0,2019-10-01,11371,9841,1530
"Miami-Fort Lauderdale-Pompano Beach, FL",33100.0,2019-11-01,7041,7224,-183
"Miami-Fort Lauderdale-Pompano Beach, FL",33100.0,2019-12-01,12900,13062,-162
"Miami-Fort Lauderdale-Pompano Beach, FL",33100.0,2020-01-01,8316,9451,-1135
"Miami-Fort Lauderdale-Pompano Beach, FL",33100.0,2020-02-01,-505,1070,-1575
"Miami-Fort Lauderdale-Pompano Beach, FL",33100.0,2020-03-01,-4792,-84,-4708
"Miami-Fort Lauderdale-Pompano Beach, FL",33100.0,2020-04-01,-2001,1597,-3598
"Miami-Fort Lauderdale-Pompano Beach, FL",33100.0,2020-05-01,-8043,-4609,-3434
"Miami-Fort Lauderdale-Pompano Beach, FL",33100.0,2020-06-01,-13336,-9998,-3338
"Miami-Fort Lauderdale-Pompano Beach, FL",33100.0,2020-07-01,-7196,-4491,-2705
"Miami-Fort Lauderdale-Pompano Beach, FL",33100.0,2020-08-01,-3449,-1098,-2351
"Miami-Fort Lauderdale-Pompano Beach, FL",33100.0,2020-09-01,-551,273,-824
"Miami-Fort Lauderdale-Pompano Beach, FL",33100.0,2020-10-01,9082,8045,1037
"Miami-Fort Lauderdale-Pompano Beach, FL",33100.0,2020-11-01,8245,8561,-316
"Miami-Fort Lauderdale-Pompano Beach, FL",33100.0,2020-12-01,11640,11649,-9
"New Ulm, MN",35580.0,2019-01-01,0,0,0
"New Ulm, MN",35580.0,2019-02-01,0,0,0
"New Ulm, MN",35580.0,2019-03-01,0,0,0
"New Ulm, MN",35580.0,2019-04-01,0,0,0
"New Ulm, MN",35580.0,2019-05-01,34,12,22
"New Ulm, MN",35580.0,2019-06-01,7,0,7
"New Ulm, MN",35580.0,2019-07-01,-11,0,-11
"New Ulm, MN",35580.0,2019-08-01,3,0,3
"New Ulm, MN",35580.0,2019-09-01,0,0,0
"New Ulm, MN",35580.0,2019-10-01,-3,0,-3
"New Ulm, MN",35580.0,2019-11-01,-23,0,-23
"New Ulm, MN",35580.0,2019-12-01,-53,-42,-11
"New Ulm, MN",35580.0,2020-01-01,-12,-12,0
"New Ulm, MN",35580.0,2020-02-01,0,0,0
"New Ulm, MN",35580.0,2020-03-01,0,0,0
"New Ulm, MN",35580.0,2020-04-01,0,0,0
"New Ulm, MN",35580.0,2020-05-01,0,0,0
"New Ulm, MN",35580.0,2020-06-01,0,0,0
"New Ulm, MN",35580.0,2020-07-01,17,0,17
"New Ulm, MN",35580.0,2020-08-01,1,0,1
"New Ulm, MN",35580.0,2020-09-01,0,0,0
"New Ulm, MN",35580.0,2020-10-01,35,0,35
"New Ulm, MN",35580.0,2020-11-01,-18,-18,0
"New Ulm, MN",35580.0,2020-12-01,-13,-13,0
"Aberdeen, SD",10100.0,2019-01-01,-22,-11,-11
"Aberdeen, SD",10100.0,2019-02-01,0,0,0
"Aberdeen, SD",10100.0,2019-03-01,-12,0,-12
"Aberdeen, SD",10100.0,2019-04-01,28,14,14
"Aberdeen, SD",10100.0,2019-05-01,0,0,0
"Aberdeen, SD",10100.0,2019-06-01,0,0,0
"Aberdeen, SD",10100.0,2019-07-01,0,0,0
"Aberdeen, SD",10100.0,2019-08-01,-16,0,-16
"Aberdeen, SD",10100.0,2019-09-01,0,0,0
"Aberdeen, SD",10100.0,2019-10-01,-40,-40,0
"Aberdeen, SD",10100.0,2019-11-01,-16,-16,0
"Aberdeen, SD",10100.0,2019-12-01,-53,-53,0
"Aberdeen, SD",10100.0,2020-01-01,-12,-12,0
"Aberdeen, SD",10100.0,2020-02-01,0,0,0
"Aberdeen, SD",10100.0,2020-03-01,-11,0,-11
"Aberdeen, SD",10100.0,2020-04-01,-11,0,-11
"Aberdeen, SD",10100.0,2020-05-01,14,0,14
"Aberdeen, SD",10100.0,2020-06-01,0,0,0
"Aberdeen, SD",10100.0,2020-07-01,0,0,0
"Aberdeen, SD",10100.0,2020-08-01,-24,0,-24
"Aberdeen, SD",10100.0,2020-09-01,-11,0,-11
"Aberdeen, SD",10100.0,2020-10-01,-54,-40,-14
"Aberdeen, SD",10100.0,2020-11-01,-21,-21,0
"Aberdeen, SD",10100.0,2020-12-01,-39,-28,-11
"Brownwood, TX",15220.0,2019-01-01,0,0,0
"Brownwood, TX",15220.0,2019-02-01,11,0,11
"Brownwood, TX",15220.0,2019-03-01,0,0,0
"Brownwood, TX",15220.0,2019-04-01,0,0,0
"Brownwood, TX",15220.0,2019-05-01,-12,0,-12
"Brownwood, TX",15220.0,2019-06-01,-14,0,-14
"Brownwood, TX",15220.0,2019-07-01,-2,0,-2
"Brownwood, TX",15220.0,2019-08-01,13,0,13
"Brownwood, TX",15220.0,2019-09-01,0,0,0
"Brownwood, TX",15220.0,2019-10-01,-12,0,-12
"Brownwood, TX",15220.0,2019-11-01,0,0,0
"Brownwood, TX",15220.0,2019-12-01,11,0,11
"Brownwood, TX",15220.0,2020-01-01,-12,0,-12
"Brownwood, TX",15220.0,2020-02-01,0,0,0
"Brownwood, TX",15220.0,2020-03-01,0,0,0
"Brownwood, TX",15220.0,2020-04-01,0,0,0
"Brownwood, TX",15220.0,2020-05-01,0,0,0
"Brownwood, TX",15220.0,2020-06-01,14,0,14
"Brownwood, TX",15220.0,2020-07-01,14,0,14
"Brownwood, TX",15220.0,2020-08-01,26,0,26
"Brownwood, TX",15220.0,2020-09-01,0,0,0
"Brownwood, TX",15220.0,2020-10-01,0,0,0
"Brownwood, TX",15220.0,2020-11-01,0,0,0
"Brownwood, TX",15220.0,2020-12-01,0,0,0
"Green Bay, WI",24580.0,2019-01-01,-220,-282,62
"Green Bay, WI",24580.0,2019-02-01,-38,-15,-23
"Green Bay, WI",24580.0,2019-03-01,-55,0,-55
"Green Bay, WI",24580.0,2019-04-01,287,134,153
"Green Bay, WI",24580.0,2019-05-01,276,186,90
"Green Bay, WI",24580.0,2019-06-01,76,17,59
"Green Bay, WI",24580.0,2019-07-01,31,0,31
"Green Bay, WI",24580.0,2019-08-01,8,0,8
"Green Bay, WI",24580.0,2019-09-01,-26,0,-26
"Green Bay, WI",24580.0,2019-10-01,-245,-200,-45
"Green Bay, WI",24580.0,2019-11-01,-119,-159,40
"Green Bay, WI",24580.0,2019-12-01,-299,-337,38
"Green Bay, WI",24580.0,2020-01-01,-352,-345,-7
"Green Bay, WI",24580.0,2020-02-01,-46,-31,-15
"Green Bay, WI",24580.0,2020-03-01,31,43,-12
"Green Bay, WI",24580.0,2020-04-01,138,78,60
"Green Bay, WI",24580.0,2020-05-01,159,123,36
"Green Bay, WI",24580.0,2020-06-01,98,11,87
"Green Bay, WI",24580.0,2020-07-01,44,0,44
"Green Bay, WI",24580.0,2020-08-01,102,0,102
"Green Bay, WI",24580.0,2020-09-01,-29,0,-29
"Green Bay, WI",24580.0,2020-10-01,-204,-225,21
"Green Bay, WI",24580.0,2020-11-01,-51,-91,40
"Green Bay, WI",24580.0,2020-12-01,-193,-227,34
"Myrtle Beach-Conway-North Myrtle Beach, SC-NC",34820.0,2019-01-01,796,672,124
"Myrtle Beach-Conway-North Myrtle Beach, SC-NC",34820.0,2019-02-01,135,50,85
"Myrtle Beach-Conway-North Myrtle Beach, SC-NC",34820.0,2019-03-01,147,-13,160
"Myrtle Beach-Conway-North Myrtle Beach, SC-NC",34820.0,2019-04-01,184,-33,217
"Myrtle Beach-Conway-North Myrtle Beach, SC-NC",34820.0,2019-05-01,391,-57,448
"Myrtle Beach-Conway-North Myrtle Beach, SC-NC",34820.0,2019-06-01,602,14,588
"Myrtle Beach-Conway-North Myrtle Beach, SC-NC",34820.0,2019-07-01,499,0,499
"Myrtle Beach-Conway-North Myrtle Beach, SC-NC",34820.0,2019-08-01,584,0,584
"Myrtle Beach-Conway-North Myrtle Beach, SC-NC",34820.0,2019-09-01,237,0,237
"Myrtle Beach-Conway-North Myrtle Beach, SC-NC",34820.0,2019-10-01,451,130,321
"Myrtle Beach-Conway-North Myrtle Beach, SC-NC",34820.0,2019-11-01,334,98,236
"Myrtle Beach-Conway-North Myrtle Beach, SC-NC",34820.0,2019-12-01,940,730,210
"Myrtle Beach-Conway-North Myrtle Beach, SC-NC",34820.0,2020-01-01,837,604,233
"Myrtle Beach-Conway-North Myrtle Beach, SC-NC",34820.0,2020-02-01,244,34,210
"Myrtle Beach-Conway-North Myrtle Beach, SC-NC",34820.0,2020-03-01,505,61,444
"Myrtle Beach-Conway-North Myrtle Beach, SC-NC",34820.0,2020-04-01,382,78,304
"Myrtle Beach-Conway-North Myrtle Beach, SC-NC",34820.0,2020-05-01,383,-35,418
"Myrtle Beach-Conway-North Myrtle Beach, SC-NC",34820.0,2020-06-01,519,-28,547
"Myrtle Beach-Conway-North Myrtle Beach, SC-NC",34820.0,2020-07-01,587,0,587
"Myrtle Beach-Conway-North Myrtle Beach, SC-NC",34820.0,2020-08-01,672,0,672
"Myrtle Beach-Conway-North Myrtle Beach, SC-NC",34820.0,2020-09-01,540,0,540
"Myrtle Beach-Conway-North Myrtle Beach, SC-NC",34820.0,2020-10-01,871,112,759
"Myrtle Beach-Conway-North Myrtle Beach, SC-NC",34820.0,2020-11-01,588,71,517
"Myrtle Beach-Conway-North Myrtle Beach, SC-NC",34820.0,2020-12-01,780,395,385
"Savannah, GA",42340.0,2019-01-01,-40,0,-40
"Savannah, GA",42340.0,2019-02-01,-83,0,-83
"Savannah, GA",42340.0,2019-03-01,-127,0,-127
"Savannah, GA",42340.0,2019-04-01,-29,0,-29
"Savannah, GA",42340.0,2019-05-01,-21,-11,-10
"Savannah, GA",42340.0,2019-06-01,-4,0,-4
"Savannah, GA",42340.0,2019-07-01,48,0,48
"Savannah, GA",42340.0,2019-08-01,-86,0,-86
"Savannah, GA",42340.0,2019-09-01,-88,0,-88
"Savannah, GA",42340.0,2019-10-01,-40,0,-40
"Savannah, GA",42340.0,2019-11-01,-74,0,-74
"Savannah, GA",42340.0,2019-12-01,-42,0,-42
"Savannah, GA",42340.0,2020-01-01,-20,0,-20
"Savannah, GA",42340.0,2020-02-01,-51,0,-51
"Savannah, GA",42340.0,2020-03-01,-43,0,-43
"Savannah, GA",42340.0,2020-04-01,-59,0,-59
"Savannah, GA",42340.0,2020-05-01,0,0,0
"Savannah, GA",42340.0,2020-06-01,20,0,20
"Savannah, GA",42340.0,2020-07-01,63,0,63
"Savannah, GA",42340.0,2020-08-01,30,0,30
"Savannah, GA",42340.0,2020-09-01,15,11,4
"Savannah, GA",42340.0,2020-10-01,-14,0,-14
"Savannah, GA",42340.0,2020-11-01,-16,0,-16
"Savannah, GA",42340.0,2020-12-01,-16,-2,-14
"Durant, OK",20460.0,2019-01-01,4,0,4
"Durant, OK",20460.0,2019-02-01,-4,0,-4
"Durant, OK",20460.0,2019-03-01,18,0,18
"Durant, OK",20460.0,2019-04-01,-13,0,-13
"Durant, OK",20460.0,2019-05-01,13,0,13
"Durant, OK",20460.0,2019-06-01,3,0,3
"Durant, OK",20460.0,2019-07-01,1,0,1
"Durant, OK",20460.0,2019-08-01,16,0,16
"Durant, OK",20460.0,2019-09-01,3,0,3
"Durant, OK",20460.0,2019-10-01,15,0,15
"Durant, OK",20460.0,2019-11-01,-15,0,-15
"Durant, OK",20460.0,2019-12-01,1,0,1
"Durant, OK",20460.0,2020-01-01,24,0,24
"Durant, OK",20460.0,2020-02-01,-2,0,-2
"Durant, OK",20460.0,2020-03-01,15,0,15
"Durant, OK",20460.0,2020-04-01,1,0,1
"Durant, OK",20460.0,2020-05-01,-3,0,-3
"Durant, OK",20460.0,2020-06-01,-9,0,-9
"Durant, OK",20460.0,2020-07-01,16,0,16
"Durant, OK",20460.0,2020-08-01,16,0,16
"Durant, OK",20460.0,2020-09-01,-7,0,-7
"Durant, OK",20460.0,2020-10-01,12,0,12
"Durant, OK",20460.0,2020-11-01,14,0,14
"Durant, OK",20460.0,2020-12-01,-17,0,-17
"Philadelphia-Camden-Wilmington, PA-NJ-DE-MD",37980.0,2019-01-01,-2465,-2508,43
"Philadelphia-Camden-Wilmington, PA-NJ-DE-MD",37980.0,2019-02-01,-82,-260,178
"Philadelphia-Camden-Wilmington, PA-NJ-DE-MD",37980.0,2019-03-01,570,55,515
"Philadelphia-Camden-Wilmington, PA-NJ-DE-MD",37980.0,2019-04-01,1687,1254,433
"Philadelphia-Camden-Wilmington, PA-NJ-DE-MD",37980.0,2019-05-01,1142,1264,-122
"Philadelphia-Camden-Wilmington, PA-NJ-DE-MD",37980.0,2019-06-01,-1043,-806,-237
"Philadelphia-Camden-Wilmington, PA-NJ-DE-MD",37980.0,2019-07-01,-449,-169,-280
"Philadelphia-Camden-Wilmington, PA-NJ-DE-MD",37980.0,2019-08-01,179,-13,192
"Philadelphia-Camden-Wilmington, PA-NJ-DE-MD",37980.0,2019-09-01,451,139,312
"Philadelphia-Camden-Wilmington, PA-NJ-DE-MD",37980.0,2019-10-01,-719,-686,-33
"Philadelphia-Camden-Wilmington, PA-NJ-DE-MD",37980.0,2019-11-01,-295,-359,64
"Philadelphia-Camden-Wilmington, PA-NJ-DE-MD",37980.0,2019-12-01,-2148,-2053,-95
"Philadelphia-Camden-Wilmington, PA-NJ-DE-MD",37980.0,2020-01-01,-2424,-2393,-31
"Philadelphia-Camden-Wilmington, PA-NJ-DE-MD",37980.0,2020-02-01,-81,-191,110
"Philadelphia-Camden-Wilmington, PA-NJ-DE-MD",37980.0,2020-03-01,1311,549,762
"Philadelphia-Camden-Wilmington, PA-NJ-DE-MD",37980.0,2020-04-01,537,248,289
"Philadelphia-Camden-Wilmington, PA-NJ-DE-MD",37980.0,2020-05-01,547,289,258
"Philadelphia-Camden-Wilmington, PA-NJ-DE-MD",37980.0,2020-06-01,137,-48,185
"Philadelphia-Camden-Wilmington, PA-NJ-DE-MD",37980.0,2020-07-01,-176,100,-276
"Philadelphia-Camden-Wilmington, PA-NJ-DE-MD",37980.0,2020-08-01,575,48,527
"Philadelphia-Camden-Wilmington, PA-NJ-DE-MD",37980.0,2020-09-01,-402,5,-407
"Philadelphia-Camden-Wilmington, PA-NJ-DE-MD",37980.0,2020-10-01,-517,-659,142
"Philadelphia-Camden-Wilmington, PA-NJ-DE-MD",37980.0,2020-11-01,-768,-572,-196
"Philadelphia-Camden-Wilmington, PA-NJ-DE-MD",37980.0,2020-12-01,-1984,-1806,-178
"Storm Lake, IA",44740.0,2019-01-01,-11,-11,0
"Storm Lake, IA",44740.0,2019-02-01,0,0,0
"Storm Lake, IA",44740.0,2019-03-01,0,0,0
"Storm Lake, IA",44740.0,2019-04-01,13,13,0
"Storm Lake, IA",44740.0,2019-05-01,0,0,0
"Storm Lake, IA",44740.0,2019-06-01,21,0,21
"Storm Lake, IA",44740.0,2019-07-01,0,0,0
"Storm Lake, IA",44740.0,2019-08-01,0,0,0
"Storm Lake, IA",44740.0,2019-09-01,0,0,0
"Storm Lake, IA",44740.0,2019-10-01,0,0,0
"Storm Lake, IA",44740.0,2019-11-01,-25,-14,-11
"Storm Lake, IA",44740.0,2019-12-01,-23,-23,0
"Storm Lake, IA",44740.0,2020-01-01,-12,-12,0
"Storm Lake, IA",44740.0,2020-02-01,0,0,0
"Storm Lake, IA",44740.0,2020-03-01,0,0,0
"Storm Lake, IA",44740.0,2020-04-01,0,0,0
"Storm Lake, IA",44740.0,2020-05-01,0,0,0
"Storm Lake, IA",44740.0,2020-06-01,0,0,0
"Storm Lake, IA",44740.0,2020-07-01,0,0,0
"Storm Lake, IA",44740.0,2020-08-01,12,0,12
"Storm Lake, IA",44740.0,2020-09-01,0,0,0
"Storm Lake, IA",44740.0,2020-10-01,0,0,0
"Storm Lake, IA",44740.0,2020-11-01,0,0,0
"Storm Lake, IA",44740.0,2020-12-01,-16,-16,0
"Kearney, NE",28260.0,2019-01-01,70,-11,81
"Kearney, NE",28260.0,2019-02-01,-30,0,-30
"Kearney, NE",28260.0,2019-03-01,12,0,12
"Kearney, NE",28260.0,2019-04-01,-37,0,-37
"Kearney, NE",28260.0,2019-05-01,-39,0,-39
"Kearney, NE",28260.0,2019-06-01,-54,0,-54
"Kearney, NE",28260.0,2019-07-01,-43,0,-43
"Kearney, NE",28260.0,2019-08-01,-44,0,-44
"Kearney, NE",28260.0,2019-09-01,5,0,5
"Kearney, NE",28260.0,2019-10-01,60,0,60
"Kearney, NE",28260.0,2019-11-01,-59,-11,-48
"Kearney, NE",28260.0,2019-12-01,-54,0,-54
"Kearney, NE",28260.0,2020-01-01,-30,0,-30
"Kearney, NE",28260.0,2020-02-01,10,0,10
"Kearney, NE",28260.0,2020-03-01,18,0,18
"Kearney, NE",28260.0,2020-04-01,-25,0,-25
"Kearney, NE",28260.0,2020-05-01,-43,0,-43
"Kearney, NE",28260.0,2020-06-01,21,0,21
"Kearney, NE",28260.0,2020-07-01,-14,0,-14
"Kearney, NE",28260.0,2020-08-01,18,0,18
"Kearney, NE",28260.0,2020-09-01,0,0,0
"Kearney, NE",28260.0,2020-10-01,-14,0,-14
"Kearney, NE",28260.0,2020-11-01,-29,-11,-18
"Kearney, NE",28260.0,2020-12-01,-13,0,-13
"Louisville/Jefferson County, KY-IN",31140.0,2019-01-01,-295,-310,15
"Louisville/Jefferson County, KY-IN",31140.0,2019-02-01,-10,-18,8
"Louisville/Jefferson County, KY-IN",31140.0,2019-03-01,85,12,73
"Louisville/Jefferson County, KY-IN",31140.0,2019-04-01,392,271,121
"Louisville/Jefferson County, KY-IN",31140.0,2019-05-01,234,176,58
"Louisville/Jefferson County, KY-IN",31140.0,2019-06-01,36,34,2
"Louisville/Jefferson County, KY-IN",31140.0,2019-07-01,94,0,94
"Louisville/Jefferson County, KY-IN",31140.0,2019-08-01,-115,0,-115
"Louisville/Jefferson County, KY-IN",31140.0,2019-09-01,-182,-42,-140
"Louisville/Jefferson County, KY-IN",31140.0,2019-10-01,-436,-198,-238
"Louisville/Jefferson County, KY-IN",31140.0,2019-11-01,-157,-62,-95
"Louisville/Jefferson County, KY-IN",31140.0,2019-12-01,-264,-336,72
"Louisville/Jefferson County, KY-IN",31140.0,2020-01-01,-332,-350,18
"Louisville/Jefferson County, KY-IN",31140.0,2020-02-01,19,-11,30
"Louisville/Jefferson County, KY-IN",31140.0,2020-03-01,94,40,54
"Louisville/Jefferson County, KY-IN",31140.0,2020-04-01,77,113,-36
"Louisville/Jefferson County, KY-IN",31140.0,2020-05-01,167,162,5
"Louisville/Jefferson County, KY-IN",31140.0,2020-06-01,127,121,6
"Louisville/Jefferson County, KY-IN",31140.0,2020-07-01,-109,0,-109
"Louisville/Jefferson County, KY-IN",31140.0,2020-08-01,-25,0,-25
"Louisville/Jefferson County, KY-IN",31140.0,2020-09-01,-132,-20,-112
"Louisville/Jefferson County, KY-IN",31140.0,2020-10-01,-292,-163,-129
"Louisville/Jefferson County, KY-IN",31140.0,2020-11-01,-143,-116,-27
"Louisville/Jefferson County, KY-IN",31140.0,2020-12-01,-362,-311,-51
"Statesboro, GA",44340.0,2019-01-01,33,0,33
"Statesboro, GA",44340.0,2019-02-01,-6,0,-6
"Statesboro, GA",44340.0,2019-03-01,38,0,38
"Statesboro, GA",44340.0,2019-04-01,19,0,19
"Statesboro, GA",44340.0,2019-05-01,11,0,11
"Statesboro, GA",44340.0,2019-06-01,21,0,21
"Statesboro, GA",44340.0,2019-07-01,-67,0,-67
"Statesboro, GA",44340.0,2019-08-01,4,0,4
"Statesboro, GA",44340.0,2019-09-01,11,0,11
"Statesboro, GA",44340.0,2019-10-01,-15,0,-15
"Statesboro, GA",44340.0,2019-11-01,30,0,30
"Statesboro, GA",44340.0,2019-12-01,13,0,13
"Statesboro, GA",44340.0,2020-01-01,-17,0,-17
"Statesboro, GA",44340.0,2020-02-01,-15,0,-15
"Statesboro, GA",44340.0,2020-03-01,55,0,55
"Statesboro, GA",44340.0,2020-04-01,26,0,26
"Statesboro, GA",44340.0,2020-05-01,-22,0,-22
"Statesboro, GA",44340.0,2020-06-01,3,0,3
"Statesboro, GA",44340.0,2020-07-01,-103,0,-103
"Statesboro, GA",44340.0,2020-08-01,19,0,19
"Statesboro, GA",44340.0,2020-09-01,33,0,33
"Statesboro, GA",44340.0,2020-10-01,8,0,8
"Statesboro, GA",44340.0,2020-11-01,5,0,5
"Statesboro, GA",44340.0,2020-12-01,-14,0,-14
"Asheville, NC",11700.0,2019-01-01,-30,-11,-19
"Asheville, NC",11700.0,2019-02-01,-42,0,-42
"Asheville, NC",11700.0,2019-03-01,-6,0,-6
"Asheville, NC",11700.0,2019-04-01,333,335,-2
"Asheville, NC",11700.0,2019-05-01,694,706,-12
"Asheville, NC",11700.0,2019-06-01,317,288,29
"Asheville, NC",11700.0,2019-07-01,145,39,106
"Asheville, NC",11700.0,2019-08-01,-97,11,-108
"Asheville, NC",11700.0,2019-09-01,-82,0,-82
"Asheville, NC",11700.0,2019-10-01,-576,-370,-206
"Asheville, NC",11700.0,2019-11-01,-417,-278,-139
"Asheville, NC",11700.0,2019-12-01,-194,-150,-44
"Asheville, NC",11700.0,2020-01-01,-57,-38,-19
"Asheville, NC",11700.0,2020-02-01,-4,0,-4
"Asheville, NC",11700.0,2020-03-01,82,73,9
"Asheville, NC",11700.0,2020-04-01,-164,60,-224
"Asheville, NC",11700.0,2020-05-01,285,332,-47
"Asheville, NC",11700.0,2020-06-01,482,400,82
"Asheville, NC",11700.0,2020-07-01,257,149,108
"Asheville, NC",11700.0,2020-08-01,280,63,217
"Asheville, NC",11700.0,2020-09-01,80,23,57
"Asheville, NC",11700.0,2020-10-01,-345,-275,-70
"Asheville, NC",11700.0,2020-11-01,-230,-234,4
"Asheville, NC",11700.0,2020-12-01,3,-32,35
"Ottawa, IL",36837.0,2019-01-01,-49,-66,17
"Ottawa, IL",36837.0,2019-02-01,-10,0,-10
"Ottawa, IL",36837.0,2019-03-01,-16,0,-16
"Ottawa, IL",36837.0,2019-04-01,100,29,71
"Ottawa, IL",36837.0,2019-05-01,40,14,26
"Ottawa, IL",36837.0,2019-06-01,121,0,121
"Ottawa, IL",36837.0,2019-07-01,24,0,24
"Ottawa, IL",36837.0,2019-08-01,-10,0,-10
"Ottawa, IL",36837.0,2019-09-01,-19,0,-19
"Ottawa, IL",36837.0,2019-10-01,-25,-18,-7
"Ottawa, IL",36837.0,2019-11-01,-7,-27,20
"Ottawa, IL",36837.0,2019-12-01,-16,-51,35
"Ottawa, IL",36837.0,2020-01-01,-29,-28,-1
"Ottawa, IL",36837.0,2020-02-01,10,0,10
"Ottawa, IL",36837.0,2020-03-01,-11,0,-11
"Ottawa, IL",36837.0,2020-04-01,71,11,60
"Ottawa, IL",36837.0,2020-05-01,24,13,11
"Ottawa, IL",36837.0,2020-06-01,13,11,2
"Ottawa, IL",36837.0,2020-07-01,69,0,69
"Ottawa, IL",36837.0,2020-08-01,27,0,27
"Ottawa, IL",36837.0,2020-09-01,49,0,49
"Ottawa, IL",36837.0,2020-10-01,1,-45,46
"Ottawa, IL",36837.0,2020-11-01,12,-24,36
"Ottawa, IL",36837.0,2020-12-01,51,-36,87
"Bismarck, ND",13900.0,2019-01-01,-147,-124,-23
"Bismarck, ND",13900.0,2019-02-01,-15,0,-15
"Bismarck, ND",13900.0,2019-03-01,30,0,30
"Bismarck, ND",13900.0,2019-04-01,190,112,78
"Bismarck, ND",13900.0,2019-05-01,129,93,36
"Bismarck, ND",13900.0,2019-06-01,53,0,53
"Bismarck, ND",13900.0,2019-07-01,-14,0,-14
"Bismarck, ND",13900.0,2019-08-01,30,0,30
"Bismarck, ND",13900.0,2019-09-01,-23,-20,-3
"Bismarck, ND",13900.0,2019-10-01,-224,-235,11
"Bismarck, ND",13900.0,2019-11-01,-148,-139,-9
"Bismarck, ND",13900.0,2019-12-01,-160,-155,-5
"Bismarck, ND",13900.0,2020-01-01,-131,-126,-5
"Bismarck, ND",13900.0,2020-02-01,25,0,25
"Bismarck, ND",13900.0,2020-03-01,107,35,72
"Bismarck, ND",13900.0,2020-04-01,147,45,102
"Bismarck, ND",13900.0,2020-05-01,155,65,90
"Bismarck, ND",13900.0,2020-06-01,21,11,10
"Bismarck, ND",13900.0,2020-07-01,63,0,63
"Bismarck, ND",13900.0,2020-08-01,-43,0,-43
"Bismarck, ND",13900.0,2020-09-01,-39,-16,-23
"Bismarck, ND",13900.0,2020-10-01,-271,-234,-37
"Bismarck, ND",13900.0,2020-11-01,-131,-134,3
"Bismarck, ND",13900.0,2020-12-01,-141,-141,0
"Wichita, KS",48620.0,2019-01-01,-40,-15,-25
"Wichita, KS",48620.0,2019-02-01,-31,0,-31
"Wichita, KS",48620.0,2019-03-01,30,0,30
"Wichita, KS",48620.0,2019-04-01,75,0,75
"Wichita, KS",48620.0,2019-05-01,210,12,198
"Wichita, KS",48620.0,2019-06-01,-5,0,-5
"Wichita, KS",48620.0,2019-07-01,69,0,69
"Wichita, KS",48620.0,2019-08-01,63,0,63
"Wichita, KS",48620.0,2019-09-01,-70,-13,-57
"Wichita, KS",48620.0,2019-10-01,-50,-11,-39
"Wichita, KS",48620.0,2019-11-01,-42,0,-42
"Wichita, KS",48620.0,2019-12-01,60,-27,87
"Wichita, KS",48620.0,2020-01-01,-51,-21,-30
"Wichita, KS",48620.0,2020-02-01,-16,0,-16
"Wichita, KS",48620.0,2020-03-01,117,13,104
"Wichita, KS",48620.0,2020-04-01,18,0,18
"Wichita, KS",48620.0,2020-05-01,101,0,101
"Wichita, KS",48620.0,2020-06-01,-106,0,-106
"Wichita, KS",48620.0,2020-07-01,31,0,31
"Wichita, KS",48620.0,2020-08-01,-2,0,-2
"Wichita, KS",48620.0,2020-09-01,5,0,5
"Wichita, KS",48620.0,2020-10-01,-48,-11,-37
"Wichita, KS",48620.0,2020-11-01,-30,-13,-17
"Wichita, KS",48620.0,2020-12-01,-13,-14,1
"Poplar Bluff, MO",38740.0,2019-01-01,28,0,28
"Poplar Bluff, MO",38740.0,2019-02-01,0,0,0
"Poplar Bluff, MO",38740.0,2019-03-01,-15,0,-15
"Poplar Bluff, MO",38740.0,2019-04-01,-15,0,-15
"Poplar Bluff, MO",38740.0,2019-05-01,16,0,16
"Poplar Bluff, MO",38740.0,2019-06-01,14,0,14
"Poplar Bluff, MO",38740.0,2019-07-01,0,0,0
"Poplar Bluff, MO",38740.0,2019-08-01,2,0,2
"Poplar Bluff, MO",38740.0,2019-09-01,0,0,0
"Poplar Bluff, MO",38740.0,2019-10-01,7,0,7
"Poplar Bluff, MO",38740.0,2019-11-01,1,0,1
"Poplar Bluff, MO",38740.0,2019-12-01,-30,0,-30
"Poplar Bluff, MO",38740.0,2020-01-01,25,0,25
"Poplar Bluff, MO",38740.0,2020-02-01,-22,0,-22
"Poplar Bluff, MO",38740.0,2020-03-01,36,0,36
"Poplar Bluff, MO",38740.0,2020-04-01,1,0,1
"Poplar Bluff, MO",38740.0,2020-05-01,21,0,21
"Poplar Bluff, MO",38740.0,2020-06-01,0,0,0
"Poplar Bluff, MO",38740.0,2020-07-01,7,0,7
"Poplar Bluff, MO",38740.0,2020-08-01,9,0,9
"Poplar Bluff, MO",38740.0,2020-09-01,17,0,17
"Poplar Bluff, MO",38740.0,2020-10-01,25,0,25
"Poplar Bluff, MO",38740.0,2020-11-01,10,0,10
"Poplar Bluff, MO",38740.0,2020-12-01,-15,0,-15
"Chico, CA",17020.0,2019-01-01,-1034,-272,-762
"Chico, CA",17020.0,2019-02-01,-773,-121,-652
"Chico, CA",17020.0,2019-03-01,-380,-29,-351
"Chico, CA",17020.0,2019-04-01,-255,-27,-228
"Chico, CA",17020.0,2019-05-01,-387,0,-387
"Chico, CA",17020.0,2019-06-01,-538,0,-538
"Chico, CA",17020.0,2019-07-01,-316,0,-316
"Chico, CA",17020.0,2019-08-01,-87,0,-87
"Chico, CA",17020.0,2019-09-01,-67,0,-67
"Chico, CA",17020.0,2019-10-01,-40,14,-54
"Chico, CA",17020.0,2019-11-01,-77,0,-77
"Chico, CA",17020.0,2019-12-01,-31,0,-31
"Chico, CA",17020.0,2020-01-01,-68,0,-68
"Chico, CA",17020.0,2020-02-01,-51,0,-51
"Chico, CA",17020.0,2020-03-01,-57,0,-57
"Chico, CA",17020.0,2020-04-01,-37,0,-37
"Chico, CA",17020.0,2020-05-01,-171,0,-171
"Chico, CA",17020.0,2020-06-01,-151,0,-151
"Chico, CA",17020.0,2020-07-01,-140,0,-140
"Chico, CA",17020.0,2020-08-01,134,0,134
"Chico, CA",17020.0,2020-09-01,18,-11,29
"Chico, CA",17020.0,2020-10-01,-58,0,-58
"Chico, CA",17020.0,2020-11-01,-46,0,-46
"Chico, CA",17020.0,2020-12-01,23,0,23
"Logan, UT-ID",30860.0,2019-01-01,-62,-17,-45
"Logan, UT-ID",30860.0,2019-02-01,-57,0,-57
"Logan, UT-ID",30860.0,2019-03-01,-60,0,-60
"Logan, UT-ID",30860.0,2019-04-01,-208,-16,-192
"Logan, UT-ID",30860.0,2019-05-01,-240,270,-510
"Logan, UT-ID",30860.0,2019-06-01,-37,36,-73
"Logan, UT-ID",30860.0,2019-07-01,-61,0,-61
"Logan, UT-ID",30860.0,2019-08-01,-69,15,-84
"Logan, UT-ID",30860.0,2019-09-01,-39,0,-39
"Logan, UT-ID",30860.0,2019-10-01,-47,-25,-22
"Logan, UT-ID",30860.0,2019-11-01,-10,-23,13
"Logan, UT-ID",30860.0,2019-12-01,-140,-35,-105
"Logan, UT-ID",30860.0,2020-01-01,-83,-15,-68
"Logan, UT-ID",30860.0,2020-02-01,-37,0,-37
"Logan, UT-ID",30860.0,2020-03-01,-361,-17,-344
"Logan, UT-ID",30860.0,2020-04-01,-109,0,-109
"Logan, UT-ID",30860.0,2020-05-01,-61,40,-101
"Logan, UT-ID",30860.0,2020-06-01,20,53,-33
"Logan, UT-ID",30860.0,2020-07-01,28,0,28
"Logan, UT-ID",30860.0,2020-08-01,-29,12,-41
"Logan, UT-ID",30860.0,2020-09-01,19,0,19
"Logan, UT-ID",30860.0,2020-10-01,33,-50,83
"Logan, UT-ID",30860.0,2020-11-01,-50,-15,-35
"Logan, UT-ID",30860.0,2020-12-01,-20,-19,-1
"Lake Charles, LA",29340.0,2019-01-01,24,0,24
"Lake Charles, LA",29340.0,2019-02-01,25,0,25
"Lake Charles, LA",29340.0,2019-03-01,-20,0,-20
"Lake Charles, LA",29340.0,2019-04-01,-103,0,-103
"Lake Charles, LA",29340.0,2019-05-01,-13,0,-13
"Lake Charles, LA",29340.0,2019-06-01,-61,0,-61
"Lake Charles, LA",29340.0,2019-07-01,-95,0,-95
"Lake Charles, LA",29340.0,2019-08-01,-97,0,-97
"Lake Charles, LA",29340.0,2019-09-01,-61,0,-61
"Lake Charles, LA",29340.0,2019-10-01,-78,0,-78
"Lake Charles, LA",29340.0,2019-11-01,-40,0,-40
"Lake Charles, LA",29340.0,2019-12-01,2,0,2
"Lake Charles, LA",29340.0,2020-01-01,-78,0,-78
"Lake Charles, LA",29340.0,2020-02-01,-49,0,-49
"Lake Charles, LA",29340.0,2020-03-01,-104,0,-104
"Lake Charles, LA",29340.0,2020-04-01,-67,0,-67
"Lake Charles, LA",29340.0,2020-05-01,-53,0,-53
"Lake Charles, LA",29340.0,2020-06-01,-32,0,-32
"Lake Charles, LA",29340.0,2020-07-01,-63,0,-63
"Lake Charles, LA",29340.0,2020-08-01,-373,-171,-202
"Lake Charles, LA",29340.0,2020-09-01,-1464,-449,-1015
"Lake Charles, LA",29340.0,2020-10-01,-876,-98,-778
"Lake Charles, LA",29340.0,2020-11-01,-556,-40,-516
"Lake Charles, LA",29340.0,2020-12-01,-516,-51,-465
"Anniston-Oxford, AL",11500.0,2019-01-01,-81,0,-81
"Anniston-Oxford, AL",11500.0,2019-02-01,15,0,15
"Anniston-Oxford, AL",11500.0,2019-03-01,-22,0,-22
"Anniston-Oxford, AL",11500.0,2019-04-01,-47,0,-47
"Anniston-Oxford, AL",11500.0,2019-05-01,-29,0,-29
"Anniston-Oxford, AL",11500.0,2019-06-01,-3,0,-3
"Anniston-Oxford, AL",11500.0,2019-07-01,-27,0,-27
"Anniston-Oxford, AL",11500.0,2019-08-01,-68,0,-68
"Anniston-Oxford, AL",11500.0,2019-09-01,7,0,7
"Anniston-Oxford, AL",11500.0,2019-10-01,-19,0,-19
"Anniston-Oxford, AL",11500.0,2019-11-01,-10,0,-10
"Anniston-Oxford, AL",11500.0,2019-12-01,-19,0,-19
"Anniston-Oxford, AL",11500.0,2020-01-01,-54,0,-54
"Anniston-Oxford, AL",11500.0,2020-02-01,0,0,0
"Anniston-Oxford, AL",11500.0,2020-03-01,6,0,6
"Anniston-Oxford, AL",11500.0,2020-04-01,5,0,5
"Anniston-Oxford, AL",11500.0,2020-05-01,11,0,11
"Anniston-Oxford, AL",11500.0,2020-06-01,24,0,24
"Anniston-Oxford, AL",11500.0,2020-07-01,-34,0,-34
"Anniston-Oxford, AL",11500.0,2020-08-01,33,0,33
"Anniston-Oxford, AL",11500.0,2020-09-01,-5,0,-5
"Anniston-Oxford, AL",11500.0,2020-10-01,-4,0,-4
"Anniston-Oxford, AL",11500.0,2020-11-01,15,0,15
"Anniston-Oxford, AL",11500.0,2020-12-01,-31,0,-31
"Camden, AR",15780.0,2019-01-01,12,0,12
"Camden, AR",15780.0,2019-02-01,1,0,1
"Camden, AR",15780.0,2019-03-01,0,0,0
"Camden, AR",15780.0,2019-04-01,0,0,0
"Camden, AR",15780.0,2019-05-01,0,0,0
"Camden, AR",15780.0,2019-06-01,0,0,0
"Camden, AR",15780.0,2019-07-01,-12,0,-12
"Camden, AR",15780.0,2019-08-01,-11,0,-11
"Camden, AR",15780.0,2019-09-01,0,0,0
"Camden, AR",15780.0,2019-10-01,0,0,0
"Camden, AR",15780.0,2019-11-01,0,0,0
"Camden, AR",15780.0,2019-12-01,0,0,0
"Camden, AR",15780.0,2020-01-01,-14,0,-14
"Camden, AR",15780.0,2020-02-01,0,0,0
"Camden, AR",15780.0,2020-03-01,0,0,0
"Camden, AR",15780.0,2020-04-01,27,0,27
"Camden, AR",15780.0,2020-05-01,-15,0,-15
"Camden, AR",15780.0,2020-06-01,0,0,0
"Camden, AR",15780.0,2020-07-01,0,0,0
"Camden, AR",15780.0,2020-08-01,0,0,0
"Camden, AR",15780.0,2020-09-01,0,0,0
"Camden, AR",15780.0,2020-10-01,0,0,0
"Camden, AR",15780.0,2020-11-01,0,0,0
"Camden, AR",15780.0,2020-12-01,0,0,0
"Battle Creek, MI",12980.0,2019-01-01,-4,-36,32
"Battle Creek, MI",12980.0,2019-02-01,57,0,57
"Battle Creek, MI",12980.0,2019-03-01,38,0,38
"Battle Creek, MI",12980.0,2019-04-01,183,110,73
"Battle Creek, MI",12980.0,2019-05-01,105,50,55
"Battle Creek, MI",12980.0,2019-06-01,-33,0,-33
"Battle Creek, MI",12980.0,2019-07-01,13,0,13
"Battle Creek, MI",12980.0,2019-08-01,-25,0,-25
"Battle Creek, MI",12980.0,2019-09-01,91,0,91
"Battle Creek, MI",12980.0,2019-10-01,-129,-109,-20
"Battle Creek, MI",12980.0,2019-11-01,-116,-144,28
"Battle Creek, MI",12980.0,2019-12-01,-144,-122,-22
"Battle Creek, MI",12980.0,2020-01-01,19,-38,57
"Battle Creek, MI",12980.0,2020-02-01,-26,0,-26
"Battle Creek, MI",12980.0,2020-03-01,27,0,27
"Battle Creek, MI",12980.0,2020-04-01,53,-11,64
"Battle Creek, MI",12980.0,2020-05-01,98,36,62
"Battle Creek, MI",12980.0,2020-06-01,44,0,44
"Battle Creek, MI",12980.0,2020-07-01,11,0,11
"Battle Creek, MI",12980.0,2020-08-01,-21,0,-21
"Battle Creek, MI",12980.0,2020-09-01,-38,0,-38
"Battle Creek, MI",12980.0,2020-10-01,-82,-84,2
"Battle Creek, MI",12980.0,2020-11-01,-117,-127,10
"Battle Creek, MI",12980.0,2020-12-01,-29,-48,19
"Columbia, SC",17900.0,2019-01-01,30,0,30
"Columbia, SC",17900.0,2019-02-01,-45,0,-45
"Columbia, SC",17900.0,2019-03-01,-4,0,-4
"Columbia, SC",17900.0,2019-04-01,54,0,54
"Columbia, SC",17900.0,2019-05-01,-32,0,-32
"Columbia, SC",17900.0,2019-06-01,-89,0,-89
"Columbia, SC",17900.0,2019-07-01,-189,-13,-176
"Columbia, SC",17900.0,2019-08-01,-7,0,-7
"Columbia, SC",17900.0,2019-09-01,-48,0,-48
"Columbia, SC",17900.0,2019-10-01,41,0,41
"Columbia, SC",17900.0,2019-11-01,-65,0,-65
"Columbia, SC",17900.0,2019-12-01,164,0,164
"Columbia, SC",17900.0,2020-01-01,-51,0,-51
"Columbia, SC",17900.0,2020-02-01,-11,0,-11
"Columbia, SC",17900.0,2020-03-01,-32,-11,-21
"Columbia, SC",17900.0,2020-04-01,-112,-41,-71
"Columbia, SC",17900.0,2020-05-01,48,0,48
"Columbia, SC",17900.0,2020-06-01,-80,0,-80
"Columbia, SC",17900.0,2020-07-01,-83,0,-83
"Columbia, SC",17900.0,2020-08-01,-89,0,-89
"Columbia, SC",17900.0,2020-09-01,66,13,53
"Columbia, SC",17900.0,2020-10-01,-17,0,-17
"Columbia, SC",17900.0,2020-11-01,83,0,83
"Columbia, SC",17900.0,2020-12-01,104,0,104
"Port Lavaca, TX",38920.0,2019-01-01,-2,0,-2
"Port Lavaca, TX",38920.0,2019-02-01,-13,0,-13
"Port Lavaca, TX",38920.0,2019-03-01,-21,0,-21
"Port Lavaca, TX",38920.0,2019-04-01,-21,0,-21
"Port Lavaca, TX",38920.0,2019-05-01,-22,0,-22
"Port Lavaca, TX",38920.0,2019-06-01,0,0,0
"Port Lavaca, TX",38920.0,2019-07-01,-2,0,-2
"Port Lavaca, TX",38920.0,2019-08-01,-7,0,-7
"Port Lavaca, TX",38920.0,2019-09-01,0,0,0
"Port Lavaca, TX",38920.0,2019-10-01,0,0,0
"Port Lavaca, TX",38920.0,2019-11-01,-11,0,-11
"Port Lavaca, TX",38920.0,2019-12-01,16,0,16
"Port Lavaca, TX",38920.0,2020-01-01,21,0,21
"Port Lavaca, TX",38920.0,2020-02-01,0,0,0
"Port Lavaca, TX",38920.0,2020-03-01,-25,0,-25
"Port Lavaca, TX",38920.0,2020-04-01,-15,0,-15
"Port Lavaca, TX",38920.0,2020-05-01,-19,0,-19
"Port Lavaca, TX",38920.0,2020-06-01,-13,0,-13
"Port Lavaca, TX",38920.0,2020-07-01,1,0,1
"Port Lavaca, TX",38920.0,2020-08-01,-8,0,-8
"Port Lavaca, TX",38920.0,2020-09-01,-12,0,-12
"Port Lavaca, TX",38920.0,2020-10-01,0,0,0
"Port Lavaca, TX",38920.0,2020-11-01,0,0,0
"Port Lavaca, TX",38920.0,2020-12-01,-12,0,-12
"Abilene, TX",10180.0,2019-01-01,35,0,35
"Abilene, TX",10180.0,2019-02-01,-15,0,-15
"Abilene, TX",10180.0,2019-03-01,-3,0,-3
"Abilene, TX",10180.0,2019-04-01,7,0,7
"Abilene, TX",10180.0,2019-05-01,40,0,40
"Abilene, TX",10180.0,2019-06-01,19,0,19
"Abilene, TX",10180.0,2019-07-01,-2,0,-2
"Abilene, TX",10180.0,2019-08-01,26,0,26
"Abilene, TX",10180.0,2019-09-01,34,0,34
"Abilene, TX",10180.0,2019-10-01,53,0,53
"Abilene, TX",10180.0,2019-11-01,22,0,22
"Abilene, TX",10180.0,2019-12-01,25,0,25
"Abilene, TX",10180.0,2020-01-01,33,0,33
"Abilene, TX",10180.0,2020-02-01,-15,0,-15
"Abilene, TX",10180.0,2020-03-01,67,0,67
"Abilene, TX",10180.0,2020-04-01,20,0,20
"Abilene, TX",10180.0,2020-05-01,18,0,18
"Abilene, TX",10180.0,2020-06-01,40,0,40
"Abilene, TX",10180.0,2020-07-01,-46,0,-46
"Abilene, TX",10180.0,2020-08-01,16,0,16
"Abilene, TX",10180.0,2020-09-01,-50,0,-50
"Abilene, TX",10180.0,2020-10-01,48,0,48
"Abilene, TX",10180.0,2020-11-01,9,0,9
"Abilene, TX",10180.0,2020-12-01,13,0,13
"Jefferson City, MO",27620.0,2019-01-01,-35,0,-35
"Jefferson City, MO",27620.0,2019-02-01,-20,0,-20
"Jefferson City, MO",27620.0,2019-03-01,6,0,6
"Jefferson City, MO",27620.0,2019-04-01,-23,0,-23
"Jefferson City, MO",27620.0,2019-05-01,4,0,4
"Jefferson City, MO",27620.0,2019-06-01,9,0,9
"Jefferson City, MO",27620.0,2019-07-01,10,0,10
"Jefferson City, MO",27620.0,2019-08-01,-14,0,-14
"Jefferson City, MO",27620.0,2019-09-01,-30,0,-30
"Jefferson City, MO",27620.0,2019-10-01,-23,0,-23
"Jefferson City, MO",27620.0,2019-11-01,-25,0,-25
"Jefferson City, MO",27620.0,2019-12-01,17,-12,29
"Jefferson City, MO",27620.0,2020-01-01,58,0,58
"Jefferson City, MO",27620.0,2020-02-01,29,0,29
"Jefferson City, MO",27620.0,2020-03-01,-49,0,-49
"Jefferson City, MO",27620.0,2020-04-01,15,0,15
"Jefferson City, MO",27620.0,2020-05-01,-14,0,-14
"Jefferson City, MO",27620.0,2020-06-01,-2,0,-2
"Jefferson City, MO",27620.0,2020-07-01,-10,0,-10
"Jefferson City, MO",27620.0,2020-08-01,-26,0,-26
"Jefferson City, MO",27620.0,2020-09-01,-6,0,-6
"Jefferson City, MO",27620.0,2020-10-01,-4,0,-4
"Jefferson City, MO",27620.0,2020-11-01,-7,0,-7
"Jefferson City, MO",27620.0,2020-12-01,-34,0,-34
"Murray, KY",34660.0,2019-01-01,-4,0,-4
"Murray, KY",34660.0,2019-02-01,0,0,0
"Murray, KY",34660.0,2019-03-01,12,0,12
"Murray, KY",34660.0,2019-04-01,-19,0,-19
"Murray, KY",34660.0,2019-05-01,-4,0,-4
"Murray, KY",34660.0,2019-06-01,-7,0,-7
"Murray, KY",34660.0,2019-07-01,-19,0,-19
"Murray, KY",34660.0,2019-08-01,9,0,9
"Murray, KY",34660.0,2019-09-01,15,0,15
"Murray, KY",34660.0,2019-10-01,-10,0,-10
"Murray, KY",34660.0,2019-11-01,18,0,18
"Murray, KY",34660.0,2019-12-01,-15,0,-15
"Murray, KY",34660.0,2020-01-01,0,0,0
"Murray, KY",34660.0,2020-02-01,24,0,24
"Murray, KY",34660.0,2020-03-01,5,0,5
"Murray, KY",34660.0,2020-04-01,15,0,15
"Murray, KY",34660.0,2020-05-01,7,0,7
"Murray, KY",34660.0,2020-06-01,12,0,12
"Murray, KY",34660.0,2020-07-01,-6,0,-6
"Murray, KY",34660.0,2020-08-01,32,0,32
"Murray, KY",34660.0,2020-09-01,26,0,26
"Murray, KY",34660.0,2020-10-01,9,0,9
"Murray, KY",34660.0,2020-11-01,-7,0,-7
"Murray, KY",34660.0,2020-12-01,-22,0,-22
"Appleton, WI",11540.0,2019-01-01,-166,-174,8
"Appleton, WI",11540.0,2019-02-01,-32,-15,-17
"Appleton, WI",11540.0,2019-03-01,104,0,104
"Appleton, WI",11540.0,2019-04-01,7,38,-31
"Appleton, WI",11540.0,2019-05-01,195,88,107
"Appleton, WI",11540.0,2019-06-01,-7,0,-7
"Appleton, WI",11540.0,2019-07-01,42,12,30
"Appleton, WI",11540.0,2019-08-01,47,0,47
"Appleton, WI",11540.0,2019-09-01,53,-11,64
"Appleton, WI",11540.0,2019-10-01,-53,-82,29
"Appleton, WI",11540.0,2019-11-01,-49,-38,-11
"Appleton, WI",11540.0,2019-12-01,-135,-174,39
"Appleton, WI",11540.0,2020-01-01,-157,-136,-21
"Appleton, WI",11540.0,2020-02-01,-23,0,-23
"Appleton, WI",11540.0,2020-03-01,89,-21,110
"Appleton, WI",11540.0,2020-04-01,107,27,80
"Appleton, WI",11540.0,2020-05-01,89,54,35
"Appleton, WI",11540.0,2020-06-01,-16,11,-27
"Appleton, WI",11540.0,2020-07-01,71,0,71
"Appleton, WI",11540.0,2020-08-01,73,0,73
"Appleton, WI",11540.0,2020-09-01,67,0,67
"Appleton, WI",11540.0,2020-10-01,-191,-91,-100
"Appleton, WI",11540.0,2020-11-01,46,-33,79
"Appleton, WI",11540.0,2020-12-01,-94,-89,-5
"Johnstown, PA",27780.0,2019-01-01,-20,-25,5
"Johnstown, PA",27780.0,2019-02-01,-31,0,-31
"Johnstown, PA",27780.0,2019-03-01,-39,0,-39
"Johnstown, PA",27780.0,2019-04-01,-7,0,-7
"Johnstown, PA",27780.0,2019-05-01,4,0,4
"Johnstown, PA",27780.0,2019-06-01,14,0,14
"Johnstown, PA",27780.0,2019-07-01,-28,0,-28
"Johnstown, PA",27780.0,2019-08-01,59,0,59
"Johnstown, PA",27780.0,2019-09-01,3,0,3
"Johnstown, PA",27780.0,2019-10-01,-9,0,-9
"Johnstown, PA",27780.0,2019-11-01,-1,0,-1
"Johnstown, PA",27780.0,2019-12-01,6,0,6
"Johnstown, PA",27780.0,2020-01-01,16,-26,42
"Johnstown, PA",27780.0,2020-02-01,47,0,47
"Johnstown, PA",27780.0,2020-03-01,40,0,40
"Johnstown, PA",27780.0,2020-04-01,-12,0,-12
"Johnstown, PA",27780.0,2020-05-01,-4,0,-4
"Johnstown, PA",27780.0,2020-06-01,-25,0,-25
"Johnstown, PA",27780.0,2020-07-01,13,0,13
"Johnstown, PA",27780.0,2020-08-01,-29,0,-29
"Johnstown, PA",27780.0,2020-09-01,-15,0,-15
"Johnstown, PA",27780.0,2020-10-01,-24,-12,-12
"Johnstown, PA",27780.0,2020-11-01,0,0,0
"Johnstown, PA",27780.0,2020-12-01,-25,-16,-9
"St. Marys, GA",41220.0,2019-01-01,38,0,38
"St. Marys, GA",41220.0,2019-02-01,30,0,30
"St. Marys, GA",41220.0,2019-03-01,-39,0,-39
"St. Marys, GA",41220.0,2019-04-01,30,0,30
"St. Marys, GA",41220.0,2019-05-01,-19,0,-19
"St. Marys, GA",41220.0,2019-06-01,16,0,16
"St. Marys, GA",41220.0,2019-07-01,30,0,30
"St. Marys, GA",41220.0,2019-08-01,20,0,20
"St. Marys, GA",41220.0,2019-09-01,-2,0,-2
"St. Marys, GA",41220.0,2019-10-01,19,0,19
"St. Marys, GA",41220.0,2019-11-01,37,0,37
"St. Marys, GA",41220.0,2019-12-01,11,0,11
"St. Marys, GA",41220.0,2020-01-01,-3,0,-3
"St. Marys, GA",41220.0,2020-02-01,2,0,2
"St. Marys, GA",41220.0,2020-03-01,-10,0,-10
"St. Marys, GA",41220.0,2020-04-01,25,0,25
"St. Marys, GA",41220.0,2020-05-01,-24,0,-24
"St. Marys, GA",41220.0,2020-06-01,2,0,2
"St. Marys, GA",41220.0,2020-07-01,-3,0,-3
"St. Marys, GA",41220.0,2020-08-01,-41,0,-41
"St. Marys, GA",41220.0,2020-09-01,-6,0,-6
"St. Marys, GA",41220.0,2020-10-01,-29,0,-29
"St. Marys, GA",41220.0,2020-11-01,-8,0,-8
"St. Marys, GA",41220.0,2020-12-01,6,0,6
"Brownsville-Harlingen, TX",15180.0,2019-01-01,45,67,-22
"Brownsville-Harlingen, TX",15180.0,2019-02-01,32,0,32
"Brownsville-Harlingen, TX",15180.0,2019-03-01,-13,0,-13
"Brownsville-Harlingen, TX",15180.0,2019-04-01,6,-23,29
"Brownsville-Harlingen, TX",15180.0,2019-05-01,-22,0,-22
"Brownsville-Harlingen, TX",15180.0,2019-06-01,-7,0,-7
"Brownsville-Harlingen, TX",15180.0,2019-07-01,-27,0,-27
"Brownsville-Harlingen, TX",15180.0,2019-08-01,48,0,48
"Brownsville-Harlingen, TX",15180.0,2019-09-01,34,0,34
"Brownsville-Harlingen, TX",15180.0,2019-10-01,98,100,-2
"Brownsville-Harlingen, TX",15180.0,2019-11-01,129,143,-14
"Brownsville-Harlingen, TX",15180.0,2019-12-01,372,358,14
"Brownsville-Harlingen, TX",15180.0,2020-01-01,65,109,-44
"Brownsville-Harlingen, TX",15180.0,2020-02-01,-11,0,-11
"Brownsville-Harlingen, TX",15180.0,2020-03-01,23,0,23
"Brownsville-Harlingen, TX",15180.0,2020-04-01,-10,-13,3
"Brownsville-Harlingen, TX",15180.0,2020-05-01,18,0,18
"Brownsville-Harlingen, TX",15180.0,2020-06-01,11,0,11
"Brownsville-Harlingen, TX",15180.0,2020-07-01,54,0,54
"Brownsville-Harlingen, TX",15180.0,2020-08-01,-2,0,-2
"Brownsville-Harlingen, TX",15180.0,2020-09-01,36,0,36
"Brownsville-Harlingen, TX",15180.0,2020-10-01,117,66,51
"Brownsville-Harlingen, TX",15180.0,2020-11-01,121,90,31
"Brownsville-Harlingen, TX",15180.0,2020-12-01,66,119,-53
"Mount Pleasant, TX",34420.0,2019-01-01,-13,0,-13
"Mount Pleasant, TX",34420.0,2019-02-01,0,0,0
"Mount Pleasant, TX",34420.0,2019-03-01,0,0,0
"Mount Pleasant, TX",34420.0,2019-04-01,0,0,0
"Mount Pleasant, TX",34420.0,2019-05-01,0,0,0
"Mount Pleasant, TX",34420.0,2019-06-01,0,0,0
"Mount Pleasant, TX",34420.0,2019-07-01,0,0,0
"Mount Pleasant, TX",34420.0,2019-08-01,12,0,12
"Mount Pleasant, TX",34420.0,2019-09-01,11,0,11
"Mount Pleasant, TX",34420.0,2019-10-01,0,0,0
"Mount Pleasant, TX",34420.0,2019-11-01,11,0,11
"Mount Pleasant, TX",34420.0,2019-12-01,0,0,0
"Mount Pleasant, TX",34420.0,2020-01-01,0,0,0
"Mount Pleasant, TX",34420.0,2020-02-01,11,0,11
"Mount Pleasant, TX",34420.0,2020-03-01,4,0,4
"Mount Pleasant, TX",34420.0,2020-04-01,-15,0,-15
"Mount Pleasant, TX",34420.0,2020-05-01,0,0,0
"Mount Pleasant, TX",34420.0,2020-06-01,0,0,0
"Mount Pleasant, TX",34420.0,2020-07-01,0,0,0
"Mount Pleasant, TX",34420.0,2020-08-01,0,0,0
"Mount Pleasant, TX",34420.0,2020-09-01,-11,0,-11
"Mount Pleasant, TX",34420.0,2020-10-01,0,0,0
"Mount Pleasant, TX",34420.0,2020-11-01,-16,0,-16
"Mount Pleasant, TX",34420.0,2020-12-01,0,0,0
"Gillette, WY",23940.0,2019-01-01,0,0,0
"Gillette, WY",23940.0,2019-02-01,11,0,11
"Gillette, WY",23940.0,2019-03-01,0,0,0
"Gillette, WY",23940.0,2019-04-01,-1,15,-16
"Gillette, WY",23940.0,2019-05-01,-1,12,-13
"Gillette, WY",23940.0,2019-06-01,13,0,13
"Gillette, WY",23940.0,2019-07-01,0,0,0
"Gillette, WY",23940.0,2019-08-01,0,0,0
"Gillette, WY",23940.0,2019-09-01,-13,0,-13
"Gillette, WY",23940.0,2019-10-01,-13,-13,0
"Gillette, WY",23940.0,2019-11-01,-15,-15,0
"Gillette, WY",23940.0,2019-12-01,0,0,0
"Gillette, WY",23940.0,2020-01-01,0,0,0
"Gillette, WY",23940.0,2020-02-01,-13,0,-13
"Gillette, WY",23940.0,2020-03-01,0,0,0
"Gillette, WY",23940.0,2020-04-01,14,14,0
"Gillette, WY",23940.0,2020-05-01,17,17,0
"Gillette, WY",23940.0,2020-06-01,-12,0,-12
"Gillette, WY",23940.0,2020-07-01,-47,0,-47
"Gillette, WY",23940.0,2020-08-01,-13,0,-13
"Gillette, WY",23940.0,2020-09-01,-6,0,-6
"Gillette, WY",23940.0,2020-10-01,-34,-23,-11
"Gillette, WY",23940.0,2020-11-01,11,0,11
"Gillette, WY",23940.0,2020-12-01,-13,-13,0
"Oklahoma City, OK",36420.0,2019-01-01,148,-11,159
"Oklahoma City, OK",36420.0,2019-02-01,113,0,113
"Oklahoma City, OK",36420.0,2019-03-01,133,0,133
"Oklahoma City, OK",36420.0,2019-04-01,216,0,216
"Oklahoma City, OK",36420.0,2019-05-01,90,0,90
"Oklahoma City, OK",36420.0,2019-06-01,226,0,226
"Oklahoma City, OK",36420.0,2019-07-01,106,0,106
"Oklahoma City, OK",36420.0,2019-08-01,175,0,175
"Oklahoma City, OK",36420.0,2019-09-01,89,0,89
"Oklahoma City, OK",36420.0,2019-10-01,102,0,102
"Oklahoma City, OK",36420.0,2019-11-01,107,0,107
"Oklahoma City, OK",36420.0,2019-12-01,32,-12,44
"Oklahoma City, OK",36420.0,2020-01-01,31,0,31
"Oklahoma City, OK",36420.0,2020-02-01,73,-11,84
"Oklahoma City, OK",36420.0,2020-03-01,63,14,49
"Oklahoma City, OK",36420.0,2020-04-01,40,-2,42
"Oklahoma City, OK",36420.0,2020-05-01,155,0,155
"Oklahoma City, OK",36420.0,2020-06-01,124,0,124
"Oklahoma City, OK",36420.0,2020-07-01,172,0,172
"Oklahoma City, OK",36420.0,2020-08-01,63,0,63
"Oklahoma City, OK",36420.0,2020-09-01,155,0,155
"Oklahoma City, OK",36420.0,2020-10-01,107,0,107
"Oklahoma City, OK",36420.0,2020-11-01,63,0,63
"Oklahoma City, OK",36420.0,2020-12-01,97,0,97
"Nashville-Davidson--Murfreesboro--Franklin, TN",34980.0,2019-01-01,-52,-26,-26
"Nashville-Davidson--Murfreesboro--Franklin, TN",34980.0,2019-02-01,43,0,43
"Nashville-Davidson--Murfreesboro--Franklin, TN",34980.0,2019-03-01,-171,0,-171
"Nashville-Davidson--Murfreesboro--Franklin, TN",34980.0,2019-04-01,43,30,13
"Nashville-Davidson--Murfreesboro--Franklin, TN",34980.0,2019-05-01,-109,13,-122
"Nashville-Davidson--Murfreesboro--Franklin, TN",34980.0,2019-06-01,402,0,402
"Nashville-Davidson--Murfreesboro--Franklin, TN",34980.0,2019-07-01,265,0,265
"Nashville-Davidson--Murfreesboro--Franklin, TN",34980.0,2019-08-01,18,-11,29
"Nashville-Davidson--Murfreesboro--Franklin, TN",34980.0,2019-09-01,-157,0,-157
"Nashville-Davidson--Murfreesboro--Franklin, TN",34980.0,2019-10-01,84,0,84
"Nashville-Davidson--Murfreesboro--Franklin, TN",34980.0,2019-11-01,-56,-11,-45
"Nashville-Davidson--Murfreesboro--Franklin, TN",34980.0,2019-12-01,-115,-60,-55
"Nashville-Davidson--Murfreesboro--Franklin, TN",34980.0,2020-01-01,-121,-12,-109
"Nashville-Davidson--Murfreesboro--Franklin, TN",34980.0,2020-02-01,154,0,154
"Nashville-Davidson--Murfreesboro--Franklin, TN",34980.0,2020-03-01,316,40,276
"Nashville-Davidson--Murfreesboro--Franklin, TN",34980.0,2020-04-01,29,35,-6
"Nashville-Davidson--Murfreesboro--Franklin, TN",34980.0,2020-05-01,-196,17,-213
"Nashville-Davidson--Murfreesboro--Franklin, TN",34980.0,2020-06-01,175,12,163
"Nashville-Davidson--Murfreesboro--Franklin, TN",34980.0,2020-07-01,283,0,283
"Nashville-Davidson--Murfreesboro--Franklin, TN",34980.0,2020-08-01,-140,12,-152
"Nashville-Davidson--Murfreesboro--Franklin, TN",34980.0,2020-09-01,92,25,67
"Nashville-Davidson--Murfreesboro--Franklin, TN",34980.0,2020-10-01,137,37,100
"Nashville-Davidson--Murfreesboro--Franklin, TN",34980.0,2020-11-01,-168,8,-176
"Nashville-Davidson--Murfreesboro--Franklin, TN",34980.0,2020-12-01,35,-20,55
"Ocean City, NJ",36140.0,2019-01-01,-474,-443,-31
"Ocean City, NJ",36140.0,2019-02-01,-35,-38,3
"Ocean City, NJ",36140.0,2019-03-01,-23,-1,-22
"Ocean City, NJ",36140.0,2019-04-01,538,401,137
"Ocean City, NJ",36140.0,2019-05-01,1423,1323,100
"Ocean City, NJ",36140.0,2019-06-01,1155,1091,64
"Ocean City, NJ",36140.0,2019-07-01,172,181,-9
"Ocean City, NJ",36140.0,2019-08-01,11,27,-16
"Ocean City, NJ",36140.0,2019-09-01,-376,-210,-166
"Ocean City, NJ",36140.0,2019-10-01,-885,-758,-127
"Ocean City, NJ",36140.0,2019-11-01,-396,-349,-47
"Ocean City, NJ",36140.0,2019-12-01,-444,-394,-50
"Ocean City, NJ",36140.0,2020-01-01,-424,-410,-14
"Ocean City, NJ",36140.0,2020-02-01,-20,-28,8
"Ocean City, NJ",36140.0,2020-03-01,315,204,111
"Ocean City, NJ",36140.0,2020-04-01,301,223,78
"Ocean City, NJ",36140.0,2020-05-01,1232,1056,176
"Ocean City, NJ",36140.0,2020-06-01,1583,1409,174
"Ocean City, NJ",36140.0,2020-07-01,421,300,121
"Ocean City, NJ",36140.0,2020-08-01,275,126,149
"Ocean City, NJ",36140.0,2020-09-01,-15,-58,43
"Ocean City, NJ",36140.0,2020-10-01,-695,-632,-63
"Ocean City, NJ",36140.0,2020-11-01,-234,-284,50
"Ocean City, NJ",36140.0,2020-12-01,-226,-290,64
"Billings, MT",13740.0,2019-01-01,-46,-57,11
"Billings, MT",13740.0,2019-02-01,15,0,15
"Billings, MT",13740.0,2019-03-01,33,0,33
"Billings, MT",13740.0,2019-04-01,147,80,67
"Billings, MT",13740.0,2019-05-01,113,88,25
"Billings, MT",13740.0,2019-06-01,51,-15,66
"Billings, MT",13740.0,2019-07-01,60,0,60
"Billings, MT",13740.0,2019-08-01,-6,0,-6
"Billings, MT",13740.0,2019-09-01,-22,-11,-11
"Billings, MT",13740.0,2019-10-01,-196,-158,-38
"Billings, MT",13740.0,2019-11-01,-151,-141,-10
"Billings, MT",13740.0,2019-12-01,-63,-49,-14
"Billings, MT",13740.0,2020-01-01,-55,-68,13
"Billings, MT",13740.0,2020-02-01,0,0,0
"Billings, MT",13740.0,2020-03-01,64,21,43
"Billings, MT",13740.0,2020-04-01,39,36,3
"Billings, MT",13740.0,2020-05-01,164,88,76
"Billings, MT",13740.0,2020-06-01,37,18,19
"Billings, MT",13740.0,2020-07-01,12,0,12
"Billings, MT",13740.0,2020-08-01,7,0,7
"Billings, MT",13740.0,2020-09-01,-48,-17,-31
"Billings, MT",13740.0,2020-10-01,-153,-125,-28
"Billings, MT",13740.0,2020-11-01,-123,-116,-7
"Billings, MT",13740.0,2020-12-01,-40,-55,15
"Allentown-Bethlehem-Easton, PA-NJ",10900.0,2019-01-01,17,-270,287
"Allentown-Bethlehem-Easton, PA-NJ",10900.0,2019-02-01,205,0,205
"Allentown-Bethlehem-Easton, PA-NJ",10900.0,2019-03-01,310,0,310
"Allentown-Bethlehem-Easton, PA-NJ",10900.0,2019-04-01,360,134,226
"Allentown-Bethlehem-Easton, PA-NJ",10900.0,2019-05-01,429,179,250
"Allentown-Bethlehem-Easton, PA-NJ",10900.0,2019-06-01,566,11,555
"Allentown-Bethlehem-Easton, PA-NJ",10900.0,2019-07-01,260,0,260
"Allentown-Bethlehem-Easton, PA-NJ",10900.0,2019-08-01,346,0,346
"Allentown-Bethlehem-Easton, PA-NJ",10900.0,2019-09-01,236,0,236
"Allentown-Bethlehem-Easton, PA-NJ",10900.0,2019-10-01,213,-118,331
"Allentown-Bethlehem-Easton, PA-NJ",10900.0,2019-11-01,204,-11,215
"Allentown-Bethlehem-Easton, PA-NJ",10900.0,2019-12-01,89,-218,307
"Allentown-Bethlehem-Easton, PA-NJ",10900.0,2020-01-01,2,-187,189
"Allentown-Bethlehem-Easton, PA-NJ",10900.0,2020-02-01,228,-12,240
"Allentown-Bethlehem-Easton, PA-NJ",10900.0,2020-03-01,383,179,204
"Allentown-Bethlehem-Easton, PA-NJ",10900.0,2020-04-01,413,120,293
"Allentown-Bethlehem-Easton, PA-NJ",10900.0,2020-05-01,481,113,368
"Allentown-Bethlehem-Easton, PA-NJ",10900.0,2020-06-01,498,68,430
"Allentown-Bethlehem-Easton, PA-NJ",10900.0,2020-07-01,536,11,525
"Allentown-Bethlehem-Easton, PA-NJ",10900.0,2020-08-01,474,0,474
"Allentown-Bethlehem-Easton, PA-NJ",10900.0,2020-09-01,425,0,425
"Allentown-Bethlehem-Easton, PA-NJ",10900.0,2020-10-01,295,-48,343
"Allentown-Bethlehem-Easton, PA-NJ",10900.0,2020-11-01,400,-33,433
"Allentown-Bethlehem-Easton, PA-NJ",10900.0,2020-12-01,255,-149,404
"Price, UT",39220.0,2019-01-01,0,0,0
"Price, UT",39220.0,2019-02-01,11,0,11
"Price, UT",39220.0,2019-03-01,0,0,0
"Price, UT",39220.0,2019-04-01,12,0,12
"Price, UT",39220.0,2019-05-01,0,0,0
"Price, UT",39220.0,2019-06-01,13,0,13
"Price, UT",39220.0,2019-07-01,3,0,3
"Price, UT",39220.0,2019-08-01,0,0,0
"Price, UT",39220.0,2019-09-01,11,0,11
"Price, UT",39220.0,2019-10-01,0,0,0
"Price, UT",39220.0,2019-11-01,12,0,12
"Price, UT",39220.0,2019-12-01,-11,0,-11
"Price, UT",39220.0,2020-01-01,-11,0,-11
"Price, UT",39220.0,2020-02-01,0,0,0
"Price, UT",39220.0,2020-03-01,-7,0,-7
"Price, UT",39220.0,2020-04-01,11,0,11
"Price, UT",39220.0,2020-05-01,0,0,0
"Price, UT",39220.0,2020-06-01,11,0,11
"Price, UT",39220.0,2020-07-01,26,0,26
"Price, UT",39220.0,2020-08-01,17,0,17
"Price, UT",39220.0,2020-09-01,-6,0,-6
"Price, UT",39220.0,2020-10-01,-25,0,-25
"Price, UT",39220.0,2020-11-01,12,0,12
"Price, UT",39220.0,2020-12-01,12,0,12
"Duluth, MN-WI",20260.0,2019-01-01,-257,-227,-30
"Duluth, MN-WI",20260.0,2019-02-01,-34,-22,-12
"Duluth, MN-WI",20260.0,2019-03-01,-5,-16,11
"Duluth, MN-WI",20260.0,2019-04-01,338,237,101
"Duluth, MN-WI",20260.0,2019-05-01,388,432,-44
"Duluth, MN-WI",20260.0,2019-06-01,103,142,-39
"Duluth, MN-WI",20260.0,2019-07-01,8,0,8
"Duluth, MN-WI",20260.0,2019-08-01,-78,0,-78
"Duluth, MN-WI",20260.0,2019-09-01,-61,-38,-23
"Duluth, MN-WI",20260.0,2019-10-01,-685,-624,-61
"Duluth, MN-WI",20260.0,2019-11-01,-310,-283,-27
"Duluth, MN-WI",20260.0,2019-12-01,-382,-350,-32
"Duluth, MN-WI",20260.0,2020-01-01,-251,-237,-14
"Duluth, MN-WI",20260.0,2020-02-01,3,-13,16
"Duluth, MN-WI",20260.0,2020-03-01,65,20,45
"Duluth, MN-WI",20260.0,2020-04-01,183,128,55
"Duluth, MN-WI",20260.0,2020-05-01,181,309,-128
"Duluth, MN-WI",20260.0,2020-06-01,141,182,-41
"Duluth, MN-WI",20260.0,2020-07-01,-3,25,-28
"Duluth, MN-WI",20260.0,2020-08-01,16,13,3
"Duluth, MN-WI",20260.0,2020-09-01,12,-22,34
"Duluth, MN-WI",20260.0,2020-10-01,-483,-493,10
"Duluth, MN-WI",20260.0,2020-11-01,-215,-237,22
"Duluth, MN-WI",20260.0,2020-12-01,-198,-186,-12
"Carroll, IA",16140.0,2019-01-01,0,0,0
"Carroll, IA",16140.0,2019-02-01,0,0,0
"Carroll, IA",16140.0,2019-03-01,0,0,0
"Carroll, IA",16140.0,2019-04-01,0,0,0
"Carroll, IA",16140.0,2019-05-01,14,0,14
"Carroll, IA",16140.0,2019-06-01,0,0,0
"Carroll, IA",16140.0,2019-07-01,11,0,11
"Carroll, IA",16140.0,2019-08-01,-26,0,-26
"Carroll, IA",16140.0,2019-09-01,12,0,12
"Carroll, IA",16140.0,2019-10-01,-13,0,-13
"Carroll, IA",16140.0,2019-11-01,0,0,0
"Carroll, IA",16140.0,2019-12-01,0,0,0
"Carroll, IA",16140.0,2020-01-01,0,0,0
"Carroll, IA",16140.0,2020-02-01,0,0,0
"Carroll, IA",16140.0,2020-03-01,0,0,0
"Carroll, IA",16140.0,2020-04-01,0,0,0
"Carroll, IA",16140.0,2020-05-01,-14,0,-14
"Carroll, IA",16140.0,2020-06-01,0,0,0
"Carroll, IA",16140.0,2020-07-01,-13,0,-13
"Carroll, IA",16140.0,2020-08-01,-14,0,-14
"Carroll, IA",16140.0,2020-09-01,0,0,0
"Carroll, IA",16140.0,2020-10-01,12,0,12
"Carroll, IA",16140.0,2020-11-01,0,0,0
"Carroll, IA",16140.0,2020-12-01,2,0,2
"Greenwood, MS",24900.0,2019-01-01,0,0,0
"Greenwood, MS",24900.0,2019-02-01,0,0,0
"Greenwood, MS",24900.0,2019-03-01,0,0,0
"Greenwood, MS",24900.0,2019-04-01,0,0,0
"Greenwood, MS",24900.0,2019-05-01,0,0,0
"Greenwood, MS",24900.0,2019-06-01,0,0,0
"Greenwood, MS",24900.0,2019-07-01,0,0,0
"Greenwood, MS",24900.0,2019-08-01,0,0,0
"Greenwood, MS",24900.0,2019-09-01,0,0,0
"Greenwood, MS",24900.0,2019-10-01,0,0,0
"Greenwood, MS",24900.0,2019-11-01,0,0,0
"Greenwood, MS",24900.0,2019-12-01,0,0,0
"Greenwood, MS",24900.0,2020-01-01,0,0,0
"Greenwood, MS",24900.0,2020-02-01,0,0,0
"Greenwood, MS",24900.0,2020-03-01,0,0,0
"Greenwood, MS",24900.0,2020-04-01,0,0,0
"Greenwood, MS",24900.0,2020-05-01,0,0,0
"Greenwood, MS",24900.0,2020-06-01,-12,0,-12
"Greenwood, MS",24900.0,2020-07-01,-13,0,-13
"Greenwood, MS",24900.0,2020-08-01,0,0,0
"Greenwood, MS",24900.0,2020-09-01,0,0,0
"Greenwood, MS",24900.0,2020-10-01,0,0,0
"Greenwood, MS",24900.0,2020-11-01,0,0,0
"Greenwood, MS",24900.0,2020-12-01,0,0,0
"Canton-Massillon, OH",15940.0,2019-01-01,-414,-400,-14
"Canton-Massillon, OH",15940.0,2019-02-01,8,-31,39
"Canton-Massillon, OH",15940.0,2019-03-01,34,0,34
"Canton-Massillon, OH",15940.0,2019-04-01,389,236,153
"Canton-Massillon, OH",15940.0,2019-05-01,296,194,102
"Canton-Massillon, OH",15940.0,2019-06-01,57,18,39
"Canton-Massillon, OH",15940.0,2019-07-01,46,-4,50
"Canton-Massillon, OH",15940.0,2019-08-01,134,11,123
"Canton-Massillon, OH",15940.0,2019-09-01,-45,-16,-29
"Canton-Massillon, OH",15940.0,2019-10-01,-268,-276,8
"Canton-Massillon, OH",15940.0,2019-11-01,-204,-176,-28
"Canton-Massillon, OH",15940.0,2019-12-01,-387,-406,19
"Canton-Massillon, OH",15940.0,2020-01-01,-318,-369,51
"Canton-Massillon, OH",15940.0,2020-02-01,10,-15,25
"Canton-Massillon, OH",15940.0,2020-03-01,140,12,128
"Canton-Massillon, OH",15940.0,2020-04-01,323,107,216
"Canton-Massillon, OH",15940.0,2020-05-01,198,163,35
"Canton-Massillon, OH",15940.0,2020-06-01,100,36,64
"Canton-Massillon, OH",15940.0,2020-07-01,30,0,30
"Canton-Massillon, OH",15940.0,2020-08-01,116,0,116
"Canton-Massillon, OH",15940.0,2020-09-01,14,-1,15
"Canton-Massillon, OH",15940.0,2020-10-01,-174,-172,-2
"Canton-Massillon, OH",15940.0,2020-11-01,-133,-173,40
"Canton-Massillon, OH",15940.0,2020-12-01,-269,-323,54
"Amarillo, TX",11100.0,2019-01-01,37,0,37
"Amarillo, TX",11100.0,2019-02-01,-26,0,-26
"Amarillo, TX",11100.0,2019-03-01,-66,0,-66
"Amarillo, TX",11100.0,2019-04-01,-53,0,-53
"Amarillo, TX",11100.0,2019-05-01,-5,0,-5
"Amarillo, TX",11100.0,2019-06-01,-73,0,-73
"Amarillo, TX",11100.0,2019-07-01,15,0,15
"Amarillo, TX",11100.0,2019-08-01,12,0,12
"Amarillo, TX",11100.0,2019-09-01,-22,0,-22
"Amarillo, TX",11100.0,2019-10-01,4,0,4
"Amarillo, TX",11100.0,2019-11-01,22,0,22
"Amarillo, TX",11100.0,2019-12-01,16,0,16
"Amarillo, TX",11100.0,2020-01-01,6,0,6
"Amarillo, TX",11100.0,2020-02-01,-81,0,-81
"Amarillo, TX",11100.0,2020-03-01,14,0,14
"Amarillo, TX",11100.0,2020-04-01,48,0,48
"Amarillo, TX",11100.0,2020-05-01,-22,0,-22
"Amarillo, TX",11100.0,2020-06-01,48,0,48
"Amarillo, TX",11100.0,2020-07-01,-32,0,-32
"Amarillo, TX",11100.0,2020-08-01,28,0,28
"Amarillo, TX",11100.0,2020-09-01,-28,0,-28
"Amarillo, TX",11100.0,2020-10-01,-24,0,-24
"Amarillo, TX",11100.0,2020-11-01,14,0,14
"Amarillo, TX",11100.0,2020-12-01,-11,0,-11
"Carson City, NV",16180.0,2019-01-01,-23,0,-23
"Carson City, NV",16180.0,2019-02-01,-2,0,-2
"Carson City, NV",16180.0,2019-03-01,8,0,8
"Carson City, NV",16180.0,2019-04-01,62,0,62
"Carson City, NV",16180.0,2019-05-01,26,0,26
"Carson City, NV",16180.0,2019-06-01,6,0,6
"Carson City, NV",16180.0,2019-07-01,62,0,62
"Carson City, NV",16180.0,2019-08-01,5,0,5
"Carson City, NV",16180.0,2019-09-01,-11,0,-11
"Carson City, NV",16180.0,2019-10-01,52,0,52
"Carson City, NV",16180.0,2019-11-01,-7,-15,8
"Carson City, NV",16180.0,2019-12-01,38,0,38
"Carson City, NV",16180.0,2020-01-01,20,0,20
"Carson City, NV",16180.0,2020-02-01,32,0,32
"Carson City, NV",16180.0,2020-03-01,47,12,35
"Carson City, NV",16180.0,2020-04-01,3,0,3
"Carson City, NV",16180.0,2020-05-01,21,0,21
"Carson City, NV",16180.0,2020-06-01,-35,0,-35
"Carson City, NV",16180.0,2020-07-01,0,0,0
"Carson City, NV",16180.0,2020-08-01,27,0,27
"Carson City, NV",16180.0,2020-09-01,-6,0,-6
"Carson City, NV",16180.0,2020-10-01,12,0,12
"Carson City, NV",16180.0,2020-11-01,-44,-11,-33
"Carson City, NV",16180.0,2020-12-01,-8,0,-8
"Ardmore, OK",11620.0,2019-01-01,26,0,26
"Ardmore, OK",11620.0,2019-02-01,4,0,4
"Ardmore, OK",11620.0,2019-03-01,12,0,12
"Ardmore, OK",11620.0,2019-04-01,-11,0,-11
"Ardmore, OK",11620.0,2019-05-01,26,0,26
"Ardmore, OK",11620.0,2019-06-01,-1,0,-1
"Ardmore, OK",11620.0,2019-07-01,-12,0,-12
"Ardmore, OK",11620.0,2019-08-01,-29,0,-29
"Ardmore, OK",11620.0,2019-09-01,0,0,0
"Ardmore, OK",11620.0,2019-10-01,12,0,12
"Ardmore, OK",11620.0,2019-11-01,0,0,0
"Ardmore, OK",11620.0,2019-12-01,0,0,0
"Ardmore, OK",11620.0,2020-01-01,14,0,14
"Ardmore, OK",11620.0,2020-02-01,-14,0,-14
"Ardmore, OK",11620.0,2020-03-01,3,0,3
"Ardmore, OK",11620.0,2020-04-01,-16,0,-16
"Ardmore, OK",11620.0,2020-05-01,0,0,0
"Ardmore, OK",11620.0,2020-06-01,15,0,15
"Ardmore, OK",11620.0,2020-07-01,-3,0,-3
"Ardmore, OK",11620.0,2020-08-01,-32,0,-32
"Ardmore, OK",11620.0,2020-09-01,11,0,11
"Ardmore, OK",11620.0,2020-10-01,12,0,12
"Ardmore, OK",11620.0,2020-11-01,-1,0,-1
"Ardmore, OK",11620.0,2020-12-01,27,0,27
"Johnson City, TN",27740.0,2019-01-01,-53,0,-53
"Johnson City, TN",27740.0,2019-02-01,-23,0,-23
"Johnson City, TN",27740.0,2019-03-01,34,0,34
"Johnson City, TN",27740.0,2019-04-01,-45,0,-45
"Johnson City, TN",27740.0,2019-05-01,-26,0,-26
"Johnson City, TN",27740.0,2019-06-01,-17,0,-17
"Johnson City, TN",27740.0,2019-07-01,-4,0,-4
"Johnson City, TN",27740.0,2019-08-01,-37,0,-37
"Johnson City, TN",27740.0,2019-09-01,-42,0,-42
"Johnson City, TN",27740.0,2019-10-01,-58,0,-58
"Johnson City, TN",27740.0,2019-11-01,-2,0,-2
"Johnson City, TN",27740.0,2019-12-01,27,0,27
"Johnson City, TN",27740.0,2020-01-01,-42,0,-42
"Johnson City, TN",27740.0,2020-02-01,31,0,31
"Johnson City, TN",27740.0,2020-03-01,-16,0,-16
"Johnson City, TN",27740.0,2020-04-01,-51,0,-51
"Johnson City, TN",27740.0,2020-05-01,-21,0,-21
"Johnson City, TN",27740.0,2020-06-01,-31,0,-31
"Johnson City, TN",27740.0,2020-07-01,-35,0,-35
"Johnson City, TN",27740.0,2020-08-01,-12,0,-12
"Johnson City, TN",27740.0,2020-09-01,-51,0,-51
"Johnson City, TN",27740.0,2020-10-01,22,0,22
"Johnson City, TN",27740.0,2020-11-01,-46,0,-46
"Johnson City, TN",27740.0,2020-12-01,-91,0,-91
"Morehead City, NC",33980.0,2019-01-01,-11,0,-11
"Morehead City, NC",33980.0,2019-02-01,2,0,2
"Morehead City, NC",33980.0,2019-03-01,-9,0,-9
"Morehead City, NC",33980.0,2019-04-01,18,0,18
"Morehead City, NC",33980.0,2019-05-01,39,0,39
"Morehead City, NC",33980.0,2019-06-01,28,0,28
"Morehead City, NC",33980.0,2019-07-01,25,0,25
"Morehead City, NC",33980.0,2019-08-01,0,0,0
"Morehead City, NC",33980.0,2019-09-01,37,0,37
"Morehead City, NC",33980.0,2019-10-01,8,0,8
"Morehead City, NC",33980.0,2019-11-01,-10,0,-10
"Morehead City, NC",33980.0,2019-12-01,-30,0,-30
"Morehead City, NC",33980.0,2020-01-01,-9,0,-9
"Morehead City, NC",33980.0,2020-02-01,6,0,6
"Morehead City, NC",33980.0,2020-03-01,7,20,-13
"Morehead City, NC",33980.0,2020-04-01,16,38,-22
"Morehead City, NC",33980.0,2020-05-01,20,21,-1
"Morehead City, NC",33980.0,2020-06-01,61,16,45
"Morehead City, NC",33980.0,2020-07-01,-2,0,-2
"Morehead City, NC",33980.0,2020-08-01,35,0,35
"Morehead City, NC",33980.0,2020-09-01,-1,0,-1
"Morehead City, NC",33980.0,2020-10-01,60,0,60
"Morehead City, NC",33980.0,2020-11-01,-16,0,-16
"Morehead City, NC",33980.0,2020-12-01,26,0,26
"Great Falls, MT",24500.0,2019-01-01,-15,0,-15
"Great Falls, MT",24500.0,2019-02-01,15,0,15
"Great Falls, MT",24500.0,2019-03-01,-15,0,-15
"Great Falls, MT",24500.0,2019-04-01,75,16,59
"Great Falls, MT",24500.0,2019-05-01,40,26,14
"Great Falls, MT",24500.0,2019-06-01,-19,19,-38
"Great Falls, MT",24500.0,2019-07-01,-27,0,-27
"Great Falls, MT",24500.0,2019-08-01,-22,0,-22
"Great Falls, MT",24500.0,2019-09-01,-21,-12,-9
"Great Falls, MT",24500.0,2019-10-01,-98,-84,-14
"Great Falls, MT",24500.0,2019-11-01,-34,-31,-3
"Great Falls, MT",24500.0,2019-12-01,-6,-26,20
"Great Falls, MT",24500.0,2020-01-01,-4,-16,12
"Great Falls, MT",24500.0,2020-02-01,1,0,1
"Great Falls, MT",24500.0,2020-03-01,22,12,10
"Great Falls, MT",24500.0,2020-04-01,-15,16,-31
"Great Falls, MT",24500.0,2020-05-01,68,25,43
"Great Falls, MT",24500.0,2020-06-01,-47,0,-47
"Great Falls, MT",24500.0,2020-07-01,25,0,25
"Great Falls, MT",24500.0,2020-08-01,-41,0,-41
"Great Falls, MT",24500.0,2020-09-01,-1,0,-1
"Great Falls, MT",24500.0,2020-10-01,-85,-81,-4
"Great Falls, MT",24500.0,2020-11-01,-1,-20,19
"Great Falls, MT",24500.0,2020-12-01,-42,-29,-13
"Logansport, IN",30900.0,2019-01-01,-25,0,-25
"Logansport, IN",30900.0,2019-02-01,11,0,11
"Logansport, IN",30900.0,2019-03-01,-10,0,-10
"Logansport, IN",30900.0,2019-04-01,5,14,-9
"Logansport, IN",30900.0,2019-05-01,-12,0,-12
"Logansport, IN",30900.0,2019-06-01,-18,0,-18
"Logansport, IN",30900.0,2019-07-01,-6,0,-6
"Logansport, IN",30900.0,2019-08-01,24,0,24
"Logansport, IN",30900.0,2019-09-01,18,0,18
"Logansport, IN",30900.0,2019-10-01,-12,-11,-1
"Logansport, IN",30900.0,2019-11-01,10,0,10
"Logansport, IN",30900.0,2019-12-01,-22,-16,-6
"Logansport, IN",30900.0,2020-01-01,-2,0,-2
"Logansport, IN",30900.0,2020-02-01,19,0,19
"Logansport, IN",30900.0,2020-03-01,-7,0,-7
"Logansport, IN",30900.0,2020-04-01,-26,0,-26
"Logansport, IN",30900.0,2020-05-01,-11,0,-11
"Logansport, IN",30900.0,2020-06-01,17,0,17
"Logansport, IN",30900.0,2020-07-01,-13,0,-13
"Logansport, IN",30900.0,2020-08-01,10,0,10
"Logansport, IN",30900.0,2020-09-01,-14,0,-14
"Logansport, IN",30900.0,2020-10-01,11,0,11
"Logansport, IN",30900.0,2020-11-01,8,0,8
"Logansport, IN",30900.0,2020-12-01,-8,-12,4
"South Bend-Mishawaka, IN-MI",43780.0,2019-01-01,-181,-182,1
"South Bend-Mishawaka, IN-MI",43780.0,2019-02-01,48,13,35
"South Bend-Mishawaka, IN-MI",43780.0,2019-03-01,-36,0,-36
"South Bend-Mishawaka, IN-MI",43780.0,2019-04-01,321,166,155
"South Bend-Mishawaka, IN-MI",43780.0,2019-05-01,176,159,17
"South Bend-Mishawaka, IN-MI",43780.0,2019-06-01,-108,0,-108
"South Bend-Mishawaka, IN-MI",43780.0,2019-07-01,47,0,47
"South Bend-Mishawaka, IN-MI",43780.0,2019-08-01,85,0,85
"South Bend-Mishawaka, IN-MI",43780.0,2019-09-01,130,0,130
"South Bend-Mishawaka, IN-MI",43780.0,2019-10-01,-245,-215,-30
"South Bend-Mishawaka, IN-MI",43780.0,2019-11-01,-121,-142,21
"South Bend-Mishawaka, IN-MI",43780.0,2019-12-01,-293,-284,-9
"South Bend-Mishawaka, IN-MI",43780.0,2020-01-01,-108,-138,30
"South Bend-Mishawaka, IN-MI",43780.0,2020-02-01,13,0,13
"South Bend-Mishawaka, IN-MI",43780.0,2020-03-01,67,-11,78
"South Bend-Mishawaka, IN-MI",43780.0,2020-04-01,175,84,91
"South Bend-Mishawaka, IN-MI",43780.0,2020-05-01,137,167,-30
"South Bend-Mishawaka, IN-MI",43780.0,2020-06-01,108,55,53
"South Bend-Mishawaka, IN-MI",43780.0,2020-07-01,17,0,17
"South Bend-Mishawaka, IN-MI",43780.0,2020-08-01,16,0,16
"South Bend-Mishawaka, IN-MI",43780.0,2020-09-01,-17,0,-17
"South Bend-Mishawaka, IN-MI",43780.0,2020-10-01,-210,-185,-25
"South Bend-Mishawaka, IN-MI",43780.0,2020-11-01,-109,-171,62
"South Bend-Mishawaka, IN-MI",43780.0,2020-12-01,-188,-231,43
"Brainerd, MN",14660.0,2019-01-01,-144,-143,-1
"Brainerd, MN",14660.0,2019-02-01,-23,-29,6
"Brainerd, MN",14660.0,2019-03-01,83,0,83
"Brainerd, MN",14660.0,2019-04-01,518,355,163
"Brainerd, MN",14660.0,2019-05-01,724,671,53
"Brainerd, MN",14660.0,2019-06-01,191,129,62
"Brainerd, MN",14660.0,2019-07-01,58,11,47
"Brainerd, MN",14660.0,2019-08-01,52,0,52
"Brainerd, MN",14660.0,2019-09-01,-99,-123,24
"Brainerd, MN",14660.0,2019-10-01,-752,-722,-30
"Brainerd, MN",14660.0,2019-11-01,-376,-409,33
"Brainerd, MN",14660.0,2019-12-01,-402,-390,-12
"Brainerd, MN",14660.0,2020-01-01,-202,-216,14
"Brainerd, MN",14660.0,2020-02-01,-3,-15,12
"Brainerd, MN",14660.0,2020-03-01,180,77,103
"Brainerd, MN",14660.0,2020-04-01,350,251,99
"Brainerd, MN",14660.0,2020-05-01,752,614,138
"Brainerd, MN",14660.0,2020-06-01,364,228,136
"Brainerd, MN",14660.0,2020-07-01,90,37,53
"Brainerd, MN",14660.0,2020-08-01,115,31,84
"Brainerd, MN",14660.0,2020-09-01,4,-48,52
"Brainerd, MN",14660.0,2020-10-01,-776,-757,-19
"Brainerd, MN",14660.0,2020-11-01,-256,-358,102
"Brainerd, MN",14660.0,2020-12-01,-215,-289,74
"Fargo, ND-MN",22020.0,2019-01-01,-264,-237,-27
"Fargo, ND-MN",22020.0,2019-02-01,14,-25,39
"Fargo, ND-MN",22020.0,2019-03-01,13,2,11
"Fargo, ND-MN",22020.0,2019-04-01,293,193,100
"Fargo, ND-MN",22020.0,2019-05-01,-50,86,-136
"Fargo, ND-MN",22020.0,2019-06-01,-59,2,-61
"Fargo, ND-MN",22020.0,2019-07-01,-49,0,-49
"Fargo, ND-MN",22020.0,2019-08-01,-3,0,-3
"Fargo, ND-MN",22020.0,2019-09-01,-112,-19,-93
"Fargo, ND-MN",22020.0,2019-10-01,-359,-334,-25
"Fargo, ND-MN",22020.0,2019-11-01,-269,-248,-21
"Fargo, ND-MN",22020.0,2019-12-01,-363,-343,-20
"Fargo, ND-MN",22020.0,2020-01-01,-220,-210,-10
"Fargo, ND-MN",22020.0,2020-02-01,-10,-19,9
"Fargo, ND-MN",22020.0,2020-03-01,194,46,148
"Fargo, ND-MN",22020.0,2020-04-01,140,69,71
"Fargo, ND-MN",22020.0,2020-05-01,17,68,-51
"Fargo, ND-MN",22020.0,2020-06-01,-64,13,-77
"Fargo, ND-MN",22020.0,2020-07-01,-139,0,-139
"Fargo, ND-MN",22020.0,2020-08-01,-7,0,-7
"Fargo, ND-MN",22020.0,2020-09-01,-41,-15,-26
"Fargo, ND-MN",22020.0,2020-10-01,-279,-259,-20
"Fargo, ND-MN",22020.0,2020-11-01,-254,-247,-7
"Fargo, ND-MN",22020.0,2020-12-01,-344,-285,-59
"Omaha-Council Bluffs, NE-IA",36540.0,2019-01-01,-274,-215,-59
"Omaha-Council Bluffs, NE-IA",36540.0,2019-02-01,75,-8,83
"Omaha-Council Bluffs, NE-IA",36540.0,2019-03-01,190,18,172
"Omaha-Council Bluffs, NE-IA",36540.0,2019-04-01,400,194,206
"Omaha-Council Bluffs, NE-IA",36540.0,2019-05-01,134,104,30
"Omaha-Council Bluffs, NE-IA",36540.0,2019-06-01,31,19,12
"Omaha-Council Bluffs, NE-IA",36540.0,2019-07-01,122,23,99
"Omaha-Council Bluffs, NE-IA",36540.0,2019-08-01,108,-11,119
"Omaha-Council Bluffs, NE-IA",36540.0,2019-09-01,25,-13,38
"Omaha-Council Bluffs, NE-IA",36540.0,2019-10-01,-279,-210,-69
"Omaha-Council Bluffs, NE-IA",36540.0,2019-11-01,-127,-134,7
"Omaha-Council Bluffs, NE-IA",36540.0,2019-12-01,-231,-290,59
"Omaha-Council Bluffs, NE-IA",36540.0,2020-01-01,-135,-201,66
"Omaha-Council Bluffs, NE-IA",36540.0,2020-02-01,-3,-12,9
"Omaha-Council Bluffs, NE-IA",36540.0,2020-03-01,174,123,51
"Omaha-Council Bluffs, NE-IA",36540.0,2020-04-01,244,91,153
"Omaha-Council Bluffs, NE-IA",36540.0,2020-05-01,110,128,-18
"Omaha-Council Bluffs, NE-IA",36540.0,2020-06-01,116,31,85
"Omaha-Council Bluffs, NE-IA",36540.0,2020-07-01,114,16,98
"Omaha-Council Bluffs, NE-IA",36540.0,2020-08-01,172,0,172
"Omaha-Council Bluffs, NE-IA",36540.0,2020-09-01,30,2,28
"Omaha-Council Bluffs, NE-IA",36540.0,2020-10-01,-215,-152,-63
"Omaha-Council Bluffs, NE-IA",36540.0,2020-11-01,-133,-164,31
"Omaha-Council Bluffs, NE-IA",36540.0,2020-12-01,-178,-224,46
"Burley, ID",15420.0,2019-01-01,1,0,1
"Burley, ID",15420.0,2019-02-01,0,0,0
"Burley, ID",15420.0,2019-03-01,19,0,19
"Burley, ID",15420.0,2019-04-01,0,0,0
"Burley, ID",15420.0,2019-05-01,13,0,13
"Burley, ID",15420.0,2019-06-01,0,0,0
"Burley, ID",15420.0,2019-07-01,-13,0,-13
"Burley, ID",15420.0,2019-08-01,-14,0,-14
"Burley, ID",15420.0,2019-09-01,11,0,11
"Burley, ID",15420.0,2019-10-01,13,0,13
"Burley, ID",15420.0,2019-11-01,-11,0,-11
"Burley, ID",15420.0,2019-12-01,0,0,0
"Burley, ID",15420.0,2020-01-01,0,0,0
"Burley, ID",15420.0,2020-02-01,0,0,0
"Burley, ID",15420.0,2020-03-01,-17,0,-17
"Burley, ID",15420.0,2020-04-01,-12,0,-12
"Burley, ID",15420.0,2020-05-01,-3,0,-3
"Burley, ID",15420.0,2020-06-01,11,0,11
"Burley, ID",15420.0,2020-07-01,0,0,0
"Burley, ID",15420.0,2020-08-01,0,0,0
"Burley, ID",15420.0,2020-09-01,11,0,11
"Burley, ID",15420.0,2020-10-01,0,0,0
"Burley, ID",15420.0,2020-11-01,-27,0,-27
"Burley, ID",15420.0,2020-12-01,0,0,0
"Chattanooga, TN-GA",16860.0,2019-01-01,32,0,32
"Chattanooga, TN-GA",16860.0,2019-02-01,-33,0,-33
"Chattanooga, TN-GA",16860.0,2019-03-01,-67,0,-67
"Chattanooga, TN-GA",16860.0,2019-04-01,-28,0,-28
"Chattanooga, TN-GA",16860.0,2019-05-01,4,0,4
"Chattanooga, TN-GA",16860.0,2019-06-01,59,0,59
"Chattanooga, TN-GA",16860.0,2019-07-01,-40,0,-40
"Chattanooga, TN-GA",16860.0,2019-08-01,-73,0,-73
"Chattanooga, TN-GA",16860.0,2019-09-01,-10,0,-10
"Chattanooga, TN-GA",16860.0,2019-10-01,84,0,84
"Chattanooga, TN-GA",16860.0,2019-11-01,-85,0,-85
"Chattanooga, TN-GA",16860.0,2019-12-01,13,0,13
"Chattanooga, TN-GA",16860.0,2020-01-01,-9,0,-9
"Chattanooga, TN-GA",16860.0,2020-02-01,-4,0,-4
"Chattanooga, TN-GA",16860.0,2020-03-01,8,0,8
"Chattanooga, TN-GA",16860.0,2020-04-01,-61,0,-61
"Chattanooga, TN-GA",16860.0,2020-05-01,26,0,26
"Chattanooga, TN-GA",16860.0,2020-06-01,-15,0,-15
"Chattanooga, TN-GA",16860.0,2020-07-01,-6,0,-6
"Chattanooga, TN-GA",16860.0,2020-08-01,-26,0,-26
"Chattanooga, TN-GA",16860.0,2020-09-01,-10,0,-10
"Chattanooga, TN-GA",16860.0,2020-10-01,-67,0,-67
"Chattanooga, TN-GA",16860.0,2020-11-01,25,0,25
"Chattanooga, TN-GA",16860.0,2020-12-01,-9,-11,2
"Olean, NY",36460.0,2019-01-01,-7,-13,6
"Olean, NY",36460.0,2019-02-01,20,0,20
"Olean, NY",36460.0,2019-03-01,29,0,29
"Olean, NY",36460.0,2019-04-01,80,36,44
"Olean, NY",36460.0,2019-05-01,50,69,-19
"Olean, NY",36460.0,2019-06-01,-1,0,-1
"Olean, NY",36460.0,2019-07-01,56,0,56
"Olean, NY",36460.0,2019-08-01,-12,0,-12
"Olean, NY",36460.0,2019-09-01,-68,0,-68
"Olean, NY",36460.0,2019-10-01,-51,-55,4
"Olean, NY",36460.0,2019-11-01,-28,-26,-2
"Olean, NY",36460.0,2019-12-01,-34,-42,8
"Olean, NY",36460.0,2020-01-01,3,0,3
"Olean, NY",36460.0,2020-02-01,6,0,6
"Olean, NY",36460.0,2020-03-01,48,11,37
"Olean, NY",36460.0,2020-04-01,2,0,2
"Olean, NY",36460.0,2020-05-01,35,35,0
"Olean, NY",36460.0,2020-06-01,21,0,21
"Olean, NY",36460.0,2020-07-01,9,0,9
"Olean, NY",36460.0,2020-08-01,-7,0,-7
"Olean, NY",36460.0,2020-09-01,20,0,20
"Olean, NY",36460.0,2020-10-01,-27,-60,33
"Olean, NY",36460.0,2020-11-01,-25,0,-25
"Olean, NY",36460.0,2020-12-01,-37,-25,-12
"Auburn, NY",12180.0,2019-01-01,-47,-22,-25
"Auburn, NY",12180.0,2019-02-01,12,0,12
"Auburn, NY",12180.0,2019-03-01,-3,0,-3
"Auburn, NY",12180.0,2019-04-01,20,35,-15
"Auburn, NY",12180.0,2019-05-01,105,89,16
"Auburn, NY",12180.0,2019-06-01,8,0,8
"Auburn, NY",12180.0,2019-07-01,26,0,26
"Auburn, NY",12180.0,2019-08-01,-1,0,-1
"Auburn, NY",12180.0,2019-09-01,-7,0,-7
"Auburn, NY",12180.0,2019-10-01,-98,-71,-27
"Auburn, NY",12180.0,2019-11-01,-63,-34,-29
"Auburn, NY",12180.0,2019-12-01,-48,-38,-10
"Auburn, NY",12180.0,2020-01-01,-77,-61,-16
"Auburn, NY",12180.0,2020-02-01,-15,0,-15
"Auburn, NY",12180.0,2020-03-01,46,0,46
"Auburn, NY",12180.0,2020-04-01,-14,0,-14
"Auburn, NY",12180.0,2020-05-01,34,71,-37
"Auburn, NY",12180.0,2020-06-01,10,0,10
"Auburn, NY",12180.0,2020-07-01,23,0,23
"Auburn, NY",12180.0,2020-08-01,-2,0,-2
"Auburn, NY",12180.0,2020-09-01,30,12,18
"Auburn, NY",12180.0,2020-10-01,22,-15,37
"Auburn, NY",12180.0,2020-11-01,-5,-45,40
"Auburn, NY",12180.0,2020-12-01,-59,-66,7
"State College, PA",44300.0,2019-01-01,-47,-38,-9
"State College, PA",44300.0,2019-02-01,-25,0,-25
"State College, PA",44300.0,2019-03-01,-17,0,-17
"State College, PA",44300.0,2019-04-01,23,15,8
"State College, PA",44300.0,2019-05-01,-94,17,-111
"State College, PA",44300.0,2019-06-01,-77,0,-77
"State College, PA",44300.0,2019-07-01,-285,0,-285
"State College, PA",44300.0,2019-08-01,-19,0,-19
"State College, PA",44300.0,2019-09-01,46,0,46
"State College, PA",44300.0,2019-10-01,18,-14,32
"State College, PA",44300.0,2019-11-01,10,0,10
"State College, PA",44300.0,2019-12-01,-4,-12,8
"State College, PA",44300.0,2020-01-01,-81,-39,-42
"State College, PA",44300.0,2020-02-01,-18,0,-18
"State College, PA",44300.0,2020-03-01,-34,0,-34
"State College, PA",44300.0,2020-04-01,4,22,-18
"State College, PA",44300.0,2020-05-01,-9,12,-21
"State College, PA",44300.0,2020-06-01,-72,0,-72
"State College, PA",44300.0,2020-07-01,-199,0,-199
"State College, PA",44300.0,2020-08-01,23,0,23
"State College, PA",44300.0,2020-09-01,-19,0,-19
"State College, PA",44300.0,2020-10-01,-56,0,-56
"State College, PA",44300.0,2020-11-01,-2,0,-2
"State College, PA",44300.0,2020-12-01,-26,0,-26
"Mason City, IA",32380.0,2019-01-01,-21,-21,0
"Mason City, IA",32380.0,2019-02-01,0,0,0
"Mason City, IA",32380.0,2019-03-01,-12,0,-12
"Mason City, IA",32380.0,2019-04-01,21,32,-11
"Mason City, IA",32380.0,2019-05-01,51,21,30
"Mason City, IA",32380.0,2019-06-01,-29,0,-29
"Mason City, IA",32380.0,2019-07-01,-5,0,-5
"Mason City, IA",32380.0,2019-08-01,-29,0,-29
"Mason City, IA",32380.0,2019-09-01,-33,0,-33
"Mason City, IA",32380.0,2019-10-01,-58,-41,-17
"Mason City, IA",32380.0,2019-11-01,-51,-51,0
"Mason City, IA",32380.0,2019-12-01,-52,-52,0
"Mason City, IA",32380.0,2020-01-01,-34,-22,-12
"Mason City, IA",32380.0,2020-02-01,-127,0,-127
"Mason City, IA",32380.0,2020-03-01,23,0,23
"Mason City, IA",32380.0,2020-04-01,9,11,-2
"Mason City, IA",32380.0,2020-05-01,36,21,15
"Mason City, IA",32380.0,2020-06-01,-10,0,-10
"Mason City, IA",32380.0,2020-07-01,3,0,3
"Mason City, IA",32380.0,2020-08-01,-18,0,-18
"Mason City, IA",32380.0,2020-09-01,14,0,14
"Mason City, IA",32380.0,2020-10-01,-49,-44,-5
"Mason City, IA",32380.0,2020-11-01,-42,-58,16
"Mason City, IA",32380.0,2020-12-01,-15,-26,11
"LaGrange, GA-AL",29300.0,2019-01-01,-6,0,-6
"LaGrange, GA-AL",29300.0,2019-02-01,17,0,17
"LaGrange, GA-AL",29300.0,2019-03-01,-1,0,-1
"LaGrange, GA-AL",29300.0,2019-04-01,3,0,3
"LaGrange, GA-AL",29300.0,2019-05-01,59,0,59
"LaGrange, GA-AL",29300.0,2019-06-01,-4,0,-4
"LaGrange, GA-AL",29300.0,2019-07-01,14,0,14
"LaGrange, GA-AL",29300.0,2019-08-01,-21,0,-21
"LaGrange, GA-AL",29300.0,2019-09-01,49,0,49
"LaGrange, GA-AL",29300.0,2019-10-01,18,0,18
"LaGrange, GA-AL",29300.0,2019-11-01,16,0,16
"LaGrange, GA-AL",29300.0,2019-12-01,-12,0,-12
"LaGrange, GA-AL",29300.0,2020-01-01,22,0,22
"LaGrange, GA-AL",29300.0,2020-02-01,38,0,38
"LaGrange, GA-AL",29300.0,2020-03-01,-6,0,-6
"LaGrange, GA-AL",29300.0,2020-04-01,22,0,22
"LaGrange, GA-AL",29300.0,2020-05-01,0,0,0
"LaGrange, GA-AL",29300.0,2020-06-01,24,0,24
"LaGrange, GA-AL",29300.0,2020-07-01,50,0,50
"LaGrange, GA-AL",29300.0,2020-08-01,-7,0,-7
"LaGrange, GA-AL",29300.0,2020-09-01,21,0,21
"LaGrange, GA-AL",29300.0,2020-10-01,9,0,9
"LaGrange, GA-AL",29300.0,2020-11-01,-17,0,-17
"LaGrange, GA-AL",29300.0,2020-12-01,2,0,2
"Champaign-Urbana, IL",16580.0,2019-01-01,-43,-36,-7
"Champaign-Urbana, IL",16580.0,2019-02-01,-42,0,-42
"Champaign-Urbana, IL",16580.0,2019-03-01,16,0,16
"Champaign-Urbana, IL",16580.0,2019-04-01,7,20,-13
"Champaign-Urbana, IL",16580.0,2019-05-01,-176,8,-184
"Champaign-Urbana, IL",16580.0,2019-06-01,-178,0,-178
"Champaign-Urbana, IL",16580.0,2019-07-01,-386,-23,-363
"Champaign-Urbana, IL",16580.0,2019-08-01,-84,16,-100
"Champaign-Urbana, IL",16580.0,2019-09-01,-5,0,-5
"Champaign-Urbana, IL",16580.0,2019-10-01,134,-28,162
"Champaign-Urbana, IL",16580.0,2019-11-01,-23,-15,-8
"Champaign-Urbana, IL",16580.0,2019-12-01,-75,-86,11
"Champaign-Urbana, IL",16580.0,2020-01-01,-55,-38,-17
"Champaign-Urbana, IL",16580.0,2020-02-01,-17,0,-17
"Champaign-Urbana, IL",16580.0,2020-03-01,34,-7,41
"Champaign-Urbana, IL",16580.0,2020-04-01,40,19,21
"Champaign-Urbana, IL",16580.0,2020-05-01,-29,29,-58
"Champaign-Urbana, IL",16580.0,2020-06-01,-118,11,-129
"Champaign-Urbana, IL",16580.0,2020-07-01,-300,-11,-289
"Champaign-Urbana, IL",16580.0,2020-08-01,1,8,-7
"Champaign-Urbana, IL",16580.0,2020-09-01,5,0,5
"Champaign-Urbana, IL",16580.0,2020-10-01,36,12,24
"Champaign-Urbana, IL",16580.0,2020-11-01,-50,-50,0
"Champaign-Urbana, IL",16580.0,2020-12-01,-68,-66,-2
"Urbana, OH",46500.0,2019-01-01,28,0,28
"Urbana, OH",46500.0,2019-02-01,-1,0,-1
"Urbana, OH",46500.0,2019-03-01,30,0,30
"Urbana, OH",46500.0,2019-04-01,22,0,22
"Urbana, OH",46500.0,2019-05-01,-8,0,-8
"Urbana, OH",46500.0,2019-06-01,-8,0,-8
"Urbana, OH",46500.0,2019-07-01,-21,0,-21
"Urbana, OH",46500.0,2019-08-01,-15,0,-15
"Urbana, OH",46500.0,2019-09-01,1,0,1
"Urbana, OH",46500.0,2019-10-01,28,0,28
"Urbana, OH",46500.0,2019-11-01,16,0,16
"Urbana, OH",46500.0,2019-12-01,14,0,14
"Urbana, OH",46500.0,2020-01-01,8,0,8
"Urbana, OH",46500.0,2020-02-01,20,0,20
"Urbana, OH",46500.0,2020-03-01,-31,0,-31
"Urbana, OH",46500.0,2020-04-01,30,0,30
"Urbana, OH",46500.0,2020-05-01,8,0,8
"Urbana, OH",46500.0,2020-06-01,13,0,13
"Urbana, OH",46500.0,2020-07-01,32,0,32
"Urbana, OH",46500.0,2020-08-01,1,0,1
"Urbana, OH",46500.0,2020-09-01,-7,0,-7
"Urbana, OH",46500.0,2020-10-01,17,0,17
"Urbana, OH",46500.0,2020-11-01,11,0,11
"Urbana, OH",46500.0,2020-12-01,56,0,56
"Punta Gorda, FL",39460.0,2019-01-01,1983,1870,113
"Punta Gorda, FL",39460.0,2019-02-01,157,111,46
"Punta Gorda, FL",39460.0,2019-03-01,63,-14,77
"Punta Gorda, FL",39460.0,2019-04-01,-2474,-2032,-442
"Punta Gorda, FL",39460.0,2019-05-01,-3081,-3058,-23
"Punta Gorda, FL",39460.0,2019-06-01,-416,-525,109
"Punta Gorda, FL",39460.0,2019-07-01,75,-53,128
"Punta Gorda, FL",39460.0,2019-08-01,188,0,188
"Punta Gorda, FL",39460.0,2019-09-01,316,139,177
"Punta Gorda, FL",39460.0,2019-10-01,2405,2221,184
"Punta Gorda, FL",39460.0,2019-11-01,1350,1222,128
"Punta Gorda, FL",39460.0,2019-12-01,2470,2373,97
"Punta Gorda, FL",39460.0,2020-01-01,2039,1937,102
"Punta Gorda, FL",39460.0,2020-02-01,125,60,65
"Punta Gorda, FL",39460.0,2020-03-01,-236,-40,-196
"Punta Gorda, FL",39460.0,2020-04-01,-319,-213,-106
"Punta Gorda, FL",39460.0,2020-05-01,-2009,-1898,-111
"Punta Gorda, FL",39460.0,2020-06-01,-1259,-1257,-2
"Punta Gorda, FL",39460.0,2020-07-01,-20,-192,172
"Punta Gorda, FL",39460.0,2020-08-01,134,0,134
"Punta Gorda, FL",39460.0,2020-09-01,349,66,283
"Punta Gorda, FL",39460.0,2020-10-01,2531,2084,447
"Punta Gorda, FL",39460.0,2020-11-01,1634,1412,222
"Punta Gorda, FL",39460.0,2020-12-01,2126,1992,134
"Durham-Chapel Hill, NC",20500.0,2019-01-01,-33,16,-49
"Durham-Chapel Hill, NC",20500.0,2019-02-01,-14,15,-29
"Durham-Chapel Hill, NC",20500.0,2019-03-01,-106,-11,-95
"Durham-Chapel Hill, NC",20500.0,2019-04-01,19,11,8
"Durham-Chapel Hill, NC",20500.0,2019-05-01,-314,-32,-282
"Durham-Chapel Hill, NC",20500.0,2019-06-01,-358,-8,-350
"Durham-Chapel Hill, NC",20500.0,2019-07-01,-140,7,-147
"Durham-Chapel Hill, NC",20500.0,2019-08-01,67,23,44
"Durham-Chapel Hill, NC",20500.0,2019-09-01,-8,-17,9
"Durham-Chapel Hill, NC",20500.0,2019-10-01,-43,-4,-39
"Durham-Chapel Hill, NC",20500.0,2019-11-01,70,-13,83
"Durham-Chapel Hill, NC",20500.0,2019-12-01,-17,0,-17
"Durham-Chapel Hill, NC",20500.0,2020-01-01,-146,-3,-143
"Durham-Chapel Hill, NC",20500.0,2020-02-01,-54,-1,-53
"Durham-Chapel Hill, NC",20500.0,2020-03-01,2,87,-85
"Durham-Chapel Hill, NC",20500.0,2020-04-01,-28,33,-61
"Durham-Chapel Hill, NC",20500.0,2020-05-01,-292,35,-327
"Durham-Chapel Hill, NC",20500.0,2020-06-01,-426,8,-434
"Durham-Chapel Hill, NC",20500.0,2020-07-01,-119,-12,-107
"Durham-Chapel Hill, NC",20500.0,2020-08-01,-69,0,-69
"Durham-Chapel Hill, NC",20500.0,2020-09-01,-165,-11,-154
"Durham-Chapel Hill, NC",20500.0,2020-10-01,-290,22,-312
"Durham-Chapel Hill, NC",20500.0,2020-11-01,-132,-2,-130
"Durham-Chapel Hill, NC",20500.0,2020-12-01,-226,-8,-218
"Columbus, GA-AL",17980.0,2019-01-01,30,0,30
"Columbus, GA-AL",17980.0,2019-02-01,5,0,5
"Columbus, GA-AL",17980.0,2019-03-01,-12,0,-12
"Columbus, GA-AL",17980.0,2019-04-01,-8,0,-8
"Columbus, GA-AL",17980.0,2019-05-01,-23,0,-23
"Columbus, GA-AL",17980.0,2019-06-01,1,0,1
"Columbus, GA-AL",17980.0,2019-07-01,52,0,52
"Columbus, GA-AL",17980.0,2019-08-01,11,0,11
"Columbus, GA-AL",17980.0,2019-09-01,13,0,13
"Columbus, GA-AL",17980.0,2019-10-01,47,0,47
"Columbus, GA-AL",17980.0,2019-11-01,-24,0,-24
"Columbus, GA-AL",17980.0,2019-12-01,-55,0,-55
"Columbus, GA-AL",17980.0,2020-01-01,-20,0,-20
"Columbus, GA-AL",17980.0,2020-02-01,-100,0,-100
"Columbus, GA-AL",17980.0,2020-03-01,-27,0,-27
"Columbus, GA-AL",17980.0,2020-04-01,-20,13,-33
"Columbus, GA-AL",17980.0,2020-05-01,-27,0,-27
"Columbus, GA-AL",17980.0,2020-06-01,31,0,31
"Columbus, GA-AL",17980.0,2020-07-01,-172,0,-172
"Columbus, GA-AL",17980.0,2020-08-01,-12,11,-23
"Columbus, GA-AL",17980.0,2020-09-01,7,0,7
"Columbus, GA-AL",17980.0,2020-10-01,-20,0,-20
"Columbus, GA-AL",17980.0,2020-11-01,-90,0,-90
"Columbus, GA-AL",17980.0,2020-12-01,56,0,56
"Summerville, GA",44900.0,2019-01-01,35,0,35
"Summerville, GA",44900.0,2019-02-01,2,0,2
"Summerville, GA",44900.0,2019-03-01,28,0,28
"Summerville, GA",44900.0,2019-04-01,-10,0,-10
"Summerville, GA",44900.0,2019-05-01,-3,0,-3
"Summerville, GA",44900.0,2019-06-01,18,0,18
"Summerville, GA",44900.0,2019-07-01,-10,0,-10
"Summerville, GA",44900.0,2019-08-01,-22,0,-22
"Summerville, GA",44900.0,2019-09-01,7,0,7
"Summerville, GA",44900.0,2019-10-01,-2,0,-2
"Summerville, GA",44900.0,2019-11-01,0,0,0
"Summerville, GA",44900.0,2019-12-01,14,0,14
"Summerville, GA",44900.0,2020-01-01,-6,0,-6
"Summerville, GA",44900.0,2020-02-01,-6,0,-6
"Summerville, GA",44900.0,2020-03-01,8,0,8
"Summerville, GA",44900.0,2020-04-01,-2,0,-2
"Summerville, GA",44900.0,2020-05-01,5,0,5
"Summerville, GA",44900.0,2020-06-01,-6,0,-6
"Summerville, GA",44900.0,2020-07-01,2,0,2
"Summerville, GA",44900.0,2020-08-01,4,0,4
"Summerville, GA",44900.0,2020-09-01,-2,0,-2
"Summerville, GA",44900.0,2020-10-01,25,0,25
"Summerville, GA",44900.0,2020-11-01,-13,0,-13
"Summerville, GA",44900.0,2020-12-01,17,0,17
"Jamestown-Dunkirk-Fredonia, NY",27460.0,2019-01-01,-113,-115,2
"Jamestown-Dunkirk-Fredonia, NY",27460.0,2019-02-01,-12,0,-12
"Jamestown-Dunkirk-Fredonia, NY",27460.0,2019-03-01,-5,0,-5
"Jamestown-Dunkirk-Fredonia, NY",27460.0,2019-04-01,181,186,-5
"Jamestown-Dunkirk-Fredonia, NY",27460.0,2019-05-01,437,441,-4
"Jamestown-Dunkirk-Fredonia, NY",27460.0,2019-06-01,234,216,18
"Jamestown-Dunkirk-Fredonia, NY",27460.0,2019-07-01,-29,0,-29
"Jamestown-Dunkirk-Fredonia, NY",27460.0,2019-08-01,-62,0,-62
"Jamestown-Dunkirk-Fredonia, NY",27460.0,2019-09-01,-117,-13,-104
"Jamestown-Dunkirk-Fredonia, NY",27460.0,2019-10-01,-385,-337,-48
"Jamestown-Dunkirk-Fredonia, NY",27460.0,2019-11-01,-232,-160,-72
"Jamestown-Dunkirk-Fredonia, NY",27460.0,2019-12-01,-159,-153,-6
"Jamestown-Dunkirk-Fredonia, NY",27460.0,2020-01-01,-123,-121,-2
"Jamestown-Dunkirk-Fredonia, NY",27460.0,2020-02-01,-14,0,-14
"Jamestown-Dunkirk-Fredonia, NY",27460.0,2020-03-01,10,1,9
"Jamestown-Dunkirk-Fredonia, NY",27460.0,2020-04-01,54,27,27
"Jamestown-Dunkirk-Fredonia, NY",27460.0,2020-05-01,288,290,-2
"Jamestown-Dunkirk-Fredonia, NY",27460.0,2020-06-01,231,211,20
"Jamestown-Dunkirk-Fredonia, NY",27460.0,2020-07-01,-12,0,-12
"Jamestown-Dunkirk-Fredonia, NY",27460.0,2020-08-01,4,0,4
"Jamestown-Dunkirk-Fredonia, NY",27460.0,2020-09-01,-71,-31,-40
"Jamestown-Dunkirk-Fredonia, NY",27460.0,2020-10-01,-330,-259,-71
"Jamestown-Dunkirk-Fredonia, NY",27460.0,2020-11-01,-130,-154,24
"Jamestown-Dunkirk-Fredonia, NY",27460.0,2020-12-01,-63,-79,16
"Roswell, NM",40740.0,2019-01-01,5,0,5
"Roswell, NM",40740.0,2019-02-01,17,0,17
"Roswell, NM",40740.0,2019-03-01,10,0,10
"Roswell, NM",40740.0,2019-04-01,0,0,0
"Roswell, NM",40740.0,2019-05-01,25,0,25
"Roswell, NM",40740.0,2019-06-01,9,0,9
"Roswell, NM",40740.0,2019-07-01,-4,0,-4
"Roswell, NM",40740.0,2019-08-01,-4,0,-4
"Roswell, NM",40740.0,2019-09-01,-12,0,-12
"Roswell, NM",40740.0,2019-10-01,3,0,3
"Roswell, NM",40740.0,2019-11-01,-24,0,-24
"Roswell, NM",40740.0,2019-12-01,-11,0,-11
"Roswell, NM",40740.0,2020-01-01,20,0,20
"Roswell, NM",40740.0,2020-02-01,19,0,19
"Roswell, NM",40740.0,2020-03-01,-3,0,-3
"Roswell, NM",40740.0,2020-04-01,21,0,21
"Roswell, NM",40740.0,2020-05-01,-9,0,-9
"Roswell, NM",40740.0,2020-06-01,-17,0,-17
"Roswell, NM",40740.0,2020-07-01,24,0,24
"Roswell, NM",40740.0,2020-08-01,-10,0,-10
"Roswell, NM",40740.0,2020-09-01,-4,0,-4
"Roswell, NM",40740.0,2020-10-01,3,0,3
"Roswell, NM",40740.0,2020-11-01,-14,-13,-1
"Roswell, NM",40740.0,2020-12-01,30,0,30
"Wenatchee, WA",48300.0,2019-01-01,63,-25,88
"Wenatchee, WA",48300.0,2019-02-01,24,-18,42
"Wenatchee, WA",48300.0,2019-03-01,62,0,62
"Wenatchee, WA",48300.0,2019-04-01,200,120,80
"Wenatchee, WA",48300.0,2019-05-01,168,75,93
"Wenatchee, WA",48300.0,2019-06-01,123,16,107
"Wenatchee, WA",48300.0,2019-07-01,39,0,39
"Wenatchee, WA",48300.0,2019-08-01,17,0,17
"Wenatchee, WA",48300.0,2019-09-01,-28,-22,-6
"Wenatchee, WA",48300.0,2019-10-01,-238,-261,23
"Wenatchee, WA",48300.0,2019-11-01,-74,-83,9
"Wenatchee, WA",48300.0,2019-12-01,-14,-57,43
"Wenatchee, WA",48300.0,2020-01-01,-70,-46,-24
"Wenatchee, WA",48300.0,2020-02-01,23,0,23
"Wenatchee, WA",48300.0,2020-03-01,112,70,42
"Wenatchee, WA",48300.0,2020-04-01,161,73,88
"Wenatchee, WA",48300.0,2020-05-01,170,99,71
"Wenatchee, WA",48300.0,2020-06-01,174,63,111
"Wenatchee, WA",48300.0,2020-07-01,85,19,66
"Wenatchee, WA",48300.0,2020-08-01,72,15,57
"Wenatchee, WA",48300.0,2020-09-01,59,-4,63
"Wenatchee, WA",48300.0,2020-10-01,-166,-222,56
"Wenatchee, WA",48300.0,2020-11-01,-24,-96,72
"Wenatchee, WA",48300.0,2020-12-01,32,-15,47
"Elmira, NY",21300.0,2019-01-01,12,-15,27
"Elmira, NY",21300.0,2019-02-01,42,0,42
"Elmira, NY",21300.0,2019-03-01,9,0,9
"Elmira, NY",21300.0,2019-04-01,26,25,1
"Elmira, NY",21300.0,2019-05-01,12,0,12
"Elmira, NY",21300.0,2019-06-01,4,0,4
"Elmira, NY",21300.0,2019-07-01,27,0,27
"Elmira, NY",21300.0,2019-08-01,-12,0,-12
"Elmira, NY",21300.0,2019-09-01,22,0,22
"Elmira, NY",21300.0,2019-10-01,-27,-16,-11
"Elmira, NY",21300.0,2019-11-01,18,0,18
"Elmira, NY",21300.0,2019-12-01,-30,-46,16
"Elmira, NY",21300.0,2020-01-01,-64,-49,-15
"Elmira, NY",21300.0,2020-02-01,7,0,7
"Elmira, NY",21300.0,2020-03-01,-42,0,-42
"Elmira, NY",21300.0,2020-04-01,-6,0,-6
"Elmira, NY",21300.0,2020-05-01,-8,0,-8
"Elmira, NY",21300.0,2020-06-01,-7,0,-7
"Elmira, NY",21300.0,2020-07-01,-27,0,-27
"Elmira, NY",21300.0,2020-08-01,-39,0,-39
"Elmira, NY",21300.0,2020-09-01,17,0,17
"Elmira, NY",21300.0,2020-10-01,-15,0,-15
"Elmira, NY",21300.0,2020-11-01,21,0,21
"Elmira, NY",21300.0,2020-12-01,-38,-47,9
"Tahlequah, OK",45140.0,2019-01-01,0,0,0
"Tahlequah, OK",45140.0,2019-02-01,-47,0,-47
"Tahlequah, OK",45140.0,2019-03-01,-17,0,-17
"Tahlequah, OK",45140.0,2019-04-01,13,0,13
"Tahlequah, OK",45140.0,2019-05-01,-22,0,-22
"Tahlequah, OK",45140.0,2019-06-01,-15,0,-15
"Tahlequah, OK",45140.0,2019-07-01,-17,0,-17
"Tahlequah, OK",45140.0,2019-08-01,-21,0,-21
"Tahlequah, OK",45140.0,2019-09-01,-15,0,-15
"Tahlequah, OK",45140.0,2019-10-01,-9,0,-9
"Tahlequah, OK",45140.0,2019-11-01,0,0,0
"Tahlequah, OK",45140.0,2019-12-01,-2,0,-2
"Tahlequah, OK",45140.0,2020-01-01,-4,0,-4
"Tahlequah, OK",45140.0,2020-02-01,-20,0,-20
"Tahlequah, OK",45140.0,2020-03-01,-8,0,-8
"Tahlequah, OK",45140.0,2020-04-01,-28,0,-28
"Tahlequah, OK",45140.0,2020-05-01,-15,0,-15
"Tahlequah, OK",45140.0,2020-06-01,-35,0,-35
"Tahlequah, OK",45140.0,2020-07-01,-11,0,-11
"Tahlequah, OK",45140.0,2020-08-01,36,0,36
"Tahlequah, OK",45140.0,2020-09-01,8,0,8
"Tahlequah, OK",45140.0,2020-10-01,-19,0,-19
"Tahlequah, OK",45140.0,2020-11-01,-2,0,-2
"Tahlequah, OK",45140.0,2020-12-01,2,0,2
"Gaffney, SC",23500.0,2019-01-01,-20,0,-20
"Gaffney, SC",23500.0,2019-02-01,-9,0,-9
"Gaffney, SC",23500.0,2019-03-01,28,0,28
"Gaffney, SC",23500.0,2019-04-01,5,0,5
"Gaffney, SC",23500.0,2019-05-01,0,0,0
"Gaffney, SC",23500.0,2019-06-01,1,0,1
"Gaffney, SC",23500.0,2019-07-01,-7,0,-7
"Gaffney, SC",23500.0,2019-08-01,31,0,31
"Gaffney, SC",23500.0,2019-09-01,-5,0,-5
"Gaffney, SC",23500.0,2019-10-01,5,0,5
"Gaffney, SC",23500.0,2019-11-01,-14,0,-14
"Gaffney, SC",23500.0,2019-12-01,-28,0,-28
"Gaffney, SC",23500.0,2020-01-01,6,0,6
"Gaffney, SC",23500.0,2020-02-01,-31,0,-31
"Gaffney, SC",23500.0,2020-03-01,15,0,15
"Gaffney, SC",23500.0,2020-04-01,-5,0,-5
"Gaffney, SC",23500.0,2020-05-01,4,0,4
"Gaffney, SC",23500.0,2020-06-01,12,0,12
"Gaffney, SC",23500.0,2020-07-01,-32,0,-32
"Gaffney, SC",23500.0,2020-08-01,22,0,22
"Gaffney, SC",23500.0,2020-09-01,18,0,18
"Gaffney, SC",23500.0,2020-10-01,15,0,15
"Gaffney, SC",23500.0,2020-11-01,11,0,11
"Gaffney, SC",23500.0,2020-12-01,-8,0,-8
"Jacksonville, TX",27380.0,2019-01-01,7,0,7
"Jacksonville, TX",27380.0,2019-02-01,-10,0,-10
"Jacksonville, TX",27380.0,2019-03-01,3,0,3
"Jacksonville, TX",27380.0,2019-04-01,-14,0,-14
"Jacksonville, TX",27380.0,2019-05-01,10,0,10
"Jacksonville, TX",27380.0,2019-06-01,1,0,1
"Jacksonville, TX",27380.0,2019-07-01,-11,0,-11
"Jacksonville, TX",27380.0,2019-08-01,-9,0,-9
"Jacksonville, TX",27380.0,2019-09-01,1,0,1
"Jacksonville, TX",27380.0,2019-10-01,-15,0,-15
"Jacksonville, TX",27380.0,2019-11-01,4,0,4
"Jacksonville, TX",27380.0,2019-12-01,0,0,0
"Jacksonville, TX",27380.0,2020-01-01,16,0,16
"Jacksonville, TX",27380.0,2020-02-01,-5,0,-5
"Jacksonville, TX",27380.0,2020-03-01,5,0,5
"Jacksonville, TX",27380.0,2020-04-01,1,0,1
"Jacksonville, TX",27380.0,2020-05-01,0,0,0
"Jacksonville, TX",27380.0,2020-06-01,9,0,9
"Jacksonville, TX",27380.0,2020-07-01,10,0,10
"Jacksonville, TX",27380.0,2020-08-01,-7,0,-7
"Jacksonville, TX",27380.0,2020-09-01,-2,0,-2
"Jacksonville, TX",27380.0,2020-10-01,-6,0,-6
"Jacksonville, TX",27380.0,2020-11-01,3,0,3
"Jacksonville, TX",27380.0,2020-12-01,2,0,2
"Virginia Beach-Norfolk-Newport News, VA-NC",47260.0,2019-01-01,-90,-18,-72
"Virginia Beach-Norfolk-Newport News, VA-NC",47260.0,2019-02-01,-87,0,-87
"Virginia Beach-Norfolk-Newport News, VA-NC",47260.0,2019-03-01,-225,0,-225
"Virginia Beach-Norfolk-Newport News, VA-NC",47260.0,2019-04-01,-35,43,-78
"Virginia Beach-Norfolk-Newport News, VA-NC",47260.0,2019-05-01,35,46,-11
"Virginia Beach-Norfolk-Newport News, VA-NC",47260.0,2019-06-01,-146,11,-157
"Virginia Beach-Norfolk-Newport News, VA-NC",47260.0,2019-07-01,44,0,44
"Virginia Beach-Norfolk-Newport News, VA-NC",47260.0,2019-08-01,-85,11,-96
"Virginia Beach-Norfolk-Newport News, VA-NC",47260.0,2019-09-01,-110,0,-110
"Virginia Beach-Norfolk-Newport News, VA-NC",47260.0,2019-10-01,-32,-33,1
"Virginia Beach-Norfolk-Newport News, VA-NC",47260.0,2019-11-01,-22,0,-22
"Virginia Beach-Norfolk-Newport News, VA-NC",47260.0,2019-12-01,1,-15,16
"Virginia Beach-Norfolk-Newport News, VA-NC",47260.0,2020-01-01,-167,-29,-138
"Virginia Beach-Norfolk-Newport News, VA-NC",47260.0,2020-02-01,-86,0,-86
"Virginia Beach-Norfolk-Newport News, VA-NC",47260.0,2020-03-01,-35,28,-63
"Virginia Beach-Norfolk-Newport News, VA-NC",47260.0,2020-04-01,-89,16,-105
"Virginia Beach-Norfolk-Newport News, VA-NC",47260.0,2020-05-01,141,40,101
"Virginia Beach-Norfolk-Newport News, VA-NC",47260.0,2020-06-01,-114,15,-129
"Virginia Beach-Norfolk-Newport News, VA-NC",47260.0,2020-07-01,119,0,119
"Virginia Beach-Norfolk-Newport News, VA-NC",47260.0,2020-08-01,-19,0,-19
"Virginia Beach-Norfolk-Newport News, VA-NC",47260.0,2020-09-01,-76,0,-76
"Virginia Beach-Norfolk-Newport News, VA-NC",47260.0,2020-10-01,-5,-21,16
"Virginia Beach-Norfolk-Newport News, VA-NC",47260.0,2020-11-01,-120,0,-120
"Virginia Beach-Norfolk-Newport News, VA-NC",47260.0,2020-12-01,12,-30,42
"Keene, NH",28300.0,2019-01-01,-23,-13,-10
"Keene, NH",28300.0,2019-02-01,40,0,40
"Keene, NH",28300.0,2019-03-01,32,0,32
"Keene, NH",28300.0,2019-04-01,64,11,53
"Keene, NH",28300.0,2019-05-01,77,74,3
"Keene, NH",28300.0,2019-06-01,63,11,52
"Keene, NH",28300.0,2019-07-01,66,0,66
"Keene, NH",28300.0,2019-08-01,72,0,72
"Keene, NH",28300.0,2019-09-01,56,0,56
"Keene, NH",28300.0,2019-10-01,-26,-27,1
"Keene, NH",28300.0,2019-11-01,42,-12,54
"Keene, NH",28300.0,2019-12-01,33,-11,44
"Keene, NH",28300.0,2020-01-01,9,-15,24
"Keene, NH",28300.0,2020-02-01,35,0,35
"Keene, NH",28300.0,2020-03-01,45,28,17
"Keene, NH",28300.0,2020-04-01,50,13,37
"Keene, NH",28300.0,2020-05-01,34,0,34
"Keene, NH",28300.0,2020-06-01,11,18,-7
"Keene, NH",28300.0,2020-07-01,59,0,59
"Keene, NH",28300.0,2020-08-01,32,0,32
"Keene, NH",28300.0,2020-09-01,8,0,8
"Keene, NH",28300.0,2020-10-01,81,0,81
"Keene, NH",28300.0,2020-11-01,12,-27,39
"Keene, NH",28300.0,2020-12-01,-5,0,-5
"Jackson, TN",27180.0,2019-01-01,-42,0,-42
"Jackson, TN",27180.0,2019-02-01,-45,0,-45
"Jackson, TN",27180.0,2019-03-01,10,0,10
"Jackson, TN",27180.0,2019-04-01,-20,0,-20
"Jackson, TN",27180.0,2019-05-01,-32,0,-32
"Jackson, TN",27180.0,2019-06-01,1,0,1
"Jackson, TN",27180.0,2019-07-01,77,0,77
"Jackson, TN",27180.0,2019-08-01,-26,0,-26
"Jackson, TN",27180.0,2019-09-01,43,0,43
"Jackson, TN",27180.0,2019-10-01,54,0,54
"Jackson, TN",27180.0,2019-11-01,20,0,20
"Jackson, TN",27180.0,2019-12-01,3,0,3
"Jackson, TN",27180.0,2020-01-01,11,0,11
"Jackson, TN",27180.0,2020-02-01,-4,0,-4
"Jackson, TN",27180.0,2020-03-01,28,0,28
"Jackson, TN",27180.0,2020-04-01,-36,0,-36
"Jackson, TN",27180.0,2020-05-01,-6,0,-6
"Jackson, TN",27180.0,2020-06-01,24,0,24
"Jackson, TN",27180.0,2020-07-01,22,0,22
"Jackson, TN",27180.0,2020-08-01,17,0,17
"Jackson, TN",27180.0,2020-09-01,6,0,6
"Jackson, TN",27180.0,2020-10-01,15,0,15
"Jackson, TN",27180.0,2020-11-01,-16,0,-16
"Jackson, TN",27180.0,2020-12-01,5,0,5
"Sault Ste. Marie, MI",42300.0,2019-01-01,0,0,0
"Sault Ste. Marie, MI",42300.0,2019-02-01,0,0,0
"Sault Ste. Marie, MI",42300.0,2019-03-01,0,0,0
"Sault Ste. Marie, MI",42300.0,2019-04-01,0,0,0
"Sault Ste. Marie, MI",42300.0,2019-05-01,14,14,0
"Sault Ste. Marie, MI",42300.0,2019-06-01,0,0,0
"Sault Ste. Marie, MI",42300.0,2019-07-01,0,0,0
"Sault Ste. Marie, MI",42300.0,2019-08-01,-14,0,-14
"Sault Ste. Marie, MI",42300.0,2019-09-01,0,0,0
"Sault Ste. Marie, MI",42300.0,2019-10-01,11,0,11
"Sault Ste. Marie, MI",42300.0,2019-11-01,-23,-23,0
"Sault Ste. Marie, MI",42300.0,2019-12-01,-11,-11,0
"Sault Ste. Marie, MI",42300.0,2020-01-01,0,0,0
"Sault Ste. Marie, MI",42300.0,2020-02-01,0,0,0
"Sault Ste. Marie, MI",42300.0,2020-03-01,0,0,0
"Sault Ste. Marie, MI",42300.0,2020-04-01,-12,-12,0
"Sault Ste. Marie, MI",42300.0,2020-05-01,0,0,0
"Sault Ste. Marie, MI",42300.0,2020-06-01,0,0,0
"Sault Ste. Marie, MI",42300.0,2020-07-01,0,0,0
"Sault Ste. Marie, MI",42300.0,2020-08-01,0,0,0
"Sault Ste. Marie, MI",42300.0,2020-09-01,0,0,0
"Sault Ste. Marie, MI",42300.0,2020-10-01,0,0,0
"Sault Ste. Marie, MI",42300.0,2020-11-01,0,0,0
"Sault Ste. Marie, MI",42300.0,2020-12-01,0,0,0
"Eau Claire, WI",20740.0,2019-01-01,-63,-49,-14
"Eau Claire, WI",20740.0,2019-02-01,-29,0,-29
"Eau Claire, WI",20740.0,2019-03-01,-59,0,-59
"Eau Claire, WI",20740.0,2019-04-01,39,40,-1
"Eau Claire, WI",20740.0,2019-05-01,-103,27,-130
"Eau Claire, WI",20740.0,2019-06-01,-92,0,-92
"Eau Claire, WI",20740.0,2019-07-01,-10,0,-10
"Eau Claire, WI",20740.0,2019-08-01,4,0,4
"Eau Claire, WI",20740.0,2019-09-01,-26,0,-26
"Eau Claire, WI",20740.0,2019-10-01,-102,-74,-28
"Eau Claire, WI",20740.0,2019-11-01,-63,-67,4
"Eau Claire, WI",20740.0,2019-12-01,-86,-85,-1
"Eau Claire, WI",20740.0,2020-01-01,-48,-37,-11
"Eau Claire, WI",20740.0,2020-02-01,-10,0,-10
"Eau Claire, WI",20740.0,2020-03-01,24,0,24
"Eau Claire, WI",20740.0,2020-04-01,-42,0,-42
"Eau Claire, WI",20740.0,2020-05-01,-80,29,-109
"Eau Claire, WI",20740.0,2020-06-01,32,0,32
"Eau Claire, WI",20740.0,2020-07-01,34,0,34
"Eau Claire, WI",20740.0,2020-08-01,34,0,34
"Eau Claire, WI",20740.0,2020-09-01,63,0,63
"Eau Claire, WI",20740.0,2020-10-01,-49,-78,29
"Eau Claire, WI",20740.0,2020-11-01,43,-43,86
"Eau Claire, WI",20740.0,2020-12-01,-91,-80,-11
"Burlington-South Burlington, VT",15540.0,2019-01-01,-176,-162,-14
"Burlington-South Burlington, VT",15540.0,2019-02-01,-29,-12,-17
"Burlington-South Burlington, VT",15540.0,2019-03-01,10,0,10
"Burlington-South Burlington, VT",15540.0,2019-04-01,234,215,19
"Burlington-South Burlington, VT",15540.0,2019-05-01,383,489,-106
"Burlington-South Burlington, VT",15540.0,2019-06-01,41,51,-10
"Burlington-South Burlington, VT",15540.0,2019-07-01,34,0,34
"Burlington-South Burlington, VT",15540.0,2019-08-01,31,0,31
"Burlington-South Burlington, VT",15540.0,2019-09-01,-18,0,-18
"Burlington-South Burlington, VT",15540.0,2019-10-01,-457,-432,-25
"Burlington-South Burlington, VT",15540.0,2019-11-01,-109,-111,2
"Burlington-South Burlington, VT",15540.0,2019-12-01,-126,-122,-4
"Burlington-South Burlington, VT",15540.0,2020-01-01,-202,-209,7
"Burlington-South Burlington, VT",15540.0,2020-02-01,13,0,13
"Burlington-South Burlington, VT",15540.0,2020-03-01,59,71,-12
"Burlington-South Burlington, VT",15540.0,2020-04-01,35,57,-22
"Burlington-South Burlington, VT",15540.0,2020-05-01,291,392,-101
"Burlington-South Burlington, VT",15540.0,2020-06-01,152,154,-2
"Burlington-South Burlington, VT",15540.0,2020-07-01,-37,0,-37
"Burlington-South Burlington, VT",15540.0,2020-08-01,92,27,65
"Burlington-South Burlington, VT",15540.0,2020-09-01,-6,0,-6
"Burlington-South Burlington, VT",15540.0,2020-10-01,-292,-317,25
"Burlington-South Burlington, VT",15540.0,2020-11-01,-118,-63,-55
"Burlington-South Burlington, VT",15540.0,2020-12-01,-88,-88,0
"Taylorville, IL",45380.0,2019-01-01,-23,0,-23
"Taylorville, IL",45380.0,2019-02-01,6,0,6
"Taylorville, IL",45380.0,2019-03-01,-5,0,-5
"Taylorville, IL",45380.0,2019-04-01,4,0,4
"Taylorville, IL",45380.0,2019-05-01,-1,0,-1
"Taylorville, IL",45380.0,2019-06-01,14,0,14
"Taylorville, IL",45380.0,2019-07-01,13,0,13
"Taylorville, IL",45380.0,2019-08-01,5,0,5
"Taylorville, IL",45380.0,2019-09-01,16,0,16
"Taylorville, IL",45380.0,2019-10-01,-6,0,-6
"Taylorville, IL",45380.0,2019-11-01,16,0,16
"Taylorville, IL",45380.0,2019-12-01,-17,0,-17
"Taylorville, IL",45380.0,2020-01-01,-4,0,-4
"Taylorville, IL",45380.0,2020-02-01,-6,0,-6
"Taylorville, IL",45380.0,2020-03-01,-26,0,-26
"Taylorville, IL",45380.0,2020-04-01,-6,0,-6
"Taylorville, IL",45380.0,2020-05-01,16,0,16
"Taylorville, IL",45380.0,2020-06-01,3,0,3
"Taylorville, IL",45380.0,2020-07-01,6,0,6
"Taylorville, IL",45380.0,2020-08-01,-7,0,-7
"Taylorville, IL",45380.0,2020-09-01,2,0,2
"Taylorville, IL",45380.0,2020-10-01,-8,0,-8
"Taylorville, IL",45380.0,2020-11-01,9,0,9
"Taylorville, IL",45380.0,2020-12-01,14,0,14
"Clarksville, TN-KY",17300.0,2019-01-01,1,0,1
"Clarksville, TN-KY",17300.0,2019-02-01,-6,0,-6
"Clarksville, TN-KY",17300.0,2019-03-01,53,0,53
"Clarksville, TN-KY",17300.0,2019-04-01,13,0,13
"Clarksville, TN-KY",17300.0,2019-05-01,126,0,126
"Clarksville, TN-KY",17300.0,2019-06-01,84,0,84
"Clarksville, TN-KY",17300.0,2019-07-01,62,0,62
"Clarksville, TN-KY",17300.0,2019-08-01,23,0,23
"Clarksville, TN-KY",17300.0,2019-09-01,129,0,129
"Clarksville, TN-KY",17300.0,2019-10-01,44,0,44
"Clarksville, TN-KY",17300.0,2019-11-01,20,0,20
"Clarksville, TN-KY",17300.0,2019-12-01,102,0,102
"Clarksville, TN-KY",17300.0,2020-01-01,86,0,86
"Clarksville, TN-KY",17300.0,2020-02-01,92,0,92
"Clarksville, TN-KY",17300.0,2020-03-01,121,0,121
"Clarksville, TN-KY",17300.0,2020-04-01,22,0,22
"Clarksville, TN-KY",17300.0,2020-05-01,73,0,73
"Clarksville, TN-KY",17300.0,2020-06-01,133,0,133
"Clarksville, TN-KY",17300.0,2020-07-01,40,0,40
"Clarksville, TN-KY",17300.0,2020-08-01,158,0,158
"Clarksville, TN-KY",17300.0,2020-09-01,125,0,125
"Clarksville, TN-KY",17300.0,2020-10-01,115,0,115
"Clarksville, TN-KY",17300.0,2020-11-01,216,0,216
"Clarksville, TN-KY",17300.0,2020-12-01,146,0,146
"Springfield, MO",44180.0,2019-01-01,-40,0,-40
"Springfield, MO",44180.0,2019-02-01,-44,0,-44
"Springfield, MO",44180.0,2019-03-01,38,0,38
"Springfield, MO",44180.0,2019-04-01,29,0,29
"Springfield, MO",44180.0,2019-05-01,-94,0,-94
"Springfield, MO",44180.0,2019-06-01,-126,0,-126
"Springfield, MO",44180.0,2019-07-01,14,0,14
"Springfield, MO",44180.0,2019-08-01,-76,0,-76
"Springfield, MO",44180.0,2019-09-01,56,0,56
"Springfield, MO",44180.0,2019-10-01,-13,0,-13
"Springfield, MO",44180.0,2019-11-01,2,-15,17
"Springfield, MO",44180.0,2019-12-01,-4,-25,21
"Springfield, MO",44180.0,2020-01-01,-94,0,-94
"Springfield, MO",44180.0,2020-02-01,-21,0,-21
"Springfield, MO",44180.0,2020-03-01,-60,0,-60
"Springfield, MO",44180.0,2020-04-01,-62,0,-62
"Springfield, MO",44180.0,2020-05-01,-102,0,-102
"Springfield, MO",44180.0,2020-06-01,-83,0,-83
"Springfield, MO",44180.0,2020-07-01,-96,0,-96
"Springfield, MO",44180.0,2020-08-01,53,0,53
"Springfield, MO",44180.0,2020-09-01,-34,0,-34
"Springfield, MO",44180.0,2020-10-01,-33,-11,-22
"Springfield, MO",44180.0,2020-11-01,-35,0,-35
"Springfield, MO",44180.0,2020-12-01,-14,-11,-3
"Fallon, NV",21980.0,2019-01-01,10,0,10
"Fallon, NV",21980.0,2019-02-01,15,0,15
"Fallon, NV",21980.0,2019-03-01,25,0,25
"Fallon, NV",21980.0,2019-04-01,1,0,1
"Fallon, NV",21980.0,2019-05-01,29,0,29
"Fallon, NV",21980.0,2019-06-01,28,0,28
"Fallon, NV",21980.0,2019-07-01,13,0,13
"Fallon, NV",21980.0,2019-08-01,3,0,3
"Fallon, NV",21980.0,2019-09-01,2,0,2
"Fallon, NV",21980.0,2019-10-01,6,0,6
"Fallon, NV",21980.0,2019-11-01,2,0,2
"Fallon, NV",21980.0,2019-12-01,10,0,10
"Fallon, NV",21980.0,2020-01-01,28,0,28
"Fallon, NV",21980.0,2020-02-01,-33,0,-33
"Fallon, NV",21980.0,2020-03-01,15,0,15
"Fallon, NV",21980.0,2020-04-01,18,0,18
"Fallon, NV",21980.0,2020-05-01,13,0,13
"Fallon, NV",21980.0,2020-06-01,29,0,29
"Fallon, NV",21980.0,2020-07-01,-3,0,-3
"Fallon, NV",21980.0,2020-08-01,9,0,9
"Fallon, NV",21980.0,2020-09-01,5,0,5
"Fallon, NV",21980.0,2020-10-01,13,0,13
"Fallon, NV",21980.0,2020-11-01,12,0,12
"Fallon, NV",21980.0,2020-12-01,9,0,9
"Grants, NM",24380.0,2019-01-01,0,0,0
"Grants, NM",24380.0,2019-02-01,-4,0,-4
"Grants, NM",24380.0,2019-03-01,0,0,0
"Grants, NM",24380.0,2019-04-01,-18,0,-18
"Grants, NM",24380.0,2019-05-01,14,0,14
"Grants, NM",24380.0,2019-06-01,-12,0,-12
"Grants, NM",24380.0,2019-07-01,19,0,19
"Grants, NM",24380.0,2019-08-01,-15,0,-15
"Grants, NM",24380.0,2019-09-01,16,0,16
"Grants, NM",24380.0,2019-10-01,1,0,1
"Grants, NM",24380.0,2019-11-01,19,0,19
"Grants, NM",24380.0,2019-12-01,-12,0,-12
"Grants, NM",24380.0,2020-01-01,-9,0,-9
"Grants, NM",24380.0,2020-02-01,-17,0,-17
"Grants, NM",24380.0,2020-03-01,22,0,22
"Grants, NM",24380.0,2020-04-01,22,0,22
"Grants, NM",24380.0,2020-05-01,4,0,4
"Grants, NM",24380.0,2020-06-01,3,0,3
"Grants, NM",24380.0,2020-07-01,-17,0,-17
"Grants, NM",24380.0,2020-08-01,20,0,20
"Grants, NM",24380.0,2020-09-01,14,0,14
"Grants, NM",24380.0,2020-10-01,24,0,24
"Grants, NM",24380.0,2020-11-01,-14,0,-14
"Grants, NM",24380.0,2020-12-01,-5,0,-5
"Homosassa Springs, FL",26140.0,2019-01-01,191,90,101
"Homosassa Springs, FL",26140.0,2019-02-01,109,0,109
"Homosassa Springs, FL",26140.0,2019-03-01,92,0,92
"Homosassa Springs, FL",26140.0,2019-04-01,-72,-126,54
"Homosassa Springs, FL",26140.0,2019-05-01,-164,-288,124
"Homosassa Springs, FL",26140.0,2019-06-01,157,0,157
"Homosassa Springs, FL",26140.0,2019-07-01,164,0,164
"Homosassa Springs, FL",26140.0,2019-08-01,140,0,140
"Homosassa Springs, FL",26140.0,2019-09-01,101,0,101
"Homosassa Springs, FL",26140.0,2019-10-01,263,131,132
"Homosassa Springs, FL",26140.0,2019-11-01,226,90,136
"Homosassa Springs, FL",26140.0,2019-12-01,316,153,163
"Homosassa Springs, FL",26140.0,2020-01-01,210,58,152
"Homosassa Springs, FL",26140.0,2020-02-01,113,0,113
"Homosassa Springs, FL",26140.0,2020-03-01,144,0,144
"Homosassa Springs, FL",26140.0,2020-04-01,180,-12,192
"Homosassa Springs, FL",26140.0,2020-05-01,7,-161,168
"Homosassa Springs, FL",26140.0,2020-06-01,104,-73,177
"Homosassa Springs, FL",26140.0,2020-07-01,222,0,222
"Homosassa Springs, FL",26140.0,2020-08-01,128,0,128
"Homosassa Springs, FL",26140.0,2020-09-01,165,0,165
"Homosassa Springs, FL",26140.0,2020-10-01,203,105,98
"Homosassa Springs, FL",26140.0,2020-11-01,284,72,212
"Homosassa Springs, FL",26140.0,2020-12-01,272,71,201
"Portland-Vancouver-Hillsboro, OR-WA",38900.0,2019-01-01,-489,-733,244
"Portland-Vancouver-Hillsboro, OR-WA",38900.0,2019-02-01,-49,-171,122
"Portland-Vancouver-Hillsboro, OR-WA",38900.0,2019-03-01,289,-9,298
"Portland-Vancouver-Hillsboro, OR-WA",38900.0,2019-04-01,1217,600,617
"Portland-Vancouver-Hillsboro, OR-WA",38900.0,2019-05-01,1661,849,812
"Portland-Vancouver-Hillsboro, OR-WA",38900.0,2019-06-01,1340,366,974
"Portland-Vancouver-Hillsboro, OR-WA",38900.0,2019-07-01,690,77,613
"Portland-Vancouver-Hillsboro, OR-WA",38900.0,2019-08-01,458,13,445
"Portland-Vancouver-Hillsboro, OR-WA",38900.0,2019-09-01,-174,-157,-17
"Portland-Vancouver-Hillsboro, OR-WA",38900.0,2019-10-01,-1144,-1213,69
"Portland-Vancouver-Hillsboro, OR-WA",38900.0,2019-11-01,-613,-536,-77
"Portland-Vancouver-Hillsboro, OR-WA",38900.0,2019-12-01,-238,-488,250
"Portland-Vancouver-Hillsboro, OR-WA",38900.0,2020-01-01,-379,-680,301
"Portland-Vancouver-Hillsboro, OR-WA",38900.0,2020-02-01,108,-172,280
"Portland-Vancouver-Hillsboro, OR-WA",38900.0,2020-03-01,231,-11,242
"Portland-Vancouver-Hillsboro, OR-WA",38900.0,2020-04-01,152,-2,154
"Portland-Vancouver-Hillsboro, OR-WA",38900.0,2020-05-01,757,655,102
"Portland-Vancouver-Hillsboro, OR-WA",38900.0,2020-06-01,1095,418,677
"Portland-Vancouver-Hillsboro, OR-WA",38900.0,2020-07-01,744,225,519
"Portland-Vancouver-Hillsboro, OR-WA",38900.0,2020-08-01,359,53,306
"Portland-Vancouver-Hillsboro, OR-WA",38900.0,2020-09-01,-24,-48,24
"Portland-Vancouver-Hillsboro, OR-WA",38900.0,2020-10-01,-1310,-1030,-280
"Portland-Vancouver-Hillsboro, OR-WA",38900.0,2020-11-01,-844,-667,-177
"Portland-Vancouver-Hillsboro, OR-WA",38900.0,2020-12-01,-624,-458,-166
"Port Angeles, WA",38820.0,2019-01-01,37,0,37
"Port Angeles, WA",38820.0,2019-02-01,-18,0,-18
"Port Angeles, WA",38820.0,2019-03-01,35,0,35
"Port Angeles, WA",38820.0,2019-04-01,127,75,52
"Port Angeles, WA",38820.0,2019-05-01,80,33,47
"Port Angeles, WA",38820.0,2019-06-01,108,12,96
"Port Angeles, WA",38820.0,2019-07-01,46,0,46
"Port Angeles, WA",38820.0,2019-08-01,54,0,54
"Port Angeles, WA",38820.0,2019-09-01,44,0,44
"Port Angeles, WA",38820.0,2019-10-01,-88,-143,55
"Port Angeles, WA",38820.0,2019-11-01,13,-61,74
"Port Angeles, WA",38820.0,2019-12-01,-20,-13,-7
"Port Angeles, WA",38820.0,2020-01-01,-1,-13,12
"Port Angeles, WA",38820.0,2020-02-01,17,0,17
"Port Angeles, WA",38820.0,2020-03-01,102,14,88
"Port Angeles, WA",38820.0,2020-04-01,72,28,44
"Port Angeles, WA",38820.0,2020-05-01,124,36,88
"Port Angeles, WA",38820.0,2020-06-01,110,13,97
"Port Angeles, WA",38820.0,2020-07-01,97,0,97
"Port Angeles, WA",38820.0,2020-08-01,97,0,97
"Port Angeles, WA",38820.0,2020-09-01,82,0,82
"Port Angeles, WA",38820.0,2020-10-01,-18,-96,78
"Port Angeles, WA",38820.0,2020-11-01,52,-45,97
"Port Angeles, WA",38820.0,2020-12-01,52,-12,64
"Sumter, SC",44940.0,2019-01-01,-7,0,-7
"Sumter, SC",44940.0,2019-02-01,-3,0,-3
"Sumter, SC",44940.0,2019-03-01,-17,0,-17
"Sumter, SC",44940.0,2019-04-01,23,0,23
"Sumter, SC",44940.0,2019-05-01,-35,0,-35
"Sumter, SC",44940.0,2019-06-01,32,0,32
"Sumter, SC",44940.0,2019-07-01,-30,0,-30
"Sumter, SC",44940.0,2019-08-01,-42,0,-42
"Sumter, SC",44940.0,2019-09-01,-4,0,-4
"Sumter, SC",44940.0,2019-10-01,15,0,15
"Sumter, SC",44940.0,2019-11-01,19,0,19
"Sumter, SC",44940.0,2019-12-01,-5,0,-5
"Sumter, SC",44940.0,2020-01-01,0,0,0
"Sumter, SC",44940.0,2020-02-01,-16,0,-16
"Sumter, SC",44940.0,2020-03-01,0,0,0
"Sumter, SC",44940.0,2020-04-01,18,0,18
"Sumter, SC",44940.0,2020-05-01,30,0,30
"Sumter, SC",44940.0,2020-06-01,-13,0,-13
"Sumter, SC",44940.0,2020-07-01,-56,0,-56
"Sumter, SC",44940.0,2020-08-01,-6,0,-6
"Sumter, SC",44940.0,2020-09-01,-26,0,-26
"Sumter, SC",44940.0,2020-10-01,-27,0,-27
"Sumter, SC",44940.0,2020-11-01,2,0,2
"Sumter, SC",44940.0,2020-12-01,17,0,17
"Arkadelphia, AR",11660.0,2019-01-01,-2,0,-2
"Arkadelphia, AR",11660.0,2019-02-01,3,0,3
"Arkadelphia, AR",11660.0,2019-03-01,-14,0,-14
"Arkadelphia, AR",11660.0,2019-04-01,-30,0,-30
"Arkadelphia, AR",11660.0,2019-05-01,-32,0,-32
"Arkadelphia, AR",11660.0,2019-06-01,-28,0,-28
"Arkadelphia, AR",11660.0,2019-07-01,-15,0,-15
"Arkadelphia, AR",11660.0,2019-08-01,0,0,0
"Arkadelphia, AR",11660.0,2019-09-01,-2,0,-2
"Arkadelphia, AR",11660.0,2019-10-01,0,0,0
"Arkadelphia, AR",11660.0,2019-11-01,0,0,0
"Arkadelphia, AR",11660.0,2019-12-01,0,0,0
"Arkadelphia, AR",11660.0,2020-01-01,-13,0,-13
"Arkadelphia, AR",11660.0,2020-02-01,-23,0,-23
"Arkadelphia, AR",11660.0,2020-03-01,-24,0,-24
"Arkadelphia, AR",11660.0,2020-04-01,-27,0,-27
"Arkadelphia, AR",11660.0,2020-05-01,14,0,14
"Arkadelphia, AR",11660.0,2020-06-01,-30,0,-30
"Arkadelphia, AR",11660.0,2020-07-01,-3,0,-3
"Arkadelphia, AR",11660.0,2020-08-01,23,0,23
"Arkadelphia, AR",11660.0,2020-09-01,11,0,11
"Arkadelphia, AR",11660.0,2020-10-01,14,0,14
"Arkadelphia, AR",11660.0,2020-11-01,0,0,0
"Arkadelphia, AR",11660.0,2020-12-01,11,0,11
"Fort Madison-Keokuk, IA-IL-MO",22800.0,2019-01-01,30,0,30
"Fort Madison-Keokuk, IA-IL-MO",22800.0,2019-02-01,19,0,19
"Fort Madison-Keokuk, IA-IL-MO",22800.0,2019-03-01,-17,0,-17
"Fort Madison-Keokuk, IA-IL-MO",22800.0,2019-04-01,0,0,0
"Fort Madison-Keokuk, IA-IL-MO",22800.0,2019-05-01,10,0,10
"Fort Madison-Keokuk, IA-IL-MO",22800.0,2019-06-01,5,0,5
"Fort Madison-Keokuk, IA-IL-MO",22800.0,2019-07-01,-7,0,-7
"Fort Madison-Keokuk, IA-IL-MO",22800.0,2019-08-01,17,0,17
"Fort Madison-Keokuk, IA-IL-MO",22800.0,2019-09-01,11,0,11
"Fort Madison-Keokuk, IA-IL-MO",22800.0,2019-10-01,-14,0,-14
"Fort Madison-Keokuk, IA-IL-MO",22800.0,2019-11-01,-15,0,-15
"Fort Madison-Keokuk, IA-IL-MO",22800.0,2019-12-01,5,0,5
"Fort Madison-Keokuk, IA-IL-MO",22800.0,2020-01-01,-14,0,-14
"Fort Madison-Keokuk, IA-IL-MO",22800.0,2020-02-01,11,0,11
"Fort Madison-Keokuk, IA-IL-MO",22800.0,2020-03-01,-22,0,-22
"Fort Madison-Keokuk, IA-IL-MO",22800.0,2020-04-01,13,0,13
"Fort Madison-Keokuk, IA-IL-MO",22800.0,2020-05-01,1,0,1
"Fort Madison-Keokuk, IA-IL-MO",22800.0,2020-06-01,-11,0,-11
"Fort Madison-Keokuk, IA-IL-MO",22800.0,2020-07-01,-1,0,-1
"Fort Madison-Keokuk, IA-IL-MO",22800.0,2020-08-01,0,0,0
"Fort Madison-Keokuk, IA-IL-MO",22800.0,2020-09-01,21,0,21
"Fort Madison-Keokuk, IA-IL-MO",22800.0,2020-10-01,13,0,13
"Fort Madison-Keokuk, IA-IL-MO",22800.0,2020-11-01,0,0,0
"Fort Madison-Keokuk, IA-IL-MO",22800.0,2020-12-01,-14,0,-14
"Las Vegas-Henderson-Paradise, NV",29820.0,2019-01-01,1511,261,1250
"Las Vegas-Henderson-Paradise, NV",29820.0,2019-02-01,840,-17,857
"Las Vegas-Henderson-Paradise, NV",29820.0,2019-03-01,1381,-14,1395
"Las Vegas-Henderson-Paradise, NV",29820.0,2019-04-01,994,-187,1181
"Las Vegas-Henderson-Paradise, NV",29820.0,2019-05-01,711,-641,1352
"Las Vegas-Henderson-Paradise, NV",29820.0,2019-06-01,1640,-314,1954
"Las Vegas-Henderson-Paradise, NV",29820.0,2019-07-01,1866,-113,1979
"Las Vegas-Henderson-Paradise, NV",29820.0,2019-08-01,1661,22,1639
"Las Vegas-Henderson-Paradise, NV",29820.0,2019-09-01,1380,104,1276
"Las Vegas-Henderson-Paradise, NV",29820.0,2019-10-01,2099,654,1445
"Las Vegas-Henderson-Paradise, NV",29820.0,2019-11-01,1137,75,1062
"Las Vegas-Henderson-Paradise, NV",29820.0,2019-12-01,1275,61,1214
"Las Vegas-Henderson-Paradise, NV",29820.0,2020-01-01,1228,150,1078
"Las Vegas-Henderson-Paradise, NV",29820.0,2020-02-01,1127,20,1107
"Las Vegas-Henderson-Paradise, NV",29820.0,2020-03-01,1348,156,1192
"Las Vegas-Henderson-Paradise, NV",29820.0,2020-04-01,1236,-9,1245
"Las Vegas-Henderson-Paradise, NV",29820.0,2020-05-01,833,-399,1232
"Las Vegas-Henderson-Paradise, NV",29820.0,2020-06-01,1291,-280,1571
"Las Vegas-Henderson-Paradise, NV",29820.0,2020-07-01,1950,-59,2009
"Las Vegas-Henderson-Paradise, NV",29820.0,2020-08-01,1486,75,1411
"Las Vegas-Henderson-Paradise, NV",29820.0,2020-09-01,1464,99,1365
"Las Vegas-Henderson-Paradise, NV",29820.0,2020-10-01,1712,560,1152
"Las Vegas-Henderson-Paradise, NV",29820.0,2020-11-01,1232,306,926
"Las Vegas-Henderson-Paradise, NV",29820.0,2020-12-01,1303,181,1122
"Springfield, OH",44220.0,2019-01-01,20,0,20
"Springfield, OH",44220.0,2019-02-01,64,0,64
"Springfield, OH",44220.0,2019-03-01,15,0,15
"Springfield, OH",44220.0,2019-04-01,39,18,21
"Springfield, OH",44220.0,2019-05-01,29,11,18
"Springfield, OH",44220.0,2019-06-01,69,0,69
"Springfield, OH",44220.0,2019-07-01,-131,0,-131
"Springfield, OH",44220.0,2019-08-01,-2,0,-2
"Springfield, OH",44220.0,2019-09-01,22,0,22
"Springfield, OH",44220.0,2019-10-01,-33,-15,-18
"Springfield, OH",44220.0,2019-11-01,-29,-35,6
"Springfield, OH",44220.0,2019-12-01,-28,-34,6
"Springfield, OH",44220.0,2020-01-01,-5,0,-5
"Springfield, OH",44220.0,2020-02-01,37,0,37
"Springfield, OH",44220.0,2020-03-01,25,0,25
"Springfield, OH",44220.0,2020-04-01,-3,0,-3
"Springfield, OH",44220.0,2020-05-01,-60,0,-60
"Springfield, OH",44220.0,2020-06-01,-4,0,-4
"Springfield, OH",44220.0,2020-07-01,44,0,44
"Springfield, OH",44220.0,2020-08-01,-26,0,-26
"Springfield, OH",44220.0,2020-09-01,30,0,30
"Springfield, OH",44220.0,2020-10-01,-27,-22,-5
"Springfield, OH",44220.0,2020-11-01,15,-13,28
"Springfield, OH",44220.0,2020-12-01,-25,-27,2
"Athens-Clarke County, GA",12020.0,2019-01-01,-56,0,-56
"Athens-Clarke County, GA",12020.0,2019-02-01,-30,0,-30
"Athens-Clarke County, GA",12020.0,2019-03-01,61,0,61
"Athens-Clarke County, GA",12020.0,2019-04-01,-50,0,-50
"Athens-Clarke County, GA",12020.0,2019-05-01,-133,0,-133
"Athens-Clarke County, GA",12020.0,2019-06-01,-118,0,-118
"Athens-Clarke County, GA",12020.0,2019-07-01,-429,0,-429
"Athens-Clarke County, GA",12020.0,2019-08-01,-26,0,-26
"Athens-Clarke County, GA",12020.0,2019-09-01,-19,0,-19
"Athens-Clarke County, GA",12020.0,2019-10-01,-1,0,-1
"Athens-Clarke County, GA",12020.0,2019-11-01,-5,0,-5
"Athens-Clarke County, GA",12020.0,2019-12-01,-78,0,-78
"Athens-Clarke County, GA",12020.0,2020-01-01,-99,0,-99
"Athens-Clarke County, GA",12020.0,2020-02-01,-39,0,-39
"Athens-Clarke County, GA",12020.0,2020-03-01,-58,0,-58
"Athens-Clarke County, GA",12020.0,2020-04-01,-101,0,-101
"Athens-Clarke County, GA",12020.0,2020-05-01,-79,0,-79
"Athens-Clarke County, GA",12020.0,2020-06-01,-103,0,-103
"Athens-Clarke County, GA",12020.0,2020-07-01,-393,0,-393
"Athens-Clarke County, GA",12020.0,2020-08-01,-33,0,-33
"Athens-Clarke County, GA",12020.0,2020-09-01,20,0,20
"Athens-Clarke County, GA",12020.0,2020-10-01,-30,0,-30
"Athens-Clarke County, GA",12020.0,2020-11-01,-25,0,-25
"Athens-Clarke County, GA",12020.0,2020-12-01,-29,0,-29
"Meridian, MS",32940.0,2019-01-01,0,0,0
"Meridian, MS",32940.0,2019-02-01,0,0,0
"Meridian, MS",32940.0,2019-03-01,0,0,0
"Meridian, MS",32940.0,2019-04-01,0,0,0
"Meridian, MS",32940.0,2019-05-01,-12,0,-12
"Meridian, MS",32940.0,2019-06-01,13,0,13
"Meridian, MS",32940.0,2019-07-01,-16,0,-16
"Meridian, MS",32940.0,2019-08-01,-11,0,-11
"Meridian, MS",32940.0,2019-09-01,-15,0,-15
"Meridian, MS",32940.0,2019-10-01,-11,0,-11
"Meridian, MS",32940.0,2019-11-01,0,0,0
"Meridian, MS",32940.0,2019-12-01,0,0,0
"Meridian, MS",32940.0,2020-01-01,-11,0,-11
"Meridian, MS",32940.0,2020-02-01,0,0,0
"Meridian, MS",32940.0,2020-03-01,-2,0,-2
"Meridian, MS",32940.0,2020-04-01,0,0,0
"Meridian, MS",32940.0,2020-05-01,0,0,0
"Meridian, MS",32940.0,2020-06-01,0,0,0
"Meridian, MS",32940.0,2020-07-01,12,0,12
"Meridian, MS",32940.0,2020-08-01,0,0,0
"Meridian, MS",32940.0,2020-09-01,0,0,0
"Meridian, MS",32940.0,2020-10-01,0,0,0
"Meridian, MS",32940.0,2020-11-01,45,0,45
"Meridian, MS",32940.0,2020-12-01,-11,0,-11
"Astoria, OR",11820.0,2019-01-01,-5,-11,6
"Astoria, OR",11820.0,2019-02-01,22,0,22
"Astoria, OR",11820.0,2019-03-01,-2,0,-2
"Astoria, OR",11820.0,2019-04-01,3,0,3
"Astoria, OR",11820.0,2019-05-01,47,13,34
"Astoria, OR",11820.0,2019-06-01,64,14,50
"Astoria, OR",11820.0,2019-07-01,14,0,14
"Astoria, OR",11820.0,2019-08-01,11,0,11
"Astoria, OR",11820.0,2019-09-01,-35,0,-35
"Astoria, OR",11820.0,2019-10-01,-15,-26,11
"Astoria, OR",11820.0,2019-11-01,-15,-11,-4
"Astoria, OR",11820.0,2019-12-01,36,0,36
"Astoria, OR",11820.0,2020-01-01,-8,0,-8
"Astoria, OR",11820.0,2020-02-01,24,0,24
"Astoria, OR",11820.0,2020-03-01,59,29,30
"Astoria, OR",11820.0,2020-04-01,68,24,44
"Astoria, OR",11820.0,2020-05-01,34,14,20
"Astoria, OR",11820.0,2020-06-01,46,11,35
"Astoria, OR",11820.0,2020-07-01,46,0,46
"Astoria, OR",11820.0,2020-08-01,39,0,39
"Astoria, OR",11820.0,2020-09-01,66,0,66
"Astoria, OR",11820.0,2020-10-01,10,-33,43
"Astoria, OR",11820.0,2020-11-01,43,0,43
"Astoria, OR",11820.0,2020-12-01,72,0,72
"Spencer, IA",43980.0,2019-01-01,0,0,0
"Spencer, IA",43980.0,2019-02-01,0,0,0
"Spencer, IA",43980.0,2019-03-01,0,0,0
"Spencer, IA",43980.0,2019-04-01,18,0,18
"Spencer, IA",43980.0,2019-05-01,-12,0,-12
"Spencer, IA",43980.0,2019-06-01,13,0,13
"Spencer, IA",43980.0,2019-07-01,-15,0,-15
"Spencer, IA",43980.0,2019-08-01,-12,0,-12
"Spencer, IA",43980.0,2019-09-01,-11,0,-11
"Spencer, IA",43980.0,2019-10-01,-15,-11,-4
"Spencer, IA",43980.0,2019-11-01,-11,0,-11
"Spencer, IA",43980.0,2019-12-01,-11,-11,0
"Spencer, IA",43980.0,2020-01-01,0,0,0
"Spencer, IA",43980.0,2020-02-01,-11,0,-11
"Spencer, IA",43980.0,2020-03-01,-12,0,-12
"Spencer, IA",43980.0,2020-04-01,14,0,14
"Spencer, IA",43980.0,2020-05-01,9,0,9
"Spencer, IA",43980.0,2020-06-01,12,0,12
"Spencer, IA",43980.0,2020-07-01,14,0,14
"Spencer, IA",43980.0,2020-08-01,-5,0,-5
"Spencer, IA",43980.0,2020-09-01,-12,0,-12
"Spencer, IA",43980.0,2020-10-01,14,0,14
"Spencer, IA",43980.0,2020-11-01,-11,-11,0
"Spencer, IA",43980.0,2020-12-01,75,0,75
"Terre Haute, IN",45460.0,2019-01-01,-2,0,-2
"Terre Haute, IN",45460.0,2019-02-01,-9,0,-9
"Terre Haute, IN",45460.0,2019-03-01,-3,0,-3
"Terre Haute, IN",45460.0,2019-04-01,9,0,9
"Terre Haute, IN",45460.0,2019-05-01,-8,0,-8
"Terre Haute, IN",45460.0,2019-06-01,-8,0,-8
"Terre Haute, IN",45460.0,2019-07-01,-10,0,-10
"Terre Haute, IN",45460.0,2019-08-01,8,0,8
"Terre Haute, IN",45460.0,2019-09-01,-25,0,-25
"Terre Haute, IN",45460.0,2019-10-01,15,0,15
"Terre Haute, IN",45460.0,2019-11-01,58,0,58
"Terre Haute, IN",45460.0,2019-12-01,-14,-11,-3
"Terre Haute, IN",45460.0,2020-01-01,17,0,17
"Terre Haute, IN",45460.0,2020-02-01,-18,0,-18
"Terre Haute, IN",45460.0,2020-03-01,25,0,25
"Terre Haute, IN",45460.0,2020-04-01,-11,0,-11
"Terre Haute, IN",45460.0,2020-05-01,0,0,0
"Terre Haute, IN",45460.0,2020-06-01,8,0,8
"Terre Haute, IN",45460.0,2020-07-01,-63,0,-63
"Terre Haute, IN",45460.0,2020-08-01,-22,0,-22
"Terre Haute, IN",45460.0,2020-09-01,24,0,24
"Terre Haute, IN",45460.0,2020-10-01,59,0,59
"Terre Haute, IN",45460.0,2020-11-01,-26,0,-26
"Terre Haute, IN",45460.0,2020-12-01,29,0,29
"London, KY",30940.0,2019-01-01,0,0,0
"London, KY",30940.0,2019-02-01,0,0,0
"London, KY",30940.0,2019-03-01,0,0,0
"London, KY",30940.0,2019-04-01,-12,0,-12
"London, KY",30940.0,2019-05-01,0,0,0
"London, KY",30940.0,2019-06-01,-13,0,-13
"London, KY",30940.0,2019-07-01,13,0,13
"London, KY",30940.0,2019-08-01,1,0,1
"London, KY",30940.0,2019-09-01,11,0,11
"London, KY",30940.0,2019-10-01,-26,0,-26
"London, KY",30940.0,2019-11-01,0,0,0
"London, KY",30940.0,2019-12-01,12,0,12
"London, KY",30940.0,2020-01-01,11,11,0
"London, KY",30940.0,2020-02-01,-25,0,-25
"London, KY",30940.0,2020-03-01,13,0,13
"London, KY",30940.0,2020-04-01,-32,0,-32
"London, KY",30940.0,2020-05-01,13,0,13
"London, KY",30940.0,2020-06-01,-1,0,-1
"London, KY",30940.0,2020-07-01,-13,0,-13
"London, KY",30940.0,2020-08-01,0,0,0
"London, KY",30940.0,2020-09-01,0,0,0
"London, KY",30940.0,2020-10-01,16,0,16
"London, KY",30940.0,2020-11-01,11,0,11
"London, KY",30940.0,2020-12-01,-11,0,-11
"West Point, MS",48500.0,2019-01-01,11,0,11
"West Point, MS",48500.0,2019-02-01,-14,0,-14
"West Point, MS",48500.0,2019-03-01,-12,0,-12
"West Point, MS",48500.0,2019-04-01,0,0,0
"West Point, MS",48500.0,2019-05-01,0,0,0
"West Point, MS",48500.0,2019-06-01,0,0,0
"West Point, MS",48500.0,2019-07-01,14,0,14
"West Point, MS",48500.0,2019-08-01,0,0,0
"West Point, MS",48500.0,2019-09-01,0,0,0
"West Point, MS",48500.0,2019-10-01,15,0,15
"West Point, MS",48500.0,2019-11-01,0,0,0
"West Point, MS",48500.0,2019-12-01,0,0,0
"West Point, MS",48500.0,2020-01-01,0,0,0
"West Point, MS",48500.0,2020-02-01,11,0,11
"West Point, MS",48500.0,2020-03-01,0,0,0
"West Point, MS",48500.0,2020-04-01,0,0,0
"West Point, MS",48500.0,2020-05-01,12,0,12
"West Point, MS",48500.0,2020-06-01,13,0,13
"West Point, MS",48500.0,2020-07-01,14,0,14
"West Point, MS",48500.0,2020-08-01,-11,0,-11
"West Point, MS",48500.0,2020-09-01,0,0,0
"West Point, MS",48500.0,2020-10-01,0,0,0
"West Point, MS",48500.0,2020-11-01,11,0,11
"West Point, MS",48500.0,2020-12-01,11,0,11
"Vermillion, SD",46820.0,2019-01-01,0,0,0
"Vermillion, SD",46820.0,2019-02-01,0,0,0
"Vermillion, SD",46820.0,2019-03-01,0,0,0
"Vermillion, SD",46820.0,2019-04-01,0,0,0
"Vermillion, SD",46820.0,2019-05-01,-65,0,-65
"Vermillion, SD",46820.0,2019-06-01,-32,0,-32
"Vermillion, SD",46820.0,2019-07-01,-31,0,-31
"Vermillion, SD",46820.0,2019-08-01,11,0,11
"Vermillion, SD",46820.0,2019-09-01,12,0,12
"Vermillion, SD",46820.0,2019-10-01,3,-12,15
"Vermillion, SD",46820.0,2019-11-01,0,0,0
"Vermillion, SD",46820.0,2019-12-01,-15,0,-15
"Vermillion, SD",46820.0,2020-01-01,11,0,11
"Vermillion, SD",46820.0,2020-02-01,0,0,0
"Vermillion, SD",46820.0,2020-03-01,0,0,0
"Vermillion, SD",46820.0,2020-04-01,-18,0,-18
"Vermillion, SD",46820.0,2020-05-01,-53,0,-53
"Vermillion, SD",46820.0,2020-06-01,-34,0,-34
"Vermillion, SD",46820.0,2020-07-01,-12,0,-12
"Vermillion, SD",46820.0,2020-08-01,1,0,1
"Vermillion, SD",46820.0,2020-09-01,-11,0,-11
"Vermillion, SD",46820.0,2020-10-01,0,0,0
"Vermillion, SD",46820.0,2020-11-01,0,0,0
"Vermillion, SD",46820.0,2020-12-01,0,0,0
"DuBois, PA",20180.0,2019-01-01,-1,0,-1
"DuBois, PA",20180.0,2019-02-01,10,0,10
"DuBois, PA",20180.0,2019-03-01,-17,0,-17
"DuBois, PA",20180.0,2019-04-01,16,0,16
"DuBois, PA",20180.0,2019-05-01,1,0,1
"DuBois, PA",20180.0,2019-06-01,36,0,36
"DuBois, PA",20180.0,2019-07-01,0,0,0
"DuBois, PA",20180.0,2019-08-01,-44,0,-44
"DuBois, PA",20180.0,2019-09-01,-7,0,-7
"DuBois, PA",20180.0,2019-10-01,-28,0,-28
"DuBois, PA",20180.0,2019-11-01,2,0,2
"DuBois, PA",20180.0,2019-12-01,-3,0,-3
"DuBois, PA",20180.0,2020-01-01,21,0,21
"DuBois, PA",20180.0,2020-02-01,-14,0,-14
"DuBois, PA",20180.0,2020-03-01,9,0,9
"DuBois, PA",20180.0,2020-04-01,12,0,12
"DuBois, PA",20180.0,2020-05-01,-19,0,-19
"DuBois, PA",20180.0,2020-06-01,22,0,22
"DuBois, PA",20180.0,2020-07-01,1,0,1
"DuBois, PA",20180.0,2020-08-01,8,0,8
"DuBois, PA",20180.0,2020-09-01,23,0,23
"DuBois, PA",20180.0,2020-10-01,8,0,8
"DuBois, PA",20180.0,2020-11-01,30,0,30
"DuBois, PA",20180.0,2020-12-01,6,0,6
"Pine Bluff, AR",38220.0,2019-01-01,-24,0,-24
"Pine Bluff, AR",38220.0,2019-02-01,-19,0,-19
"Pine Bluff, AR",38220.0,2019-03-01,-25,0,-25
"Pine Bluff, AR",38220.0,2019-04-01,-29,0,-29
"Pine Bluff, AR",38220.0,2019-05-01,-26,0,-26
"Pine Bluff, AR",38220.0,2019-06-01,-19,0,-19
"Pine Bluff, AR",38220.0,2019-07-01,-52,0,-52
"Pine Bluff, AR",38220.0,2019-08-01,-51,0,-51
"Pine Bluff, AR",38220.0,2019-09-01,-36,0,-36
"Pine Bluff, AR",38220.0,2019-10-01,-44,0,-44
"Pine Bluff, AR",38220.0,2019-11-01,-7,0,-7
"Pine Bluff, AR",38220.0,2019-12-01,-7,0,-7
"Pine Bluff, AR",38220.0,2020-01-01,2,0,2
"Pine Bluff, AR",38220.0,2020-02-01,-53,0,-53
"Pine Bluff, AR",38220.0,2020-03-01,0,0,0
"Pine Bluff, AR",38220.0,2020-04-01,-25,0,-25
"Pine Bluff, AR",38220.0,2020-05-01,-19,0,-19
"Pine Bluff, AR",38220.0,2020-06-01,-28,0,-28
"Pine Bluff, AR",38220.0,2020-07-01,-14,0,-14
"Pine Bluff, AR",38220.0,2020-08-01,-38,0,-38
"Pine Bluff, AR",38220.0,2020-09-01,-30,0,-30
"Pine Bluff, AR",38220.0,2020-10-01,-30,0,-30
"Pine Bluff, AR",38220.0,2020-11-01,-30,0,-30
"Pine Bluff, AR",38220.0,2020-12-01,-25,0,-25
"Shelby, NC",43140.0,2019-01-01,33,0,33
"Shelby, NC",43140.0,2019-02-01,32,0,32
"Shelby, NC",43140.0,2019-03-01,43,0,43
"Shelby, NC",43140.0,2019-04-01,53,0,53
"Shelby, NC",43140.0,2019-05-01,14,0,14
"Shelby, NC",43140.0,2019-06-01,74,0,74
"Shelby, NC",43140.0,2019-07-01,82,0,82
"Shelby, NC",43140.0,2019-08-01,51,0,51
"Shelby, NC",43140.0,2019-09-01,39,0,39
"Shelby, NC",43140.0,2019-10-01,34,0,34
"Shelby, NC",43140.0,2019-11-01,-9,0,-9
"Shelby, NC",43140.0,2019-12-01,15,0,15
"Shelby, NC",43140.0,2020-01-01,35,0,35
"Shelby, NC",43140.0,2020-02-01,67,0,67
"Shelby, NC",43140.0,2020-03-01,25,0,25
"Shelby, NC",43140.0,2020-04-01,98,0,98
"Shelby, NC",43140.0,2020-05-01,61,0,61
"Shelby, NC",43140.0,2020-06-01,56,0,56
"Shelby, NC",43140.0,2020-07-01,40,0,40
"Shelby, NC",43140.0,2020-08-01,97,0,97
"Shelby, NC",43140.0,2020-09-01,51,0,51
"Shelby, NC",43140.0,2020-10-01,58,0,58
"Shelby, NC",43140.0,2020-11-01,32,0,32
"Shelby, NC",43140.0,2020-12-01,61,0,61
"Clinton, IA",17540.0,2019-01-01,-36,0,-36
"Clinton, IA",17540.0,2019-02-01,19,0,19
"Clinton, IA",17540.0,2019-03-01,-46,0,-46
"Clinton, IA",17540.0,2019-04-01,-8,0,-8
"Clinton, IA",17540.0,2019-05-01,25,12,13
"Clinton, IA",17540.0,2019-06-01,20,0,20
"Clinton, IA",17540.0,2019-07-01,17,0,17
"Clinton, IA",17540.0,2019-08-01,-9,0,-9
"Clinton, IA",17540.0,2019-09-01,15,0,15
"Clinton, IA",17540.0,2019-10-01,-34,-13,-21
"Clinton, IA",17540.0,2019-11-01,-35,-26,-9
"Clinton, IA",17540.0,2019-12-01,-13,-13,0
"Clinton, IA",17540.0,2020-01-01,15,0,15
"Clinton, IA",17540.0,2020-02-01,6,0,6
"Clinton, IA",17540.0,2020-03-01,15,0,15
"Clinton, IA",17540.0,2020-04-01,-8,11,-19
"Clinton, IA",17540.0,2020-05-01,2,0,2
"Clinton, IA",17540.0,2020-06-01,-3,0,-3
"Clinton, IA",17540.0,2020-07-01,6,0,6
"Clinton, IA",17540.0,2020-08-01,6,0,6
"Clinton, IA",17540.0,2020-09-01,36,0,36
"Clinton, IA",17540.0,2020-10-01,1,-12,13
"Clinton, IA",17540.0,2020-11-01,7,0,7
"Clinton, IA",17540.0,2020-12-01,5,0,5
"Frankfort, IN",23140.0,2019-01-01,-4,0,-4
"Frankfort, IN",23140.0,2019-02-01,10,0,10
"Frankfort, IN",23140.0,2019-03-01,-5,0,-5
"Frankfort, IN",23140.0,2019-04-01,31,13,18
"Frankfort, IN",23140.0,2019-05-01,-14,0,-14
"Frankfort, IN",23140.0,2019-06-01,-4,0,-4
"Frankfort, IN",23140.0,2019-07-01,0,0,0
"Frankfort, IN",23140.0,2019-08-01,-21,0,-21
"Frankfort, IN",23140.0,2019-09-01,25,0,25
"Frankfort, IN",23140.0,2019-10-01,-12,-15,3
"Frankfort, IN",23140.0,2019-11-01,-5,0,-5
"Frankfort, IN",23140.0,2019-12-01,6,-11,17
"Frankfort, IN",23140.0,2020-01-01,-34,-14,-20
"Frankfort, IN",23140.0,2020-02-01,-3,0,-3
"Frankfort, IN",23140.0,2020-03-01,27,0,27
"Frankfort, IN",23140.0,2020-04-01,-2,0,-2
"Frankfort, IN",23140.0,2020-05-01,-18,0,-18
"Frankfort, IN",23140.0,2020-06-01,-8,0,-8
"Frankfort, IN",23140.0,2020-07-01,19,0,19
"Frankfort, IN",23140.0,2020-08-01,-1,0,-1
"Frankfort, IN",23140.0,2020-09-01,-21,0,-21
"Frankfort, IN",23140.0,2020-10-01,-7,0,-7
"Frankfort, IN",23140.0,2020-11-01,13,0,13
"Frankfort, IN",23140.0,2020-12-01,2,0,2
"Lansing-East Lansing, MI",29620.0,2019-01-01,-254,-291,37
"Lansing-East Lansing, MI",29620.0,2019-02-01,30,0,30
"Lansing-East Lansing, MI",29620.0,2019-03-01,26,0,26
"Lansing-East Lansing, MI",29620.0,2019-04-01,481,320,161
"Lansing-East Lansing, MI",29620.0,2019-05-01,45,188,-143
"Lansing-East Lansing, MI",29620.0,2019-06-01,-147,16,-163
"Lansing-East Lansing, MI",29620.0,2019-07-01,-371,0,-371
"Lansing-East Lansing, MI",29620.0,2019-08-01,-210,0,-210
"Lansing-East Lansing, MI",29620.0,2019-09-01,-74,0,-74
"Lansing-East Lansing, MI",29620.0,2019-10-01,-436,-361,-75
"Lansing-East Lansing, MI",29620.0,2019-11-01,-360,-364,4
"Lansing-East Lansing, MI",29620.0,2019-12-01,-683,-602,-81
"Lansing-East Lansing, MI",29620.0,2020-01-01,-306,-237,-69
"Lansing-East Lansing, MI",29620.0,2020-02-01,-32,0,-32
"Lansing-East Lansing, MI",29620.0,2020-03-01,-42,-20,-22
"Lansing-East Lansing, MI",29620.0,2020-04-01,-48,1,-49
"Lansing-East Lansing, MI",29620.0,2020-05-01,173,165,8
"Lansing-East Lansing, MI",29620.0,2020-06-01,-47,30,-77
"Lansing-East Lansing, MI",29620.0,2020-07-01,-294,0,-294
"Lansing-East Lansing, MI",29620.0,2020-08-01,-157,0,-157
"Lansing-East Lansing, MI",29620.0,2020-09-01,-63,0,-63
"Lansing-East Lansing, MI",29620.0,2020-10-01,-307,-334,27
"Lansing-East Lansing, MI",29620.0,2020-11-01,-332,-314,-18
"Lansing-East Lansing, MI",29620.0,2020-12-01,-350,-346,-4
"Plattsburgh, NY",38460.0,2019-01-01,-65,-55,-10
"Plattsburgh, NY",38460.0,2019-02-01,3,0,3
"Plattsburgh, NY",38460.0,2019-03-01,-6,0,-6
"Plattsburgh, NY",38460.0,2019-04-01,97,85,12
"Plattsburgh, NY",38460.0,2019-05-01,165,162,3
"Plattsburgh, NY",38460.0,2019-06-01,-2,0,-2
"Plattsburgh, NY",38460.0,2019-07-01,17,0,17
"Plattsburgh, NY",38460.0,2019-08-01,-20,0,-20
"Plattsburgh, NY",38460.0,2019-09-01,-9,0,-9
"Plattsburgh, NY",38460.0,2019-10-01,-131,-140,9
"Plattsburgh, NY",38460.0,2019-11-01,-64,-77,13
"Plattsburgh, NY",38460.0,2019-12-01,-111,-108,-3
"Plattsburgh, NY",38460.0,2020-01-01,-80,-63,-17
"Plattsburgh, NY",38460.0,2020-02-01,7,0,7
"Plattsburgh, NY",38460.0,2020-03-01,22,0,22
"Plattsburgh, NY",38460.0,2020-04-01,-17,16,-33
"Plattsburgh, NY",38460.0,2020-05-01,84,53,31
"Plattsburgh, NY",38460.0,2020-06-01,2,0,2
"Plattsburgh, NY",38460.0,2020-07-01,19,0,19
"Plattsburgh, NY",38460.0,2020-08-01,-7,0,-7
"Plattsburgh, NY",38460.0,2020-09-01,-1,0,-1
"Plattsburgh, NY",38460.0,2020-10-01,-79,-104,25
"Plattsburgh, NY",38460.0,2020-11-01,-54,-49,-5
"Plattsburgh, NY",38460.0,2020-12-01,-23,-19,-4
"Wilmington, OH",48940.0,2019-01-01,-19,0,-19
"Wilmington, OH",48940.0,2019-02-01,27,0,27
"Wilmington, OH",48940.0,2019-03-01,-42,0,-42
"Wilmington, OH",48940.0,2019-04-01,41,0,41
"Wilmington, OH",48940.0,2019-05-01,4,0,4
"Wilmington, OH",48940.0,2019-06-01,-16,0,-16
"Wilmington, OH",48940.0,2019-07-01,0,0,0
"Wilmington, OH",48940.0,2019-08-01,57,0,57
"Wilmington, OH",48940.0,2019-09-01,-10,0,-10
"Wilmington, OH",48940.0,2019-10-01,14,0,14
"Wilmington, OH",48940.0,2019-11-01,17,0,17
"Wilmington, OH",48940.0,2019-12-01,-24,0,-24
"Wilmington, OH",48940.0,2020-01-01,-12,0,-12
"Wilmington, OH",48940.0,2020-02-01,1,0,1
"Wilmington, OH",48940.0,2020-03-01,46,0,46
"Wilmington, OH",48940.0,2020-04-01,-42,0,-42
"Wilmington, OH",48940.0,2020-05-01,4,0,4
"Wilmington, OH",48940.0,2020-06-01,-2,0,-2
"Wilmington, OH",48940.0,2020-07-01,-3,0,-3
"Wilmington, OH",48940.0,2020-08-01,40,0,40
"Wilmington, OH",48940.0,2020-09-01,32,0,32
"Wilmington, OH",48940.0,2020-10-01,-11,0,-11
"Wilmington, OH",48940.0,2020-11-01,-10,0,-10
"Wilmington, OH",48940.0,2020-12-01,11,0,11
"Lock Haven, PA",30820.0,2019-01-01,-13,0,-13
"Lock Haven, PA",30820.0,2019-02-01,-5,0,-5
"Lock Haven, PA",30820.0,2019-03-01,-5,0,-5
"Lock Haven, PA",30820.0,2019-04-01,-18,0,-18
"Lock Haven, PA",30820.0,2019-05-01,-28,0,-28
"Lock Haven, PA",30820.0,2019-06-01,-36,0,-36
"Lock Haven, PA",30820.0,2019-07-01,-11,0,-11
"Lock Haven, PA",30820.0,2019-08-01,-18,0,-18
"Lock Haven, PA",30820.0,2019-09-01,-19,0,-19
"Lock Haven, PA",30820.0,2019-10-01,-29,0,-29
"Lock Haven, PA",30820.0,2019-11-01,-17,0,-17
"Lock Haven, PA",30820.0,2019-12-01,3,0,3
"Lock Haven, PA",30820.0,2020-01-01,13,0,13
"Lock Haven, PA",30820.0,2020-02-01,15,0,15
"Lock Haven, PA",30820.0,2020-03-01,12,0,12
"Lock Haven, PA",30820.0,2020-04-01,-12,0,-12
"Lock Haven, PA",30820.0,2020-05-01,-18,0,-18
"Lock Haven, PA",30820.0,2020-06-01,18,0,18
"Lock Haven, PA",30820.0,2020-07-01,-4,0,-4
"Lock Haven, PA",30820.0,2020-08-01,22,0,22
"Lock Haven, PA",30820.0,2020-09-01,9,0,9
"Lock Haven, PA",30820.0,2020-10-01,8,0,8
"Lock Haven, PA",30820.0,2020-11-01,13,0,13
"Lock Haven, PA",30820.0,2020-12-01,25,0,25
"Clarksdale, MS",17260.0,2019-01-01,14,0,14
"Clarksdale, MS",17260.0,2019-02-01,0,0,0
"Clarksdale, MS",17260.0,2019-03-01,0,0,0
"Clarksdale, MS",17260.0,2019-04-01,0,0,0
"Clarksdale, MS",17260.0,2019-05-01,0,0,0
"Clarksdale, MS",17260.0,2019-06-01,-11,0,-11
"Clarksdale, MS",17260.0,2019-07-01,-11,0,-11
"Clarksdale, MS",17260.0,2019-08-01,0,0,0
"Clarksdale, MS",17260.0,2019-09-01,0,0,0
"Clarksdale, MS",17260.0,2019-10-01,-46,0,-46
"Clarksdale, MS",17260.0,2019-11-01,0,0,0
"Clarksdale, MS",17260.0,2019-12-01,0,0,0
"Clarksdale, MS",17260.0,2020-01-01,0,0,0
"Clarksdale, MS",17260.0,2020-02-01,0,0,0
"Clarksdale, MS",17260.0,2020-03-01,0,0,0
"Clarksdale, MS",17260.0,2020-04-01,-23,0,-23
"Clarksdale, MS",17260.0,2020-05-01,0,0,0
"Clarksdale, MS",17260.0,2020-06-01,-15,0,-15
"Clarksdale, MS",17260.0,2020-07-01,0,0,0
"Clarksdale, MS",17260.0,2020-08-01,0,0,0
"Clarksdale, MS",17260.0,2020-09-01,0,0,0
"Clarksdale, MS",17260.0,2020-10-01,0,0,0
"Clarksdale, MS",17260.0,2020-11-01,0,0,0
"Clarksdale, MS",17260.0,2020-12-01,0,0,0
"Coamo, PR",17620.0,2019-01-01,0,0,0
"Coamo, PR",17620.0,2019-03-01,0,0,0
"Coamo, PR",17620.0,2019-05-01,0,0,0
"Coamo, PR",17620.0,2019-06-01,0,0,0
"Coamo, PR",17620.0,2019-07-01,0,0,0
"Coamo, PR",17620.0,2020-07-01,0,0,0
"Coamo, PR",17620.0,2020-08-01,0,0,0
"Coamo, PR",17620.0,2020-12-01,0,0,0
"Sierra Vista-Douglas, AZ",43420.0,2019-01-01,8,-1,9
"Sierra Vista-Douglas, AZ",43420.0,2019-02-01,-23,0,-23
"Sierra Vista-Douglas, AZ",43420.0,2019-03-01,-15,0,-15
"Sierra Vista-Douglas, AZ",43420.0,2019-04-01,-14,-11,-3
"Sierra Vista-Douglas, AZ",43420.0,2019-05-01,-60,-23,-37
"Sierra Vista-Douglas, AZ",43420.0,2019-06-01,46,0,46
"Sierra Vista-Douglas, AZ",43420.0,2019-07-01,-50,0,-50
"Sierra Vista-Douglas, AZ",43420.0,2019-08-01,-67,15,-82
"Sierra Vista-Douglas, AZ",43420.0,2019-09-01,-41,0,-41
"Sierra Vista-Douglas, AZ",43420.0,2019-10-01,21,0,21
"Sierra Vista-Douglas, AZ",43420.0,2019-11-01,29,-12,41
"Sierra Vista-Douglas, AZ",43420.0,2019-12-01,-42,-11,-31
"Sierra Vista-Douglas, AZ",43420.0,2020-01-01,-10,-11,1
"Sierra Vista-Douglas, AZ",43420.0,2020-02-01,-12,0,-12
"Sierra Vista-Douglas, AZ",43420.0,2020-03-01,-25,-13,-12
"Sierra Vista-Douglas, AZ",43420.0,2020-04-01,-5,11,-16
"Sierra Vista-Douglas, AZ",43420.0,2020-05-01,46,18,28
"Sierra Vista-Douglas, AZ",43420.0,2020-06-01,-106,0,-106
"Sierra Vista-Douglas, AZ",43420.0,2020-07-01,58,0,58
"Sierra Vista-Douglas, AZ",43420.0,2020-08-01,42,0,42
"Sierra Vista-Douglas, AZ",43420.0,2020-09-01,-3,0,-3
"Sierra Vista-Douglas, AZ",43420.0,2020-10-01,50,-14,64
"Sierra Vista-Douglas, AZ",43420.0,2020-11-01,7,-14,21
"Sierra Vista-Douglas, AZ",43420.0,2020-12-01,46,0,46
"Newport, TN",35460.0,2019-01-01,9,0,9
"Newport, TN",35460.0,2019-02-01,6,0,6
"Newport, TN",35460.0,2019-03-01,9,0,9
"Newport, TN",35460.0,2019-04-01,11,0,11
"Newport, TN",35460.0,2019-05-01,-15,0,-15
"Newport, TN",35460.0,2019-06-01,31,0,31
"Newport, TN",35460.0,2019-07-01,11,0,11
"Newport, TN",35460.0,2019-08-01,-30,0,-30
"Newport, TN",35460.0,2019-09-01,17,0,17
"Newport, TN",35460.0,2019-10-01,9,0,9
"Newport, TN",35460.0,2019-11-01,-6,0,-6
"Newport, TN",35460.0,2019-12-01,5,0,5
"Newport, TN",35460.0,2020-01-01,-9,0,-9
"Newport, TN",35460.0,2020-02-01,-35,0,-35
"Newport, TN",35460.0,2020-03-01,-17,0,-17
"Newport, TN",35460.0,2020-04-01,-18,0,-18
"Newport, TN",35460.0,2020-05-01,-4,0,-4
"Newport, TN",35460.0,2020-06-01,-1,0,-1
"Newport, TN",35460.0,2020-07-01,-10,0,-10
"Newport, TN",35460.0,2020-08-01,29,0,29
"Newport, TN",35460.0,2020-09-01,12,0,12
"Newport, TN",35460.0,2020-10-01,-10,0,-10
"Newport, TN",35460.0,2020-11-01,-11,0,-11
"Newport, TN",35460.0,2020-12-01,-28,0,-28
"Flagstaff, AZ",22380.0,2019-01-01,-102,-8,-94
"Flagstaff, AZ",22380.0,2019-02-01,-74,-22,-52
"Flagstaff, AZ",22380.0,2019-03-01,-56,-23,-33
"Flagstaff, AZ",22380.0,2019-04-01,55,106,-51
"Flagstaff, AZ",22380.0,2019-05-01,566,716,-150
"Flagstaff, AZ",22380.0,2019-06-01,293,371,-78
"Flagstaff, AZ",22380.0,2019-07-01,-80,96,-176
"Flagstaff, AZ",22380.0,2019-08-01,26,44,-18
"Flagstaff, AZ",22380.0,2019-09-01,-183,-55,-128
"Flagstaff, AZ",22380.0,2019-10-01,-695,-465,-230
"Flagstaff, AZ",22380.0,2019-11-01,-225,-169,-56
"Flagstaff, AZ",22380.0,2019-12-01,-113,-47,-66
"Flagstaff, AZ",22380.0,2020-01-01,-138,-49,-89
"Flagstaff, AZ",22380.0,2020-02-01,-37,-30,-7
"Flagstaff, AZ",22380.0,2020-03-01,-74,-4,-70
"Flagstaff, AZ",22380.0,2020-04-01,-5,116,-121
"Flagstaff, AZ",22380.0,2020-05-01,568,736,-168
"Flagstaff, AZ",22380.0,2020-06-01,248,368,-120
"Flagstaff, AZ",22380.0,2020-07-01,-90,89,-179
"Flagstaff, AZ",22380.0,2020-08-01,71,88,-17
"Flagstaff, AZ",22380.0,2020-09-01,-83,-47,-36
"Flagstaff, AZ",22380.0,2020-10-01,-522,-393,-129
"Flagstaff, AZ",22380.0,2020-11-01,-270,-217,-53
"Flagstaff, AZ",22380.0,2020-12-01,-62,-68,6
"Watertown, SD",47980.0,2019-01-01,-14,0,-14
"Watertown, SD",47980.0,2019-02-01,0,0,0
"Watertown, SD",47980.0,2019-03-01,0,0,0
"Watertown, SD",47980.0,2019-04-01,25,14,11
"Watertown, SD",47980.0,2019-05-01,-17,0,-17
"Watertown, SD",47980.0,2019-06-01,-19,0,-19
"Watertown, SD",47980.0,2019-07-01,-11,0,-11
"Watertown, SD",47980.0,2019-08-01,-14,0,-14
"Watertown, SD",47980.0,2019-09-01,0,0,0
"Watertown, SD",47980.0,2019-10-01,-30,-18,-12
"Watertown, SD",47980.0,2019-11-01,-31,-20,-11
"Watertown, SD",47980.0,2019-12-01,-34,-34,0
"Watertown, SD",47980.0,2020-01-01,0,0,0
"Watertown, SD",47980.0,2020-02-01,0,0,0
"Watertown, SD",47980.0,2020-03-01,0,0,0
"Watertown, SD",47980.0,2020-04-01,-13,0,-13
"Watertown, SD",47980.0,2020-05-01,-14,0,-14
"Watertown, SD",47980.0,2020-06-01,0,0,0
"Watertown, SD",47980.0,2020-07-01,-11,0,-11
"Watertown, SD",47980.0,2020-08-01,3,0,3
"Watertown, SD",47980.0,2020-09-01,0,0,0
"Watertown, SD",47980.0,2020-10-01,-17,-17,0
"Watertown, SD",47980.0,2020-11-01,-17,-17,0
"Watertown, SD",47980.0,2020-12-01,-11,-11,0
"Enterprise, AL",21460.0,2019-01-01,-9,0,-9
"Enterprise, AL",21460.0,2019-02-01,-8,0,-8
"Enterprise, AL",21460.0,2019-03-01,-5,0,-5
"Enterprise, AL",21460.0,2019-04-01,-3,0,-3
"Enterprise, AL",21460.0,2019-05-01,31,0,31
"Enterprise, AL",21460.0,2019-06-01,-10,0,-10
"Enterprise, AL",21460.0,2019-07-01,-3,0,-3
"Enterprise, AL",21460.0,2019-08-01,-12,0,-12
"Enterprise, AL",21460.0,2019-09-01,11,0,11
"Enterprise, AL",21460.0,2019-10-01,-35,0,-35
"Enterprise, AL",21460.0,2019-11-01,-15,0,-15
"Enterprise, AL",21460.0,2019-12-01,13,0,13
"Enterprise, AL",21460.0,2020-01-01,-41,0,-41
"Enterprise, AL",21460.0,2020-02-01,1,0,1
"Enterprise, AL",21460.0,2020-03-01,-13,0,-13
"Enterprise, AL",21460.0,2020-04-01,36,0,36
"Enterprise, AL",21460.0,2020-05-01,0,0,0
"Enterprise, AL",21460.0,2020-06-01,53,0,53
"Enterprise, AL",21460.0,2020-07-01,-14,0,-14
"Enterprise, AL",21460.0,2020-08-01,-23,0,-23
"Enterprise, AL",21460.0,2020-09-01,-22,0,-22
"Enterprise, AL",21460.0,2020-10-01,26,0,26
"Enterprise, AL",21460.0,2020-11-01,-36,0,-36
"Enterprise, AL",21460.0,2020-12-01,-26,0,-26
"Tullahoma-Manchester, TN",46100.0,2019-01-01,51,0,51
"Tullahoma-Manchester, TN",46100.0,2019-02-01,17,0,17
"Tullahoma-Manchester, TN",46100.0,2019-03-01,60,0,60
"Tullahoma-Manchester, TN",46100.0,2019-04-01,23,0,23
"Tullahoma-Manchester, TN",46100.0,2019-05-01,-8,0,-8
"Tullahoma-Manchester, TN",46100.0,2019-06-01,36,0,36
"Tullahoma-Manchester, TN",46100.0,2019-07-01,4,0,4
"Tullahoma-Manchester, TN",46100.0,2019-08-01,-1,0,-1
"Tullahoma-Manchester, TN",46100.0,2019-09-01,47,0,47
"Tullahoma-Manchester, TN",46100.0,2019-10-01,59,0,59
"Tullahoma-Manchester, TN",46100.0,2019-11-01,60,0,60
"Tullahoma-Manchester, TN",46100.0,2019-12-01,42,0,42
"Tullahoma-Manchester, TN",46100.0,2020-01-01,30,0,30
"Tullahoma-Manchester, TN",46100.0,2020-02-01,8,0,8
"Tullahoma-Manchester, TN",46100.0,2020-03-01,51,0,51
"Tullahoma-Manchester, TN",46100.0,2020-04-01,62,0,62
"Tullahoma-Manchester, TN",46100.0,2020-05-01,31,0,31
"Tullahoma-Manchester, TN",46100.0,2020-06-01,24,0,24
"Tullahoma-Manchester, TN",46100.0,2020-07-01,57,0,57
"Tullahoma-Manchester, TN",46100.0,2020-08-01,77,0,77
"Tullahoma-Manchester, TN",46100.0,2020-09-01,57,0,57
"Tullahoma-Manchester, TN",46100.0,2020-10-01,37,0,37
"Tullahoma-Manchester, TN",46100.0,2020-11-01,53,0,53
"Tullahoma-Manchester, TN",46100.0,2020-12-01,8,0,8
"Florence-Muscle Shoals, AL",22520.0,2019-01-01,13,0,13
"Florence-Muscle Shoals, AL",22520.0,2019-02-01,4,0,4
"Florence-Muscle Shoals, AL",22520.0,2019-03-01,-34,0,-34
"Florence-Muscle Shoals, AL",22520.0,2019-04-01,1,0,1
"Florence-Muscle Shoals, AL",22520.0,2019-05-01,-5,0,-5
"Florence-Muscle Shoals, AL",22520.0,2019-06-01,-46,0,-46
"Florence-Muscle Shoals, AL",22520.0,2019-07-01,-21,0,-21
"Florence-Muscle Shoals, AL",22520.0,2019-08-01,-22,0,-22
"Florence-Muscle Shoals, AL",22520.0,2019-09-01,6,0,6
"Florence-Muscle Shoals, AL",22520.0,2019-10-01,-18,0,-18
"Florence-Muscle Shoals, AL",22520.0,2019-11-01,-25,0,-25
"Florence-Muscle Shoals, AL",22520.0,2019-12-01,-14,0,-14
"Florence-Muscle Shoals, AL",22520.0,2020-01-01,-28,0,-28
"Florence-Muscle Shoals, AL",22520.0,2020-02-01,15,0,15
"Florence-Muscle Shoals, AL",22520.0,2020-03-01,35,0,35
"Florence-Muscle Shoals, AL",22520.0,2020-04-01,37,0,37
"Florence-Muscle Shoals, AL",22520.0,2020-05-01,-9,0,-9
"Florence-Muscle Shoals, AL",22520.0,2020-06-01,25,0,25
"Florence-Muscle Shoals, AL",22520.0,2020-07-01,-35,0,-35
"Florence-Muscle Shoals, AL",22520.0,2020-08-01,20,0,20
"Florence-Muscle Shoals, AL",22520.0,2020-09-01,-49,0,-49
"Florence-Muscle Shoals, AL",22520.0,2020-10-01,0,0,0
"Florence-Muscle Shoals, AL",22520.0,2020-11-01,-5,0,-5
"Florence-Muscle Shoals, AL",22520.0,2020-12-01,-7,0,-7
"Charleston-Mattoon, IL",16660.0,2019-01-01,4,0,4
"Charleston-Mattoon, IL",16660.0,2019-02-01,8,0,8
"Charleston-Mattoon, IL",16660.0,2019-03-01,-1,0,-1
"Charleston-Mattoon, IL",16660.0,2019-04-01,1,0,1
"Charleston-Mattoon, IL",16660.0,2019-05-01,-100,-18,-82
"Charleston-Mattoon, IL",16660.0,2019-06-01,-26,0,-26
"Charleston-Mattoon, IL",16660.0,2019-07-01,-72,0,-72
"Charleston-Mattoon, IL",16660.0,2019-08-01,-32,0,-32
"Charleston-Mattoon, IL",16660.0,2019-09-01,4,0,4
"Charleston-Mattoon, IL",16660.0,2019-10-01,0,0,0
"Charleston-Mattoon, IL",16660.0,2019-11-01,-13,0,-13
"Charleston-Mattoon, IL",16660.0,2019-12-01,0,-11,11
"Charleston-Mattoon, IL",16660.0,2020-01-01,19,0,19
"Charleston-Mattoon, IL",16660.0,2020-02-01,4,0,4
"Charleston-Mattoon, IL",16660.0,2020-03-01,36,0,36
"Charleston-Mattoon, IL",16660.0,2020-04-01,0,0,0
"Charleston-Mattoon, IL",16660.0,2020-05-01,-4,0,-4
"Charleston-Mattoon, IL",16660.0,2020-06-01,-43,0,-43
"Charleston-Mattoon, IL",16660.0,2020-07-01,-6,0,-6
"Charleston-Mattoon, IL",16660.0,2020-08-01,0,0,0
"Charleston-Mattoon, IL",16660.0,2020-09-01,-7,0,-7
"Charleston-Mattoon, IL",16660.0,2020-10-01,33,0,33
"Charleston-Mattoon, IL",16660.0,2020-11-01,35,0,35
"Charleston-Mattoon, IL",16660.0,2020-12-01,-26,0,-26
"Naples-Marco Island, FL",34940.0,2019-01-01,9666,9435,231
"Naples-Marco Island, FL",34940.0,2019-02-01,1038,1157,-119
"Naples-Marco Island, FL",34940.0,2019-03-01,-707,120,-827
"Naples-Marco Island, FL",34940.0,2019-04-01,-8757,-5782,-2975
"Naples-Marco Island, FL",34940.0,2019-05-01,-12083,-11049,-1034
"Naples-Marco Island, FL",34940.0,2019-06-01,-2296,-2349,53
"Naples-Marco Island, FL",34940.0,2019-07-01,-329,-510,181
"Naples-Marco Island, FL",34940.0,2019-08-01,159,-184,343
"Naples-Marco Island, FL",34940.0,2019-09-01,1581,898,683
"Naples-Marco Island, FL",34940.0,2019-10-01,8489,7082,1407
"Naples-Marco Island, FL",34940.0,2019-11-01,2865,2562,303
"Naples-Marco Island, FL",34940.0,2019-12-01,8564,8257,307
"Naples-Marco Island, FL",34940.0,2020-01-01,9372,9198,174
"Naples-Marco Island, FL",34940.0,2020-02-01,1129,1155,-26
"Naples-Marco Island, FL",34940.0,2020-03-01,-1782,-102,-1680
"Naples-Marco Island, FL",34940.0,2020-04-01,-1556,-531,-1025
"Naples-Marco Island, FL",34940.0,2020-05-01,-6739,-5796,-943
"Naples-Marco Island, FL",34940.0,2020-06-01,-5830,-5531,-299
"Naples-Marco Island, FL",34940.0,2020-07-01,-1304,-1463,159
"Naples-Marco Island, FL",34940.0,2020-08-01,61,-344,405
"Naples-Marco Island, FL",34940.0,2020-09-01,1329,435,894
"Naples-Marco Island, FL",34940.0,2020-10-01,8375,6681,1694
"Naples-Marco Island, FL",34940.0,2020-11-01,4561,3990,571
"Naples-Marco Island, FL",34940.0,2020-12-01,8536,8020,516
"Dallas-Fort Worth-Arlington, TX",19100.0,2019-01-01,740,-25,765
"Dallas-Fort Worth-Arlington, TX",19100.0,2019-02-01,676,0,676
"Dallas-Fort Worth-Arlington, TX",19100.0,2019-03-01,1376,-23,1399
"Dallas-Fort Worth-Arlington, TX",19100.0,2019-04-01,920,39,881
"Dallas-Fort Worth-Arlington, TX",19100.0,2019-05-01,1588,-57,1645
"Dallas-Fort Worth-Arlington, TX",19100.0,2019-06-01,2781,30,2751
"Dallas-Fort Worth-Arlington, TX",19100.0,2019-07-01,3113,4,3109
"Dallas-Fort Worth-Arlington, TX",19100.0,2019-08-01,2070,5,2065
"Dallas-Fort Worth-Arlington, TX",19100.0,2019-09-01,1469,-30,1499
"Dallas-Fort Worth-Arlington, TX",19100.0,2019-10-01,1304,41,1263
"Dallas-Fort Worth-Arlington, TX",19100.0,2019-11-01,1153,25,1128
"Dallas-Fort Worth-Arlington, TX",19100.0,2019-12-01,1288,27,1261
"Dallas-Fort Worth-Arlington, TX",19100.0,2020-01-01,1416,-23,1439
"Dallas-Fort Worth-Arlington, TX",19100.0,2020-02-01,1276,51,1225
"Dallas-Fort Worth-Arlington, TX",19100.0,2020-03-01,1893,438,1455
"Dallas-Fort Worth-Arlington, TX",19100.0,2020-04-01,1546,134,1412
"Dallas-Fort Worth-Arlington, TX",19100.0,2020-05-01,1800,145,1655
"Dallas-Fort Worth-Arlington, TX",19100.0,2020-06-01,2529,4,2525
"Dallas-Fort Worth-Arlington, TX",19100.0,2020-07-01,2402,35,2367
"Dallas-Fort Worth-Arlington, TX",19100.0,2020-08-01,2330,46,2284
"Dallas-Fort Worth-Arlington, TX",19100.0,2020-09-01,1926,75,1851
"Dallas-Fort Worth-Arlington, TX",19100.0,2020-10-01,1371,56,1315
"Dallas-Fort Worth-Arlington, TX",19100.0,2020-11-01,1659,95,1564
"Dallas-Fort Worth-Arlington, TX",19100.0,2020-12-01,2567,82,2485
"Moultrie, GA",34220.0,2019-01-01,-12,0,-12
"Moultrie, GA",34220.0,2019-02-01,0,0,0
"Moultrie, GA",34220.0,2019-03-01,2,0,2
"Moultrie, GA",34220.0,2019-04-01,3,0,3
"Moultrie, GA",34220.0,2019-05-01,0,0,0
"Moultrie, GA",34220.0,2019-06-01,0,0,0
"Moultrie, GA",34220.0,2019-07-01,-28,0,-28
"Moultrie, GA",34220.0,2019-08-01,-25,0,-25
"Moultrie, GA",34220.0,2019-09-01,-12,0,-12
"Moultrie, GA",34220.0,2019-10-01,0,0,0
"Moultrie, GA",34220.0,2019-11-01,0,0,0
"Moultrie, GA",34220.0,2019-12-01,0,0,0
"Moultrie, GA",34220.0,2020-01-01,0,0,0
"Moultrie, GA",34220.0,2020-02-01,3,0,3
"Moultrie, GA",34220.0,2020-03-01,11,0,11
"Moultrie, GA",34220.0,2020-04-01,-19,0,-19
"Moultrie, GA",34220.0,2020-05-01,4,0,4
"Moultrie, GA",34220.0,2020-06-01,0,0,0
"Moultrie, GA",34220.0,2020-07-01,0,0,0
"Moultrie, GA",34220.0,2020-08-01,0,0,0
"Moultrie, GA",34220.0,2020-09-01,-1,0,-1
"Moultrie, GA",34220.0,2020-10-01,0,0,0
"Moultrie, GA",34220.0,2020-11-01,-11,0,-11
"Moultrie, GA",34220.0,2020-12-01,0,0,0
"Magnolia, AR",31620.0,2019-01-01,0,0,0
"Magnolia, AR",31620.0,2019-02-01,0,0,0
"Magnolia, AR",31620.0,2019-03-01,0,0,0
"Magnolia, AR",31620.0,2019-04-01,0,0,0
"Magnolia, AR",31620.0,2019-05-01,0,0,0
"Magnolia, AR",31620.0,2019-06-01,0,0,0
"Magnolia, AR",31620.0,2019-07-01,0,0,0
"Magnolia, AR",31620.0,2019-08-01,0,0,0
"Magnolia, AR",31620.0,2019-09-01,0,0,0
"Magnolia, AR",31620.0,2019-10-01,0,0,0
"Magnolia, AR",31620.0,2019-11-01,0,0,0
"Magnolia, AR",31620.0,2019-12-01,0,0,0
"Magnolia, AR",31620.0,2020-01-01,0,0,0
"Magnolia, AR",31620.0,2020-02-01,0,0,0
"Magnolia, AR",31620.0,2020-03-01,0,0,0
"Magnolia, AR",31620.0,2020-04-01,-23,0,-23
"Magnolia, AR",31620.0,2020-05-01,0,0,0
"Magnolia, AR",31620.0,2020-06-01,0,0,0
"Magnolia, AR",31620.0,2020-07-01,0,0,0
"Magnolia, AR",31620.0,2020-08-01,0,0,0
"Magnolia, AR",31620.0,2020-09-01,0,0,0
"Magnolia, AR",31620.0,2020-10-01,0,0,0
"Magnolia, AR",31620.0,2020-11-01,0,0,0
"Magnolia, AR",31620.0,2020-12-01,0,0,0
"Lake City, FL",29380.0,2019-01-01,27,0,27
"Lake City, FL",29380.0,2019-02-01,27,0,27
"Lake City, FL",29380.0,2019-03-01,32,0,32
"Lake City, FL",29380.0,2019-04-01,24,0,24
"Lake City, FL",29380.0,2019-05-01,20,0,20
"Lake City, FL",29380.0,2019-06-01,-6,0,-6
"Lake City, FL",29380.0,2019-07-01,11,0,11
"Lake City, FL",29380.0,2019-08-01,41,0,41
"Lake City, FL",29380.0,2019-09-01,59,0,59
"Lake City, FL",29380.0,2019-10-01,38,0,38
"Lake City, FL",29380.0,2019-11-01,36,0,36
"Lake City, FL",29380.0,2019-12-01,16,0,16
"Lake City, FL",29380.0,2020-01-01,66,0,66
"Lake City, FL",29380.0,2020-02-01,-3,0,-3
"Lake City, FL",29380.0,2020-03-01,-25,0,-25
"Lake City, FL",29380.0,2020-04-01,4,0,4
"Lake City, FL",29380.0,2020-05-01,-30,0,-30
"Lake City, FL",29380.0,2020-06-01,25,0,25
"Lake City, FL",29380.0,2020-07-01,53,0,53
"Lake City, FL",29380.0,2020-08-01,23,0,23
"Lake City, FL",29380.0,2020-09-01,9,0,9
"Lake City, FL",29380.0,2020-10-01,12,0,12
"Lake City, FL",29380.0,2020-11-01,36,0,36
"Lake City, FL",29380.0,2020-12-01,36,0,36
"Hudson, NY",26460.0,2019-01-01,22,0,22
"Hudson, NY",26460.0,2019-02-01,64,0,64
"Hudson, NY",26460.0,2019-03-01,-10,0,-10
"Hudson, NY",26460.0,2019-04-01,36,0,36
"Hudson, NY",26460.0,2019-05-01,91,80,11
"Hudson, NY",26460.0,2019-06-01,71,40,31
"Hudson, NY",26460.0,2019-07-01,43,0,43
"Hudson, NY",26460.0,2019-08-01,-36,0,-36
"Hudson, NY",26460.0,2019-09-01,37,0,37
"Hudson, NY",26460.0,2019-10-01,-23,-32,9
"Hudson, NY",26460.0,2019-11-01,-52,-40,-12
"Hudson, NY",26460.0,2019-12-01,23,-39,62
"Hudson, NY",26460.0,2020-01-01,-16,-25,9
"Hudson, NY",26460.0,2020-02-01,2,0,2
"Hudson, NY",26460.0,2020-03-01,862,706,156
"Hudson, NY",26460.0,2020-04-01,443,382,61
"Hudson, NY",26460.0,2020-05-01,400,296,104
"Hudson, NY",26460.0,2020-06-01,412,243,169
"Hudson, NY",26460.0,2020-07-01,279,166,113
"Hudson, NY",26460.0,2020-08-01,206,106,100
"Hudson, NY",26460.0,2020-09-01,235,131,104
"Hudson, NY",26460.0,2020-10-01,143,108,35
"Hudson, NY",26460.0,2020-11-01,63,60,3
"Hudson, NY",26460.0,2020-12-01,120,87,33
"Bloomsburg-Berwick, PA",14100.0,2019-01-01,-17,-12,-5
"Bloomsburg-Berwick, PA",14100.0,2019-02-01,-16,0,-16
"Bloomsburg-Berwick, PA",14100.0,2019-03-01,22,0,22
"Bloomsburg-Berwick, PA",14100.0,2019-04-01,-19,0,-19
"Bloomsburg-Berwick, PA",14100.0,2019-05-01,6,0,6
"Bloomsburg-Berwick, PA",14100.0,2019-06-01,29,0,29
"Bloomsburg-Berwick, PA",14100.0,2019-07-01,4,0,4
"Bloomsburg-Berwick, PA",14100.0,2019-08-01,8,0,8
"Bloomsburg-Berwick, PA",14100.0,2019-09-01,41,0,41
"Bloomsburg-Berwick, PA",14100.0,2019-10-01,30,0,30
"Bloomsburg-Berwick, PA",14100.0,2019-11-01,20,0,20
"Bloomsburg-Berwick, PA",14100.0,2019-12-01,48,0,48
"Bloomsburg-Berwick, PA",14100.0,2020-01-01,49,0,49
"Bloomsburg-Berwick, PA",14100.0,2020-02-01,30,0,30
"Bloomsburg-Berwick, PA",14100.0,2020-03-01,-22,0,-22
"Bloomsburg-Berwick, PA",14100.0,2020-04-01,26,0,26
"Bloomsburg-Berwick, PA",14100.0,2020-05-01,15,0,15
"Bloomsburg-Berwick, PA",14100.0,2020-06-01,21,0,21
"Bloomsburg-Berwick, PA",14100.0,2020-07-01,-9,0,-9
"Bloomsburg-Berwick, PA",14100.0,2020-08-01,25,0,25
"Bloomsburg-Berwick, PA",14100.0,2020-09-01,21,0,21
"Bloomsburg-Berwick, PA",14100.0,2020-10-01,21,0,21
"Bloomsburg-Berwick, PA",14100.0,2020-11-01,51,0,51
"Bloomsburg-Berwick, PA",14100.0,2020-12-01,39,0,39
"Madison, WI",31540.0,2019-01-01,-526,-460,-66
"Madison, WI",31540.0,2019-02-01,-147,-71,-76
"Madison, WI",31540.0,2019-03-01,15,-13,28
"Madison, WI",31540.0,2019-04-01,500,340,160
"Madison, WI",31540.0,2019-05-01,407,400,7
"Madison, WI",31540.0,2019-06-01,-374,60,-434
"Madison, WI",31540.0,2019-07-01,-643,10,-653
"Madison, WI",31540.0,2019-08-01,-608,0,-608
"Madison, WI",31540.0,2019-09-01,80,-49,129
"Madison, WI",31540.0,2019-10-01,-514,-402,-112
"Madison, WI",31540.0,2019-11-01,-391,-298,-93
"Madison, WI",31540.0,2019-12-01,-757,-682,-75
"Madison, WI",31540.0,2020-01-01,-600,-526,-74
"Madison, WI",31540.0,2020-02-01,-171,-96,-75
"Madison, WI",31540.0,2020-03-01,112,39,73
"Madison, WI",31540.0,2020-04-01,19,129,-110
"Madison, WI",31540.0,2020-05-01,201,347,-146
"Madison, WI",31540.0,2020-06-01,-177,104,-281
"Madison, WI",31540.0,2020-07-01,-440,36,-476
"Madison, WI",31540.0,2020-08-01,-444,-16,-428
"Madison, WI",31540.0,2020-09-01,-93,-10,-83
"Madison, WI",31540.0,2020-10-01,-469,-378,-91
"Madison, WI",31540.0,2020-11-01,-506,-443,-63
"Madison, WI",31540.0,2020-12-01,-638,-486,-152
"Salem, OH",41400.0,2019-01-01,-36,-22,-14
"Salem, OH",41400.0,2019-02-01,-20,0,-20
"Salem, OH",41400.0,2019-03-01,22,0,22
"Salem, OH",41400.0,2019-04-01,21,17,4
"Salem, OH",41400.0,2019-05-01,-5,0,-5
"Salem, OH",41400.0,2019-06-01,23,0,23
"Salem, OH",41400.0,2019-07-01,30,0,30
"Salem, OH",41400.0,2019-08-01,-8,0,-8
"Salem, OH",41400.0,2019-09-01,0,0,0
"Salem, OH",41400.0,2019-10-01,17,-14,31
"Salem, OH",41400.0,2019-11-01,25,-15,40
"Salem, OH",41400.0,2019-12-01,0,-19,19
"Salem, OH",41400.0,2020-01-01,19,-14,33
"Salem, OH",41400.0,2020-02-01,-4,0,-4
"Salem, OH",41400.0,2020-03-01,-48,0,-48
"Salem, OH",41400.0,2020-04-01,17,0,17
"Salem, OH",41400.0,2020-05-01,-10,11,-21
"Salem, OH",41400.0,2020-06-01,24,0,24
"Salem, OH",41400.0,2020-07-01,43,0,43
"Salem, OH",41400.0,2020-08-01,13,0,13
"Salem, OH",41400.0,2020-09-01,40,0,40
"Salem, OH",41400.0,2020-10-01,5,0,5
"Salem, OH",41400.0,2020-11-01,41,-11,52
"Salem, OH",41400.0,2020-12-01,-15,-23,8
"Lawton, OK",30020.0,2019-01-01,-18,0,-18
"Lawton, OK",30020.0,2019-02-01,-62,0,-62
"Lawton, OK",30020.0,2019-03-01,2,0,2
"Lawton, OK",30020.0,2019-04-01,-20,0,-20
"Lawton, OK",30020.0,2019-05-01,25,0,25
"Lawton, OK",30020.0,2019-06-01,-19,0,-19
"Lawton, OK",30020.0,2019-07-01,-22,0,-22
"Lawton, OK",30020.0,2019-08-01,-10,0,-10
"Lawton, OK",30020.0,2019-09-01,27,0,27
"Lawton, OK",30020.0,2019-10-01,12,0,12
"Lawton, OK",30020.0,2019-11-01,-14,0,-14
"Lawton, OK",30020.0,2019-12-01,-33,0,-33
"Lawton, OK",30020.0,2020-01-01,-7,0,-7
"Lawton, OK",30020.0,2020-02-01,-14,0,-14
"Lawton, OK",30020.0,2020-03-01,-15,0,-15
"Lawton, OK",30020.0,2020-04-01,-14,12,-26
"Lawton, OK",30020.0,2020-05-01,-33,0,-33
"Lawton, OK",30020.0,2020-06-01,-92,0,-92
"Lawton, OK",30020.0,2020-07-01,21,0,21
"Lawton, OK",30020.0,2020-08-01,7,0,7
"Lawton, OK",30020.0,2020-09-01,-42,0,-42
"Lawton, OK",30020.0,2020-10-01,0,0,0
"Lawton, OK",30020.0,2020-11-01,-27,0,-27
"Lawton, OK",30020.0,2020-12-01,-30,0,-30
"Chicago-Naperville-Elgin, IL-IN-WI",16980.0,2019-01-01,-5786,-4582,-1204
"Chicago-Naperville-Elgin, IL-IN-WI",16980.0,2019-02-01,-1576,-709,-867
"Chicago-Naperville-Elgin, IL-IN-WI",16980.0,2019-03-01,-907,-28,-879
"Chicago-Naperville-Elgin, IL-IN-WI",16980.0,2019-04-01,2864,3226,-362
"Chicago-Naperville-Elgin, IL-IN-WI",16980.0,2019-05-01,4885,5778,-893
"Chicago-Naperville-Elgin, IL-IN-WI",16980.0,2019-06-01,-2253,1146,-3399
"Chicago-Naperville-Elgin, IL-IN-WI",16980.0,2019-07-01,-2969,506,-3475
"Chicago-Naperville-Elgin, IL-IN-WI",16980.0,2019-08-01,-2799,208,-3007
"Chicago-Naperville-Elgin, IL-IN-WI",16980.0,2019-09-01,-2601,-252,-2349
"Chicago-Naperville-Elgin, IL-IN-WI",16980.0,2019-10-01,-5601,-2846,-2755
"Chicago-Naperville-Elgin, IL-IN-WI",16980.0,2019-11-01,-3288,-1726,-1562
"Chicago-Naperville-Elgin, IL-IN-WI",16980.0,2019-12-01,-5780,-4460,-1320
"Chicago-Naperville-Elgin, IL-IN-WI",16980.0,2020-01-01,-5769,-4269,-1500
"Chicago-Naperville-Elgin, IL-IN-WI",16980.0,2020-02-01,-1432,-575,-857
"Chicago-Naperville-Elgin, IL-IN-WI",16980.0,2020-03-01,-1389,-362,-1027
"Chicago-Naperville-Elgin, IL-IN-WI",16980.0,2020-04-01,-2126,-552,-1574
"Chicago-Naperville-Elgin, IL-IN-WI",16980.0,2020-05-01,756,1888,-1132
"Chicago-Naperville-Elgin, IL-IN-WI",16980.0,2020-06-01,-789,2399,-3188
"Chicago-Naperville-Elgin, IL-IN-WI",16980.0,2020-07-01,-2829,977,-3806
"Chicago-Naperville-Elgin, IL-IN-WI",16980.0,2020-08-01,-3500,337,-3837
"Chicago-Naperville-Elgin, IL-IN-WI",16980.0,2020-09-01,-3504,-180,-3324
"Chicago-Naperville-Elgin, IL-IN-WI",16980.0,2020-10-01,-7056,-3284,-3772
"Chicago-Naperville-Elgin, IL-IN-WI",16980.0,2020-11-01,-5472,-2951,-2521
"Chicago-Naperville-Elgin, IL-IN-WI",16980.0,2020-12-01,-7333,-4862,-2471
"Gainesville, TX",23620.0,2019-01-01,44,0,44
"Gainesville, TX",23620.0,2019-02-01,47,0,47
"Gainesville, TX",23620.0,2019-03-01,12,0,12
"Gainesville, TX",23620.0,2019-04-01,23,0,23
"Gainesville, TX",23620.0,2019-05-01,66,0,66
"Gainesville, TX",23620.0,2019-06-01,2,0,2
"Gainesville, TX",23620.0,2019-07-01,-7,0,-7
"Gainesville, TX",23620.0,2019-08-01,-3,0,-3
"Gainesville, TX",23620.0,2019-09-01,13,0,13
"Gainesville, TX",23620.0,2019-10-01,-2,0,-2
"Gainesville, TX",23620.0,2019-11-01,23,0,23
"Gainesville, TX",23620.0,2019-12-01,-23,0,-23
"Gainesville, TX",23620.0,2020-01-01,9,0,9
"Gainesville, TX",23620.0,2020-02-01,-2,0,-2
"Gainesville, TX",23620.0,2020-03-01,5,0,5
"Gainesville, TX",23620.0,2020-04-01,18,0,18
"Gainesville, TX",23620.0,2020-05-01,5,0,5
"Gainesville, TX",23620.0,2020-06-01,61,0,61
"Gainesville, TX",23620.0,2020-07-01,41,0,41
"Gainesville, TX",23620.0,2020-08-01,55,0,55
"Gainesville, TX",23620.0,2020-09-01,-7,0,-7
"Gainesville, TX",23620.0,2020-10-01,39,0,39
"Gainesville, TX",23620.0,2020-11-01,38,0,38
"Gainesville, TX",23620.0,2020-12-01,21,0,21
"Berlin, NH",13620.0,2019-01-01,12,0,12
"Berlin, NH",13620.0,2019-02-01,-14,0,-14
"Berlin, NH",13620.0,2019-03-01,-4,0,-4
"Berlin, NH",13620.0,2019-04-01,12,0,12
"Berlin, NH",13620.0,2019-05-01,52,23,29
"Berlin, NH",13620.0,2019-06-01,-2,0,-2
"Berlin, NH",13620.0,2019-07-01,24,0,24
"Berlin, NH",13620.0,2019-08-01,-12,0,-12
"Berlin, NH",13620.0,2019-09-01,-18,0,-18
"Berlin, NH",13620.0,2019-10-01,-30,-33,3
"Berlin, NH",13620.0,2019-11-01,16,-15,31
"Berlin, NH",13620.0,2019-12-01,13,0,13
"Berlin, NH",13620.0,2020-01-01,-13,0,-13
"Berlin, NH",13620.0,2020-02-01,-17,0,-17
"Berlin, NH",13620.0,2020-03-01,4,0,4
"Berlin, NH",13620.0,2020-04-01,-17,0,-17
"Berlin, NH",13620.0,2020-05-01,22,0,22
"Berlin, NH",13620.0,2020-06-01,-24,0,-24
"Berlin, NH",13620.0,2020-07-01,59,0,59
"Berlin, NH",13620.0,2020-08-01,-6,0,-6
"Berlin, NH",13620.0,2020-09-01,30,0,30
"Berlin, NH",13620.0,2020-10-01,23,0,23
"Berlin, NH",13620.0,2020-11-01,-5,-12,7
"Berlin, NH",13620.0,2020-12-01,0,0,0
"Coos Bay, OR",18300.0,2019-01-01,12,0,12
"Coos Bay, OR",18300.0,2019-02-01,-1,0,-1
"Coos Bay, OR",18300.0,2019-03-01,15,0,15
"Coos Bay, OR",18300.0,2019-04-01,-21,0,-21
"Coos Bay, OR",18300.0,2019-05-01,45,12,33
"Coos Bay, OR",18300.0,2019-06-01,-9,0,-9
"Coos Bay, OR",18300.0,2019-07-01,-28,0,-28
"Coos Bay, OR",18300.0,2019-08-01,-46,0,-46
"Coos Bay, OR",18300.0,2019-09-01,36,0,36
"Coos Bay, OR",18300.0,2019-10-01,29,0,29
"Coos Bay, OR",18300.0,2019-11-01,-9,-13,4
"Coos Bay, OR",18300.0,2019-12-01,2,-11,13
"Coos Bay, OR",18300.0,2020-01-01,0,0,0
"Coos Bay, OR",18300.0,2020-02-01,16,0,16
"Coos Bay, OR",18300.0,2020-03-01,35,11,24
"Coos Bay, OR",18300.0,2020-04-01,7,0,7
"Coos Bay, OR",18300.0,2020-05-01,-9,0,-9
"Coos Bay, OR",18300.0,2020-06-01,35,11,24
"Coos Bay, OR",18300.0,2020-07-01,9,0,9
"Coos Bay, OR",18300.0,2020-08-01,2,0,2
"Coos Bay, OR",18300.0,2020-09-01,6,0,6
"Coos Bay, OR",18300.0,2020-10-01,-2,0,-2
"Coos Bay, OR",18300.0,2020-11-01,30,0,30
"Coos Bay, OR",18300.0,2020-12-01,25,0,25
"Alexander City, AL",10760.0,2019-01-01,10,0,10
"Alexander City, AL",10760.0,2019-02-01,1,0,1
"Alexander City, AL",10760.0,2019-03-01,-27,0,-27
"Alexander City, AL",10760.0,2019-04-01,16,0,16
"Alexander City, AL",10760.0,2019-05-01,17,0,17
"Alexander City, AL",10760.0,2019-06-01,28,0,28
"Alexander City, AL",10760.0,2019-07-01,20,0,20
"Alexander City, AL",10760.0,2019-08-01,-3,0,-3
"Alexander City, AL",10760.0,2019-09-01,-19,0,-19
"Alexander City, AL",10760.0,2019-10-01,-24,0,-24
"Alexander City, AL",10760.0,2019-11-01,0,0,0
"Alexander City, AL",10760.0,2019-12-01,-10,0,-10
"Alexander City, AL",10760.0,2020-01-01,10,0,10
"Alexander City, AL",10760.0,2020-02-01,11,0,11
"Alexander City, AL",10760.0,2020-03-01,22,0,22
"Alexander City, AL",10760.0,2020-04-01,-19,0,-19
"Alexander City, AL",10760.0,2020-05-01,8,0,8
"Alexander City, AL",10760.0,2020-06-01,-4,0,-4
"Alexander City, AL",10760.0,2020-07-01,24,0,24
"Alexander City, AL",10760.0,2020-08-01,-9,0,-9
"Alexander City, AL",10760.0,2020-09-01,-9,0,-9
"Alexander City, AL",10760.0,2020-10-01,0,0,0
"Alexander City, AL",10760.0,2020-11-01,-8,0,-8
"Alexander City, AL",10760.0,2020-12-01,-20,0,-20
"Jackson, MS",27140.0,2019-01-01,-63,0,-63
"Jackson, MS",27140.0,2019-02-01,-7,0,-7
"Jackson, MS",27140.0,2019-03-01,-76,0,-76
"Jackson, MS",27140.0,2019-04-01,-13,13,-26
"Jackson, MS",27140.0,2019-05-01,-44,0,-44
"Jackson, MS",27140.0,2019-06-01,1,0,1
"Jackson, MS",27140.0,2019-07-01,42,0,42
"Jackson, MS",27140.0,2019-08-01,-29,0,-29
"Jackson, MS",27140.0,2019-09-01,-8,0,-8
"Jackson, MS",27140.0,2019-10-01,-48,0,-48
"Jackson, MS",27140.0,2019-11-01,-27,0,-27
"Jackson, MS",27140.0,2019-12-01,-36,0,-36
"Jackson, MS",27140.0,2020-01-01,-10,0,-10
"Jackson, MS",27140.0,2020-02-01,-23,0,-23
"Jackson, MS",27140.0,2020-03-01,-63,0,-63
"Jackson, MS",27140.0,2020-04-01,-36,0,-36
"Jackson, MS",27140.0,2020-05-01,-13,0,-13
"Jackson, MS",27140.0,2020-06-01,-55,0,-55
"Jackson, MS",27140.0,2020-07-01,35,0,35
"Jackson, MS",27140.0,2020-08-01,23,0,23
"Jackson, MS",27140.0,2020-09-01,-63,0,-63
"Jackson, MS",27140.0,2020-10-01,-10,0,-10
"Jackson, MS",27140.0,2020-11-01,19,0,19
"Jackson, MS",27140.0,2020-12-01,50,0,50
"Cortland, NY",18660.0,2019-01-01,-3,0,-3
"Cortland, NY",18660.0,2019-02-01,28,0,28
"Cortland, NY",18660.0,2019-03-01,-16,0,-16
"Cortland, NY",18660.0,2019-04-01,37,17,20
"Cortland, NY",18660.0,2019-05-01,-28,0,-28
"Cortland, NY",18660.0,2019-06-01,8,0,8
"Cortland, NY",18660.0,2019-07-01,-19,0,-19
"Cortland, NY",18660.0,2019-08-01,-10,0,-10
"Cortland, NY",18660.0,2019-09-01,-3,0,-3
"Cortland, NY",18660.0,2019-10-01,-62,-19,-43
"Cortland, NY",18660.0,2019-11-01,30,-12,42
"Cortland, NY",18660.0,2019-12-01,35,-12,47
"Cortland, NY",18660.0,2020-01-01,-11,0,-11
"Cortland, NY",18660.0,2020-02-01,-12,0,-12
"Cortland, NY",18660.0,2020-03-01,-7,0,-7
"Cortland, NY",18660.0,2020-04-01,1,0,1
"Cortland, NY",18660.0,2020-05-01,2,0,2
"Cortland, NY",18660.0,2020-06-01,-15,13,-28
"Cortland, NY",18660.0,2020-07-01,-36,0,-36
"Cortland, NY",18660.0,2020-08-01,-41,0,-41
"Cortland, NY",18660.0,2020-09-01,-4,0,-4
"Cortland, NY",18660.0,2020-10-01,-31,0,-31
"Cortland, NY",18660.0,2020-11-01,5,-13,18
"Cortland, NY",18660.0,2020-12-01,11,0,11
"Coshocton, OH",18740.0,2019-01-01,0,0,0
"Coshocton, OH",18740.0,2019-02-01,19,0,19
"Coshocton, OH",18740.0,2019-03-01,2,0,2
"Coshocton, OH",18740.0,2019-04-01,-9,0,-9
"Coshocton, OH",18740.0,2019-05-01,4,0,4
"Coshocton, OH",18740.0,2019-06-01,-25,0,-25
"Coshocton, OH",18740.0,2019-07-01,30,0,30
"Coshocton, OH",18740.0,2019-08-01,39,0,39
"Coshocton, OH",18740.0,2019-09-01,6,0,6
"Coshocton, OH",18740.0,2019-10-01,9,0,9
"Coshocton, OH",18740.0,2019-11-01,28,0,28
"Coshocton, OH",18740.0,2019-12-01,23,0,23
"Coshocton, OH",18740.0,2020-01-01,5,0,5
"Coshocton, OH",18740.0,2020-02-01,-6,0,-6
"Coshocton, OH",18740.0,2020-03-01,24,0,24
"Coshocton, OH",18740.0,2020-04-01,4,0,4
"Coshocton, OH",18740.0,2020-05-01,31,0,31
"Coshocton, OH",18740.0,2020-06-01,25,0,25
"Coshocton, OH",18740.0,2020-07-01,9,0,9
"Coshocton, OH",18740.0,2020-08-01,-8,0,-8
"Coshocton, OH",18740.0,2020-09-01,-16,0,-16
"Coshocton, OH",18740.0,2020-10-01,20,0,20
"Coshocton, OH",18740.0,2020-11-01,-3,0,-3
"Coshocton, OH",18740.0,2020-12-01,-15,0,-15
"Hattiesburg, MS",25620.0,2019-01-01,23,0,23
"Hattiesburg, MS",25620.0,2019-02-01,24,0,24
"Hattiesburg, MS",25620.0,2019-03-01,-33,0,-33
"Hattiesburg, MS",25620.0,2019-04-01,-14,0,-14
"Hattiesburg, MS",25620.0,2019-05-01,22,0,22
"Hattiesburg, MS",25620.0,2019-06-01,-58,0,-58
"Hattiesburg, MS",25620.0,2019-07-01,-78,0,-78
"Hattiesburg, MS",25620.0,2019-08-01,-51,0,-51
"Hattiesburg, MS",25620.0,2019-09-01,-13,0,-13
"Hattiesburg, MS",25620.0,2019-10-01,-11,0,-11
"Hattiesburg, MS",25620.0,2019-11-01,-18,0,-18
"Hattiesburg, MS",25620.0,2019-12-01,-7,0,-7
"Hattiesburg, MS",25620.0,2020-01-01,-11,0,-11
"Hattiesburg, MS",25620.0,2020-02-01,-27,0,-27
"Hattiesburg, MS",25620.0,2020-03-01,-31,0,-31
"Hattiesburg, MS",25620.0,2020-04-01,-10,0,-10
"Hattiesburg, MS",25620.0,2020-05-01,-22,0,-22
"Hattiesburg, MS",25620.0,2020-06-01,-10,0,-10
"Hattiesburg, MS",25620.0,2020-07-01,-86,0,-86
"Hattiesburg, MS",25620.0,2020-08-01,-30,0,-30
"Hattiesburg, MS",25620.0,2020-09-01,11,0,11
"Hattiesburg, MS",25620.0,2020-10-01,10,0,10
"Hattiesburg, MS",25620.0,2020-11-01,19,0,19
"Hattiesburg, MS",25620.0,2020-12-01,12,0,12
"Winfield, KS",49060.0,2019-01-01,-9,0,-9
"Winfield, KS",49060.0,2019-02-01,-1,0,-1
"Winfield, KS",49060.0,2019-03-01,-21,0,-21
"Winfield, KS",49060.0,2019-04-01,3,0,3
"Winfield, KS",49060.0,2019-05-01,1,0,1
"Winfield, KS",49060.0,2019-06-01,-15,0,-15
"Winfield, KS",49060.0,2019-07-01,-5,0,-5
"Winfield, KS",49060.0,2019-08-01,-5,0,-5
"Winfield, KS",49060.0,2019-09-01,15,0,15
"Winfield, KS",49060.0,2019-10-01,20,0,20
"Winfield, KS",49060.0,2019-11-01,-3,0,-3
"Winfield, KS",49060.0,2019-12-01,-11,0,-11
"Winfield, KS",49060.0,2020-01-01,-7,0,-7
"Winfield, KS",49060.0,2020-02-01,5,0,5
"Winfield, KS",49060.0,2020-03-01,-10,0,-10
"Winfield, KS",49060.0,2020-04-01,-9,0,-9
"Winfield, KS",49060.0,2020-05-01,-15,0,-15
"Winfield, KS",49060.0,2020-06-01,26,0,26
"Winfield, KS",49060.0,2020-07-01,12,0,12
"Winfield, KS",49060.0,2020-08-01,20,0,20
"Winfield, KS",49060.0,2020-09-01,15,0,15
"Winfield, KS",49060.0,2020-10-01,21,0,21
"Winfield, KS",49060.0,2020-11-01,-5,0,-5
"Winfield, KS",49060.0,2020-12-01,6,0,6
"Longview, WA",31020.0,2019-01-01,-8,-39,31
"Longview, WA",31020.0,2019-02-01,25,0,25
"Longview, WA",31020.0,2019-03-01,54,0,54
"Longview, WA",31020.0,2019-04-01,106,30,76
"Longview, WA",31020.0,2019-05-01,74,31,43
"Longview, WA",31020.0,2019-06-01,42,0,42
"Longview, WA",31020.0,2019-07-01,79,0,79
"Longview, WA",31020.0,2019-08-01,98,0,98
"Longview, WA",31020.0,2019-09-01,134,0,134
"Longview, WA",31020.0,2019-10-01,33,-98,131
"Longview, WA",31020.0,2019-11-01,-10,-48,38
"Longview, WA",31020.0,2019-12-01,-5,-52,47
"Longview, WA",31020.0,2020-01-01,32,-16,48
"Longview, WA",31020.0,2020-02-01,-22,0,-22
"Longview, WA",31020.0,2020-03-01,45,0,45
"Longview, WA",31020.0,2020-04-01,109,0,109
"Longview, WA",31020.0,2020-05-01,74,11,63
"Longview, WA",31020.0,2020-06-01,79,0,79
"Longview, WA",31020.0,2020-07-01,80,0,80
"Longview, WA",31020.0,2020-08-01,115,0,115
"Longview, WA",31020.0,2020-09-01,128,0,128
"Longview, WA",31020.0,2020-10-01,4,-71,75
"Longview, WA",31020.0,2020-11-01,92,-41,133
"Longview, WA",31020.0,2020-12-01,46,-17,63
"Jonesboro, AR",27860.0,2019-01-01,3,0,3
"Jonesboro, AR",27860.0,2019-02-01,31,0,31
"Jonesboro, AR",27860.0,2019-03-01,-42,0,-42
"Jonesboro, AR",27860.0,2019-04-01,-14,0,-14
"Jonesboro, AR",27860.0,2019-05-01,16,0,16
"Jonesboro, AR",27860.0,2019-06-01,-30,0,-30
"Jonesboro, AR",27860.0,2019-07-01,-28,0,-28
"Jonesboro, AR",27860.0,2019-08-01,-52,0,-52
"Jonesboro, AR",27860.0,2019-09-01,-26,0,-26
"Jonesboro, AR",27860.0,2019-10-01,3,0,3
"Jonesboro, AR",27860.0,2019-11-01,24,0,24
"Jonesboro, AR",27860.0,2019-12-01,-19,0,-19
"Jonesboro, AR",27860.0,2020-01-01,-8,0,-8
"Jonesboro, AR",27860.0,2020-02-01,5,0,5
"Jonesboro, AR",27860.0,2020-03-01,37,12,25
"Jonesboro, AR",27860.0,2020-04-01,68,0,68
"Jonesboro, AR",27860.0,2020-05-01,15,0,15
"Jonesboro, AR",27860.0,2020-06-01,4,0,4
"Jonesboro, AR",27860.0,2020-07-01,-46,0,-46
"Jonesboro, AR",27860.0,2020-08-01,-4,0,-4
"Jonesboro, AR",27860.0,2020-09-01,-36,0,-36
"Jonesboro, AR",27860.0,2020-10-01,-10,0,-10
"Jonesboro, AR",27860.0,2020-11-01,20,0,20
"Jonesboro, AR",27860.0,2020-12-01,13,0,13
"New Bern, NC",35100.0,2019-01-01,-10,0,-10
"New Bern, NC",35100.0,2019-02-01,-31,0,-31
"New Bern, NC",35100.0,2019-03-01,-40,0,-40
"New Bern, NC",35100.0,2019-04-01,22,0,22
"New Bern, NC",35100.0,2019-05-01,-12,0,-12
"New Bern, NC",35100.0,2019-06-01,-19,0,-19
"New Bern, NC",35100.0,2019-07-01,-25,0,-25
"New Bern, NC",35100.0,2019-08-01,-32,0,-32
"New Bern, NC",35100.0,2019-09-01,15,0,15
"New Bern, NC",35100.0,2019-10-01,-8,0,-8
"New Bern, NC",35100.0,2019-11-01,15,0,15
"New Bern, NC",35100.0,2019-12-01,23,0,23
"New Bern, NC",35100.0,2020-01-01,16,0,16
"New Bern, NC",35100.0,2020-02-01,9,0,9
"New Bern, NC",35100.0,2020-03-01,11,0,11
"New Bern, NC",35100.0,2020-04-01,-7,0,-7
"New Bern, NC",35100.0,2020-05-01,9,0,9
"New Bern, NC",35100.0,2020-06-01,39,0,39
"New Bern, NC",35100.0,2020-07-01,25,0,25
"New Bern, NC",35100.0,2020-08-01,11,0,11
"New Bern, NC",35100.0,2020-09-01,22,0,22
"New Bern, NC",35100.0,2020-10-01,-8,0,-8
"New Bern, NC",35100.0,2020-11-01,12,0,12
"New Bern, NC",35100.0,2020-12-01,9,0,9
"Fort Smith, AR-OK",22900.0,2019-01-01,17,0,17
"Fort Smith, AR-OK",22900.0,2019-02-01,-3,0,-3
"Fort Smith, AR-OK",22900.0,2019-03-01,-40,0,-40
"Fort Smith, AR-OK",22900.0,2019-04-01,15,0,15
"Fort Smith, AR-OK",22900.0,2019-05-01,-53,0,-53
"Fort Smith, AR-OK",22900.0,2019-06-01,-90,0,-90
"Fort Smith, AR-OK",22900.0,2019-07-01,-45,0,-45
"Fort Smith, AR-OK",22900.0,2019-08-01,-30,0,-30
"Fort Smith, AR-OK",22900.0,2019-09-01,-17,0,-17
"Fort Smith, AR-OK",22900.0,2019-10-01,-64,0,-64
"Fort Smith, AR-OK",22900.0,2019-11-01,-26,0,-26
"Fort Smith, AR-OK",22900.0,2019-12-01,-18,0,-18
"Fort Smith, AR-OK",22900.0,2020-01-01,-42,0,-42
"Fort Smith, AR-OK",22900.0,2020-02-01,-15,0,-15
"Fort Smith, AR-OK",22900.0,2020-03-01,6,0,6
"Fort Smith, AR-OK",22900.0,2020-04-01,14,0,14
"Fort Smith, AR-OK",22900.0,2020-05-01,-25,0,-25
"Fort Smith, AR-OK",22900.0,2020-06-01,-2,0,-2
"Fort Smith, AR-OK",22900.0,2020-07-01,5,0,5
"Fort Smith, AR-OK",22900.0,2020-08-01,-31,0,-31
"Fort Smith, AR-OK",22900.0,2020-09-01,15,0,15
"Fort Smith, AR-OK",22900.0,2020-10-01,-44,0,-44
"Fort Smith, AR-OK",22900.0,2020-11-01,-29,0,-29
"Fort Smith, AR-OK",22900.0,2020-12-01,2,0,2
"Pittsburg, KS",38260.0,2019-01-01,-20,0,-20
"Pittsburg, KS",38260.0,2019-02-01,7,0,7
"Pittsburg, KS",38260.0,2019-03-01,-10,0,-10
"Pittsburg, KS",38260.0,2019-04-01,1,0,1
"Pittsburg, KS",38260.0,2019-05-01,-60,0,-60
"Pittsburg, KS",38260.0,2019-06-01,-48,0,-48
"Pittsburg, KS",38260.0,2019-07-01,-29,0,-29
"Pittsburg, KS",38260.0,2019-08-01,-2,0,-2
"Pittsburg, KS",38260.0,2019-09-01,-2,0,-2
"Pittsburg, KS",38260.0,2019-10-01,30,0,30
"Pittsburg, KS",38260.0,2019-11-01,14,0,14
"Pittsburg, KS",38260.0,2019-12-01,-6,0,-6
"Pittsburg, KS",38260.0,2020-01-01,14,0,14
"Pittsburg, KS",38260.0,2020-02-01,14,0,14
"Pittsburg, KS",38260.0,2020-03-01,10,0,10
"Pittsburg, KS",38260.0,2020-04-01,18,0,18
"Pittsburg, KS",38260.0,2020-05-01,6,0,6
"Pittsburg, KS",38260.0,2020-06-01,-22,0,-22
"Pittsburg, KS",38260.0,2020-07-01,-9,0,-9
"Pittsburg, KS",38260.0,2020-08-01,29,0,29
"Pittsburg, KS",38260.0,2020-09-01,19,0,19
"Pittsburg, KS",38260.0,2020-10-01,30,0,30
"Pittsburg, KS",38260.0,2020-11-01,1,0,1
"Pittsburg, KS",38260.0,2020-12-01,0,0,0
"Bucyrus-Galion, OH",15340.0,2019-01-01,-3,0,-3
"Bucyrus-Galion, OH",15340.0,2019-02-01,-1,0,-1
"Bucyrus-Galion, OH",15340.0,2019-03-01,-29,0,-29
"Bucyrus-Galion, OH",15340.0,2019-04-01,2,0,2
"Bucyrus-Galion, OH",15340.0,2019-05-01,13,0,13
"Bucyrus-Galion, OH",15340.0,2019-06-01,21,0,21
"Bucyrus-Galion, OH",15340.0,2019-07-01,2,0,2
"Bucyrus-Galion, OH",15340.0,2019-08-01,9,0,9
"Bucyrus-Galion, OH",15340.0,2019-09-01,-11,0,-11
"Bucyrus-Galion, OH",15340.0,2019-10-01,-2,0,-2
"Bucyrus-Galion, OH",15340.0,2019-11-01,18,0,18
"Bucyrus-Galion, OH",15340.0,2019-12-01,15,0,15
"Bucyrus-Galion, OH",15340.0,2020-01-01,28,0,28
"Bucyrus-Galion, OH",15340.0,2020-02-01,-13,0,-13
"Bucyrus-Galion, OH",15340.0,2020-03-01,-39,0,-39
"Bucyrus-Galion, OH",15340.0,2020-04-01,31,0,31
"Bucyrus-Galion, OH",15340.0,2020-05-01,17,0,17
"Bucyrus-Galion, OH",15340.0,2020-06-01,-14,0,-14
"Bucyrus-Galion, OH",15340.0,2020-07-01,-6,0,-6
"Bucyrus-Galion, OH",15340.0,2020-08-01,28,0,28
"Bucyrus-Galion, OH",15340.0,2020-09-01,4,0,4
"Bucyrus-Galion, OH",15340.0,2020-10-01,11,0,11
"Bucyrus-Galion, OH",15340.0,2020-11-01,-11,0,-11
"Bucyrus-Galion, OH",15340.0,2020-12-01,18,0,18
"Meadville, PA",32740.0,2019-01-01,-21,-29,8
"Meadville, PA",32740.0,2019-02-01,33,0,33
"Meadville, PA",32740.0,2019-03-01,-11,0,-11
"Meadville, PA",32740.0,2019-04-01,24,25,-1
"Meadville, PA",32740.0,2019-05-01,4,12,-8
"Meadville, PA",32740.0,2019-06-01,12,0,12
"Meadville, PA",32740.0,2019-07-01,-4,0,-4
"Meadville, PA",32740.0,2019-08-01,-13,0,-13
"Meadville, PA",32740.0,2019-09-01,20,0,20
"Meadville, PA",32740.0,2019-10-01,-37,-44,7
"Meadville, PA",32740.0,2019-11-01,-46,-21,-25
"Meadville, PA",32740.0,2019-12-01,-51,-40,-11
"Meadville, PA",32740.0,2020-01-01,-37,-17,-20
"Meadville, PA",32740.0,2020-02-01,-14,0,-14
"Meadville, PA",32740.0,2020-03-01,4,11,-7
"Meadville, PA",32740.0,2020-04-01,-2,11,-13
"Meadville, PA",32740.0,2020-05-01,23,17,6
"Meadville, PA",32740.0,2020-06-01,43,0,43
"Meadville, PA",32740.0,2020-07-01,43,0,43
"Meadville, PA",32740.0,2020-08-01,15,0,15
"Meadville, PA",32740.0,2020-09-01,25,0,25
"Meadville, PA",32740.0,2020-10-01,-32,-27,-5
"Meadville, PA",32740.0,2020-11-01,-17,-22,5
"Meadville, PA",32740.0,2020-12-01,-63,-61,-2
"Tulsa, OK",46140.0,2019-01-01,84,-11,95
"Tulsa, OK",46140.0,2019-02-01,53,0,53
"Tulsa, OK",46140.0,2019-03-01,85,0,85
"Tulsa, OK",46140.0,2019-04-01,21,0,21
"Tulsa, OK",46140.0,2019-05-01,257,0,257
"Tulsa, OK",46140.0,2019-06-01,78,0,78
"Tulsa, OK",46140.0,2019-07-01,248,0,248
"Tulsa, OK",46140.0,2019-08-01,152,0,152
"Tulsa, OK",46140.0,2019-09-01,64,0,64
"Tulsa, OK",46140.0,2019-10-01,135,0,135
"Tulsa, OK",46140.0,2019-11-01,5,0,5
"Tulsa, OK",46140.0,2019-12-01,1,-11,12
"Tulsa, OK",46140.0,2020-01-01,152,-11,163
"Tulsa, OK",46140.0,2020-02-01,29,0,29
"Tulsa, OK",46140.0,2020-03-01,113,0,113
"Tulsa, OK",46140.0,2020-04-01,238,0,238
"Tulsa, OK",46140.0,2020-05-01,218,11,207
"Tulsa, OK",46140.0,2020-06-01,197,0,197
"Tulsa, OK",46140.0,2020-07-01,377,0,377
"Tulsa, OK",46140.0,2020-08-01,92,0,92
"Tulsa, OK",46140.0,2020-09-01,20,0,20
"Tulsa, OK",46140.0,2020-10-01,96,-12,108
"Tulsa, OK",46140.0,2020-11-01,58,0,58
"Tulsa, OK",46140.0,2020-12-01,137,0,137
"Cordele, GA",18380.0,2019-01-01,12,0,12
"Cordele, GA",18380.0,2019-02-01,0,0,0
"Cordele, GA",18380.0,2019-03-01,11,0,11
"Cordele, GA",18380.0,2019-04-01,0,0,0
"Cordele, GA",18380.0,2019-05-01,0,0,0
"Cordele, GA",18380.0,2019-06-01,0,0,0
"Cordele, GA",18380.0,2019-07-01,-17,0,-17
"Cordele, GA",18380.0,2019-08-01,0,0,0
"Cordele, GA",18380.0,2019-09-01,-20,0,-20
"Cordele, GA",18380.0,2019-10-01,9,0,9
"Cordele, GA",18380.0,2019-11-01,0,0,0
"Cordele, GA",18380.0,2019-12-01,-11,0,-11
"Cordele, GA",18380.0,2020-01-01,0,0,0
"Cordele, GA",18380.0,2020-02-01,0,0,0
"Cordele, GA",18380.0,2020-03-01,0,0,0
"Cordele, GA",18380.0,2020-04-01,-11,0,-11
"Cordele, GA",18380.0,2020-05-01,0,0,0
"Cordele, GA",18380.0,2020-06-01,-32,0,-32
"Cordele, GA",18380.0,2020-07-01,0,0,0
"Cordele, GA",18380.0,2020-08-01,0,0,0
"Cordele, GA",18380.0,2020-09-01,0,0,0
"Cordele, GA",18380.0,2020-10-01,0,0,0
"Cordele, GA",18380.0,2020-11-01,0,0,0
"Cordele, GA",18380.0,2020-12-01,0,0,0
"Memphis, TN-MS-AR",32820.0,2019-01-01,-49,0,-49
"Memphis, TN-MS-AR",32820.0,2019-02-01,-40,0,-40
"Memphis, TN-MS-AR",32820.0,2019-03-01,-10,0,-10
"Memphis, TN-MS-AR",32820.0,2019-04-01,-14,0,-14
"Memphis, TN-MS-AR",32820.0,2019-05-01,-63,0,-63
"Memphis, TN-MS-AR",32820.0,2019-06-01,-176,0,-176
"Memphis, TN-MS-AR",32820.0,2019-07-01,-132,0,-132
"Memphis, TN-MS-AR",32820.0,2019-08-01,-70,0,-70
"Memphis, TN-MS-AR",32820.0,2019-09-01,-108,0,-108
"Memphis, TN-MS-AR",32820.0,2019-10-01,-69,0,-69
"Memphis, TN-MS-AR",32820.0,2019-11-01,-46,0,-46
"Memphis, TN-MS-AR",32820.0,2019-12-01,-53,0,-53
"Memphis, TN-MS-AR",32820.0,2020-01-01,0,0,0
"Memphis, TN-MS-AR",32820.0,2020-02-01,-29,0,-29
"Memphis, TN-MS-AR",32820.0,2020-03-01,-35,-1,-34
"Memphis, TN-MS-AR",32820.0,2020-04-01,-70,12,-82
"Memphis, TN-MS-AR",32820.0,2020-05-01,-324,13,-337
"Memphis, TN-MS-AR",32820.0,2020-06-01,-32,12,-44
"Memphis, TN-MS-AR",32820.0,2020-07-01,58,0,58
"Memphis, TN-MS-AR",32820.0,2020-08-01,-121,0,-121
"Memphis, TN-MS-AR",32820.0,2020-09-01,-22,0,-22
"Memphis, TN-MS-AR",32820.0,2020-10-01,-167,0,-167
"Memphis, TN-MS-AR",32820.0,2020-11-01,-164,-18,-146
"Memphis, TN-MS-AR",32820.0,2020-12-01,-141,-16,-125
"Prineville, OR",39260.0,2019-01-01,-4,0,-4
"Prineville, OR",39260.0,2019-02-01,22,0,22
"Prineville, OR",39260.0,2019-03-01,-1,0,-1
"Prineville, OR",39260.0,2019-04-01,-11,0,-11
"Prineville, OR",39260.0,2019-05-01,37,16,21
"Prineville, OR",39260.0,2019-06-01,21,0,21
"Prineville, OR",39260.0,2019-07-01,33,0,33
"Prineville, OR",39260.0,2019-08-01,9,0,9
"Prineville, OR",39260.0,2019-09-01,12,0,12
"Prineville, OR",39260.0,2019-10-01,28,-13,41
"Prineville, OR",39260.0,2019-11-01,3,0,3
"Prineville, OR",39260.0,2019-12-01,16,0,16
"Prineville, OR",39260.0,2020-01-01,31,0,31
"Prineville, OR",39260.0,2020-02-01,16,0,16
"Prineville, OR",39260.0,2020-03-01,28,0,28
"Prineville, OR",39260.0,2020-04-01,14,0,14
"Prineville, OR",39260.0,2020-05-01,12,0,12
"Prineville, OR",39260.0,2020-06-01,45,0,45
"Prineville, OR",39260.0,2020-07-01,66,0,66
"Prineville, OR",39260.0,2020-08-01,61,0,61
"Prineville, OR",39260.0,2020-09-01,-7,0,-7
"Prineville, OR",39260.0,2020-10-01,14,-15,29
"Prineville, OR",39260.0,2020-11-01,22,0,22
"Prineville, OR",39260.0,2020-12-01,54,0,54
"Lubbock, TX",31180.0,2019-01-01,-168,0,-168
"Lubbock, TX",31180.0,2019-02-01,20,0,20
"Lubbock, TX",31180.0,2019-03-01,131,0,131
"Lubbock, TX",31180.0,2019-04-01,-11,0,-11
"Lubbock, TX",31180.0,2019-05-01,-157,0,-157
"Lubbock, TX",31180.0,2019-06-01,-200,0,-200
"Lubbock, TX",31180.0,2019-07-01,-178,0,-178
"Lubbock, TX",31180.0,2019-08-01,56,0,56
"Lubbock, TX",31180.0,2019-09-01,67,0,67
"Lubbock, TX",31180.0,2019-10-01,-32,0,-32
"Lubbock, TX",31180.0,2019-11-01,21,0,21
"Lubbock, TX",31180.0,2019-12-01,27,0,27
"Lubbock, TX",31180.0,2020-01-01,-66,0,-66
"Lubbock, TX",31180.0,2020-02-01,8,0,8
"Lubbock, TX",31180.0,2020-03-01,-46,0,-46
"Lubbock, TX",31180.0,2020-04-01,-58,0,-58
"Lubbock, TX",31180.0,2020-05-01,-49,0,-49
"Lubbock, TX",31180.0,2020-06-01,-66,0,-66
"Lubbock, TX",31180.0,2020-07-01,-52,0,-52
"Lubbock, TX",31180.0,2020-08-01,42,0,42
"Lubbock, TX",31180.0,2020-09-01,75,0,75
"Lubbock, TX",31180.0,2020-10-01,-54,0,-54
"Lubbock, TX",31180.0,2020-11-01,-20,0,-20
"Lubbock, TX",31180.0,2020-12-01,-22,0,-22
"Cullman, AL",18980.0,2019-01-01,21,0,21
"Cullman, AL",18980.0,2019-02-01,32,0,32
"Cullman, AL",18980.0,2019-03-01,14,0,14
"Cullman, AL",18980.0,2019-04-01,3,0,3
"Cullman, AL",18980.0,2019-05-01,74,0,74
"Cullman, AL",18980.0,2019-06-01,7,0,7
"Cullman, AL",18980.0,2019-07-01,50,0,50
"Cullman, AL",18980.0,2019-08-01,29,0,29
"Cullman, AL",18980.0,2019-09-01,31,0,31
"Cullman, AL",18980.0,2019-10-01,47,0,47
"Cullman, AL",18980.0,2019-11-01,7,0,7
"Cullman, AL",18980.0,2019-12-01,63,0,63
"Cullman, AL",18980.0,2020-01-01,49,0,49
"Cullman, AL",18980.0,2020-02-01,-14,0,-14
"Cullman, AL",18980.0,2020-03-01,35,0,35
"Cullman, AL",18980.0,2020-04-01,83,0,83
"Cullman, AL",18980.0,2020-05-01,28,0,28
"Cullman, AL",18980.0,2020-06-01,56,0,56
"Cullman, AL",18980.0,2020-07-01,15,0,15
"Cullman, AL",18980.0,2020-08-01,54,0,54
"Cullman, AL",18980.0,2020-09-01,86,0,86
"Cullman, AL",18980.0,2020-10-01,73,0,73
"Cullman, AL",18980.0,2020-11-01,16,0,16
"Cullman, AL",18980.0,2020-12-01,28,0,28
"Portland-South Portland, ME",38860.0,2019-01-01,-503,-596,93
"Portland-South Portland, ME",38860.0,2019-02-01,-70,-89,19
"Portland-South Portland, ME",38860.0,2019-03-01,122,-42,164
"Portland-South Portland, ME",38860.0,2019-04-01,1432,1030,402
"Portland-South Portland, ME",38860.0,2019-05-01,3083,2647,436
"Portland-South Portland, ME",38860.0,2019-06-01,1370,1130,240
"Portland-South Portland, ME",38860.0,2019-07-01,308,108,200
"Portland-South Portland, ME",38860.0,2019-08-01,207,0,207
"Portland-South Portland, ME",38860.0,2019-09-01,-333,-307,-26
"Portland-South Portland, ME",38860.0,2019-10-01,-2042,-1788,-254
"Portland-South Portland, ME",38860.0,2019-11-01,-955,-867,-88
"Portland-South Portland, ME",38860.0,2019-12-01,-824,-927,103
"Portland-South Portland, ME",38860.0,2020-01-01,-575,-692,117
"Portland-South Portland, ME",38860.0,2020-02-01,-14,-67,53
"Portland-South Portland, ME",38860.0,2020-03-01,1033,582,451
"Portland-South Portland, ME",38860.0,2020-04-01,895,588,307
"Portland-South Portland, ME",38860.0,2020-05-01,2288,1900,388
"Portland-South Portland, ME",38860.0,2020-06-01,2138,1825,313
"Portland-South Portland, ME",38860.0,2020-07-01,841,418,423
"Portland-South Portland, ME",38860.0,2020-08-01,590,122,468
"Portland-South Portland, ME",38860.0,2020-09-01,203,-121,324
"Portland-South Portland, ME",38860.0,2020-10-01,-1603,-1454,-149
"Portland-South Portland, ME",38860.0,2020-11-01,-428,-626,198
"Portland-South Portland, ME",38860.0,2020-12-01,-441,-630,189
"Fayetteville, NC",22180.0,2019-01-01,-197,0,-197
"Fayetteville, NC",22180.0,2019-02-01,-110,0,-110
"Fayetteville, NC",22180.0,2019-03-01,-130,0,-130
"Fayetteville, NC",22180.0,2019-04-01,-166,0,-166
"Fayetteville, NC",22180.0,2019-05-01,-295,0,-295
"Fayetteville, NC",22180.0,2019-06-01,-189,0,-189
"Fayetteville, NC",22180.0,2019-07-01,-4,0,-4
"Fayetteville, NC",22180.0,2019-08-01,-90,0,-90
"Fayetteville, NC",22180.0,2019-09-01,-115,0,-115
"Fayetteville, NC",22180.0,2019-10-01,-43,0,-43
"Fayetteville, NC",22180.0,2019-11-01,-89,0,-89
"Fayetteville, NC",22180.0,2019-12-01,-24,0,-24
"Fayetteville, NC",22180.0,2020-01-01,-28,0,-28
"Fayetteville, NC",22180.0,2020-02-01,-96,0,-96
"Fayetteville, NC",22180.0,2020-03-01,-155,-28,-127
"Fayetteville, NC",22180.0,2020-04-01,-71,0,-71
"Fayetteville, NC",22180.0,2020-05-01,-68,0,-68
"Fayetteville, NC",22180.0,2020-06-01,140,0,140
"Fayetteville, NC",22180.0,2020-07-01,-158,0,-158
"Fayetteville, NC",22180.0,2020-08-01,-159,0,-159
"Fayetteville, NC",22180.0,2020-09-01,-83,0,-83
"Fayetteville, NC",22180.0,2020-10-01,-93,0,-93
"Fayetteville, NC",22180.0,2020-11-01,-65,0,-65
"Fayetteville, NC",22180.0,2020-12-01,-73,0,-73
"Vineland-Bridgeton, NJ",47220.0,2019-01-01,-93,0,-93
"Vineland-Bridgeton, NJ",47220.0,2019-02-01,7,0,7
"Vineland-Bridgeton, NJ",47220.0,2019-03-01,-29,0,-29
"Vineland-Bridgeton, NJ",47220.0,2019-04-01,-23,0,-23
"Vineland-Bridgeton, NJ",47220.0,2019-05-01,9,0,9
"Vineland-Bridgeton, NJ",47220.0,2019-06-01,-29,0,-29
"Vineland-Bridgeton, NJ",47220.0,2019-07-01,-2,0,-2
"Vineland-Bridgeton, NJ",47220.0,2019-08-01,-45,0,-45
"Vineland-Bridgeton, NJ",47220.0,2019-09-01,-63,0,-63
"Vineland-Bridgeton, NJ",47220.0,2019-10-01,16,0,16
"Vineland-Bridgeton, NJ",47220.0,2019-11-01,-59,0,-59
"Vineland-Bridgeton, NJ",47220.0,2019-12-01,-24,-11,-13
"Vineland-Bridgeton, NJ",47220.0,2020-01-01,29,0,29
"Vineland-Bridgeton, NJ",47220.0,2020-02-01,-36,0,-36
"Vineland-Bridgeton, NJ",47220.0,2020-03-01,-38,0,-38
"Vineland-Bridgeton, NJ",47220.0,2020-04-01,6,0,6
"Vineland-Bridgeton, NJ",47220.0,2020-05-01,-32,0,-32
"Vineland-Bridgeton, NJ",47220.0,2020-06-01,34,16,18
"Vineland-Bridgeton, NJ",47220.0,2020-07-01,56,0,56
"Vineland-Bridgeton, NJ",47220.0,2020-08-01,-15,0,-15
"Vineland-Bridgeton, NJ",47220.0,2020-09-01,-40,15,-55
"Vineland-Bridgeton, NJ",47220.0,2020-10-01,31,0,31
"Vineland-Bridgeton, NJ",47220.0,2020-11-01,19,0,19
"Vineland-Bridgeton, NJ",47220.0,2020-12-01,80,0,80
"Harrisburg-Carlisle, PA",25420.0,2019-01-01,-116,-98,-18
"Harrisburg-Carlisle, PA",25420.0,2019-02-01,80,0,80
"Harrisburg-Carlisle, PA",25420.0,2019-03-01,11,0,11
"Harrisburg-Carlisle, PA",25420.0,2019-04-01,167,93,74
"Harrisburg-Carlisle, PA",25420.0,2019-05-01,88,-1,89
"Harrisburg-Carlisle, PA",25420.0,2019-06-01,-142,0,-142
"Harrisburg-Carlisle, PA",25420.0,2019-07-01,155,0,155
"Harrisburg-Carlisle, PA",25420.0,2019-08-01,148,0,148
"Harrisburg-Carlisle, PA",25420.0,2019-09-01,99,0,99
"Harrisburg-Carlisle, PA",25420.0,2019-10-01,25,-68,93
"Harrisburg-Carlisle, PA",25420.0,2019-11-01,-137,-29,-108
"Harrisburg-Carlisle, PA",25420.0,2019-12-01,-89,-120,31
"Harrisburg-Carlisle, PA",25420.0,2020-01-01,-151,-155,4
"Harrisburg-Carlisle, PA",25420.0,2020-02-01,58,-13,71
"Harrisburg-Carlisle, PA",25420.0,2020-03-01,82,5,77
"Harrisburg-Carlisle, PA",25420.0,2020-04-01,79,4,75
"Harrisburg-Carlisle, PA",25420.0,2020-05-01,39,38,1
"Harrisburg-Carlisle, PA",25420.0,2020-06-01,76,-19,95
"Harrisburg-Carlisle, PA",25420.0,2020-07-01,124,-12,136
"Harrisburg-Carlisle, PA",25420.0,2020-08-01,147,0,147
"Harrisburg-Carlisle, PA",25420.0,2020-09-01,263,0,263
"Harrisburg-Carlisle, PA",25420.0,2020-10-01,11,-55,66
"Harrisburg-Carlisle, PA",25420.0,2020-11-01,76,-24,100
"Harrisburg-Carlisle, PA",25420.0,2020-12-01,-98,-127,29
"Crossville, TN",18900.0,2019-01-01,-7,-11,4
"Crossville, TN",18900.0,2019-02-01,2,0,2
"Crossville, TN",18900.0,2019-03-01,2,0,2
"Crossville, TN",18900.0,2019-04-01,30,11,19
"Crossville, TN",18900.0,2019-05-01,-22,13,-35
"Crossville, TN",18900.0,2019-06-01,-4,0,-4
"Crossville, TN",18900.0,2019-07-01,-8,0,-8
"Crossville, TN",18900.0,2019-08-01,-3,0,-3
"Crossville, TN",18900.0,2019-09-01,-3,0,-3
"Crossville, TN",18900.0,2019-10-01,-28,0,-28
"Crossville, TN",18900.0,2019-11-01,-57,-25,-32
"Crossville, TN",18900.0,2019-12-01,-34,-17,-17
"Crossville, TN",18900.0,2020-01-01,12,0,12
"Crossville, TN",18900.0,2020-02-01,7,0,7
"Crossville, TN",18900.0,2020-03-01,1,0,1
"Crossville, TN",18900.0,2020-04-01,-3,0,-3
"Crossville, TN",18900.0,2020-05-01,-1,0,-1
"Crossville, TN",18900.0,2020-06-01,44,0,44
"Crossville, TN",18900.0,2020-07-01,4,0,4
"Crossville, TN",18900.0,2020-08-01,-13,0,-13
"Crossville, TN",18900.0,2020-09-01,-11,0,-11
"Crossville, TN",18900.0,2020-10-01,37,0,37
"Crossville, TN",18900.0,2020-11-01,-1,0,-1
"Crossville, TN",18900.0,2020-12-01,-4,-12,8
"Clovis, NM",17580.0,2019-01-01,20,0,20
"Clovis, NM",17580.0,2019-02-01,17,0,17
"Clovis, NM",17580.0,2019-03-01,35,0,35
"Clovis, NM",17580.0,2019-04-01,16,0,16
"Clovis, NM",17580.0,2019-05-01,44,0,44
"Clovis, NM",17580.0,2019-06-01,-31,0,-31
"Clovis, NM",17580.0,2019-07-01,-18,0,-18
"Clovis, NM",17580.0,2019-08-01,6,0,6
"Clovis, NM",17580.0,2019-09-01,-20,0,-20
"Clovis, NM",17580.0,2019-10-01,40,0,40
"Clovis, NM",17580.0,2019-11-01,16,0,16
"Clovis, NM",17580.0,2019-12-01,30,0,30
"Clovis, NM",17580.0,2020-01-01,13,0,13
"Clovis, NM",17580.0,2020-02-01,26,0,26
"Clovis, NM",17580.0,2020-03-01,42,0,42
"Clovis, NM",17580.0,2020-04-01,-17,0,-17
"Clovis, NM",17580.0,2020-05-01,31,0,31
"Clovis, NM",17580.0,2020-06-01,21,0,21
"Clovis, NM",17580.0,2020-07-01,25,0,25
"Clovis, NM",17580.0,2020-08-01,-2,0,-2
"Clovis, NM",17580.0,2020-09-01,15,0,15
"Clovis, NM",17580.0,2020-10-01,21,0,21
"Clovis, NM",17580.0,2020-11-01,22,0,22
"Clovis, NM",17580.0,2020-12-01,42,0,42
"Brookings, OR",15060.0,2019-01-01,-15,0,-15
"Brookings, OR",15060.0,2019-02-01,-2,0,-2
"Brookings, OR",15060.0,2019-03-01,0,0,0
"Brookings, OR",15060.0,2019-04-01,23,11,12
"Brookings, OR",15060.0,2019-05-01,-13,18,-31
"Brookings, OR",15060.0,2019-06-01,15,15,0
"Brookings, OR",15060.0,2019-07-01,-1,0,-1
"Brookings, OR",15060.0,2019-08-01,-22,0,-22
"Brookings, OR",15060.0,2019-09-01,39,0,39
"Brookings, OR",15060.0,2019-10-01,14,-11,25
"Brookings, OR",15060.0,2019-11-01,0,0,0
"Brookings, OR",15060.0,2019-12-01,-13,0,-13
"Brookings, OR",15060.0,2020-01-01,0,0,0
"Brookings, OR",15060.0,2020-02-01,-11,0,-11
"Brookings, OR",15060.0,2020-03-01,12,0,12
"Brookings, OR",15060.0,2020-04-01,11,11,0
"Brookings, OR",15060.0,2020-05-01,8,20,-12
"Brookings, OR",15060.0,2020-06-01,25,13,12
"Brookings, OR",15060.0,2020-07-01,0,0,0
"Brookings, OR",15060.0,2020-08-01,0,0,0
"Brookings, OR",15060.0,2020-09-01,14,0,14
"Brookings, OR",15060.0,2020-10-01,17,0,17
"Brookings, OR",15060.0,2020-11-01,-11,0,-11
"Brookings, OR",15060.0,2020-12-01,0,0,0
"Weatherford, OK",48220.0,2019-01-01,-18,0,-18
"Weatherford, OK",48220.0,2019-02-01,-10,0,-10
"Weatherford, OK",48220.0,2019-03-01,-9,0,-9
"Weatherford, OK",48220.0,2019-04-01,-9,0,-9
"Weatherford, OK",48220.0,2019-05-01,-73,0,-73
"Weatherford, OK",48220.0,2019-06-01,-15,0,-15
"Weatherford, OK",48220.0,2019-07-01,-52,0,-52
"Weatherford, OK",48220.0,2019-08-01,-7,0,-7
"Weatherford, OK",48220.0,2019-09-01,-2,0,-2
"Weatherford, OK",48220.0,2019-10-01,-27,0,-27
"Weatherford, OK",48220.0,2019-11-01,-50,0,-50
"Weatherford, OK",48220.0,2019-12-01,-31,0,-31
"Weatherford, OK",48220.0,2020-01-01,0,0,0
"Weatherford, OK",48220.0,2020-02-01,-29,0,-29
"Weatherford, OK",48220.0,2020-03-01,-44,0,-44
"Weatherford, OK",48220.0,2020-04-01,-41,0,-41
"Weatherford, OK",48220.0,2020-05-01,-14,0,-14
"Weatherford, OK",48220.0,2020-06-01,-28,0,-28
"Weatherford, OK",48220.0,2020-07-01,-46,0,-46
"Weatherford, OK",48220.0,2020-08-01,6,0,6
"Weatherford, OK",48220.0,2020-09-01,18,0,18
"Weatherford, OK",48220.0,2020-10-01,-28,0,-28
"Weatherford, OK",48220.0,2020-11-01,-27,0,-27
"Weatherford, OK",48220.0,2020-12-01,-8,0,-8
"Cleveland-Elyria, OH",17460.0,2019-01-01,-1594,-1547,-47
"Cleveland-Elyria, OH",17460.0,2019-02-01,-286,-173,-113
"Cleveland-Elyria, OH",17460.0,2019-03-01,-47,-1,-46
"Cleveland-Elyria, OH",17460.0,2019-04-01,1409,906,503
"Cleveland-Elyria, OH",17460.0,2019-05-01,1564,1385,179
"Cleveland-Elyria, OH",17460.0,2019-06-01,-354,167,-521
"Cleveland-Elyria, OH",17460.0,2019-07-01,-224,34,-258
"Cleveland-Elyria, OH",17460.0,2019-08-01,-232,26,-258
"Cleveland-Elyria, OH",17460.0,2019-09-01,-339,-82,-257
"Cleveland-Elyria, OH",17460.0,2019-10-01,-1066,-828,-238
"Cleveland-Elyria, OH",17460.0,2019-11-01,-676,-629,-47
"Cleveland-Elyria, OH",17460.0,2019-12-01,-1566,-1432,-134
"Cleveland-Elyria, OH",17460.0,2020-01-01,-1672,-1476,-196
"Cleveland-Elyria, OH",17460.0,2020-02-01,-101,-82,-19
"Cleveland-Elyria, OH",17460.0,2020-03-01,546,300,246
"Cleveland-Elyria, OH",17460.0,2020-04-01,678,414,264
"Cleveland-Elyria, OH",17460.0,2020-05-01,1232,958,274
"Cleveland-Elyria, OH",17460.0,2020-06-01,535,500,35
"Cleveland-Elyria, OH",17460.0,2020-07-01,86,162,-76
"Cleveland-Elyria, OH",17460.0,2020-08-01,-87,48,-135
"Cleveland-Elyria, OH",17460.0,2020-09-01,-317,6,-323
"Cleveland-Elyria, OH",17460.0,2020-10-01,-1055,-727,-328
"Cleveland-Elyria, OH",17460.0,2020-11-01,-863,-652,-211
"Cleveland-Elyria, OH",17460.0,2020-12-01,-1291,-1143,-148
"Sioux City, IA-NE-SD",43580.0,2019-01-01,-56,-24,-32
"Sioux City, IA-NE-SD",43580.0,2019-02-01,-57,0,-57
"Sioux City, IA-NE-SD",43580.0,2019-03-01,-10,0,-10
"Sioux City, IA-NE-SD",43580.0,2019-04-01,24,33,-9
"Sioux City, IA-NE-SD",43580.0,2019-05-01,-56,13,-69
"Sioux City, IA-NE-SD",43580.0,2019-06-01,-37,0,-37
"Sioux City, IA-NE-SD",43580.0,2019-07-01,-32,0,-32
"Sioux City, IA-NE-SD",43580.0,2019-08-01,-22,0,-22
"Sioux City, IA-NE-SD",43580.0,2019-09-01,-36,0,-36
"Sioux City, IA-NE-SD",43580.0,2019-10-01,11,-28,39
"Sioux City, IA-NE-SD",43580.0,2019-11-01,-35,-49,14
"Sioux City, IA-NE-SD",43580.0,2019-12-01,-99,-94,-5
"Sioux City, IA-NE-SD",43580.0,2020-01-01,-62,-21,-41
"Sioux City, IA-NE-SD",43580.0,2020-02-01,-7,0,-7
"Sioux City, IA-NE-SD",43580.0,2020-03-01,17,0,17
"Sioux City, IA-NE-SD",43580.0,2020-04-01,-11,0,-11
"Sioux City, IA-NE-SD",43580.0,2020-05-01,-79,0,-79
"Sioux City, IA-NE-SD",43580.0,2020-06-01,-22,0,-22
"Sioux City, IA-NE-SD",43580.0,2020-07-01,-14,0,-14
"Sioux City, IA-NE-SD",43580.0,2020-08-01,-4,0,-4
"Sioux City, IA-NE-SD",43580.0,2020-09-01,-9,0,-9
"Sioux City, IA-NE-SD",43580.0,2020-10-01,-31,-41,10
"Sioux City, IA-NE-SD",43580.0,2020-11-01,-20,-29,9
"Sioux City, IA-NE-SD",43580.0,2020-12-01,-69,-40,-29
"Ozark, AL",37120.0,2019-01-01,36,0,36
"Ozark, AL",37120.0,2019-02-01,-5,0,-5
"Ozark, AL",37120.0,2019-03-01,-13,0,-13
"Ozark, AL",37120.0,2019-04-01,27,0,27
"Ozark, AL",37120.0,2019-05-01,7,0,7
"Ozark, AL",37120.0,2019-06-01,2,0,2
"Ozark, AL",37120.0,2019-07-01,6,0,6
"Ozark, AL",37120.0,2019-08-01,-69,0,-69
"Ozark, AL",37120.0,2019-09-01,-20,0,-20
"Ozark, AL",37120.0,2019-10-01,-14,0,-14
"Ozark, AL",37120.0,2019-11-01,5,0,5
"Ozark, AL",37120.0,2019-12-01,24,0,24
"Ozark, AL",37120.0,2020-01-01,3,0,3
"Ozark, AL",37120.0,2020-02-01,-8,0,-8
"Ozark, AL",37120.0,2020-03-01,-4,0,-4
"Ozark, AL",37120.0,2020-04-01,43,0,43
"Ozark, AL",37120.0,2020-05-01,-1,0,-1
"Ozark, AL",37120.0,2020-06-01,21,0,21
"Ozark, AL",37120.0,2020-07-01,3,0,3
"Ozark, AL",37120.0,2020-08-01,46,0,46
"Ozark, AL",37120.0,2020-09-01,3,0,3
"Ozark, AL",37120.0,2020-10-01,21,0,21
"Ozark, AL",37120.0,2020-11-01,16,0,16
"Ozark, AL",37120.0,2020-12-01,24,0,24
"Selma, AL",42820.0,2019-01-01,-29,0,-29
"Selma, AL",42820.0,2019-02-01,0,0,0
"Selma, AL",42820.0,2019-03-01,13,0,13
"Selma, AL",42820.0,2019-04-01,-14,0,-14
"Selma, AL",42820.0,2019-05-01,-29,0,-29
"Selma, AL",42820.0,2019-06-01,-18,0,-18
"Selma, AL",42820.0,2019-07-01,-32,0,-32
"Selma, AL",42820.0,2019-08-01,0,0,0
"Selma, AL",42820.0,2019-09-01,0,0,0
"Selma, AL",42820.0,2019-10-01,0,0,0
"Selma, AL",42820.0,2019-11-01,0,0,0
"Selma, AL",42820.0,2019-12-01,-15,0,-15
"Selma, AL",42820.0,2020-01-01,-4,0,-4
"Selma, AL",42820.0,2020-02-01,0,0,0
"Selma, AL",42820.0,2020-03-01,2,0,2
"Selma, AL",42820.0,2020-04-01,12,0,12
"Selma, AL",42820.0,2020-05-01,-11,0,-11
"Selma, AL",42820.0,2020-06-01,-12,0,-12
"Selma, AL",42820.0,2020-07-01,0,0,0
"Selma, AL",42820.0,2020-08-01,-36,0,-36
"Selma, AL",42820.0,2020-09-01,-12,0,-12
"Selma, AL",42820.0,2020-10-01,18,0,18
"Selma, AL",42820.0,2020-11-01,0,0,0
"Selma, AL",42820.0,2020-12-01,-18,0,-18
"Des Moines-West Des Moines, IA",19780.0,2019-01-01,-151,-251,100
"Des Moines-West Des Moines, IA",19780.0,2019-02-01,37,-34,71
"Des Moines-West Des Moines, IA",19780.0,2019-03-01,136,23,113
"Des Moines-West Des Moines, IA",19780.0,2019-04-01,578,306,272
"Des Moines-West Des Moines, IA",19780.0,2019-05-01,464,209,255
"Des Moines-West Des Moines, IA",19780.0,2019-06-01,174,25,149
"Des Moines-West Des Moines, IA",19780.0,2019-07-01,524,37,487
"Des Moines-West Des Moines, IA",19780.0,2019-08-01,239,0,239
"Des Moines-West Des Moines, IA",19780.0,2019-09-01,87,-12,99
"Des Moines-West Des Moines, IA",19780.0,2019-10-01,-417,-447,30
"Des Moines-West Des Moines, IA",19780.0,2019-11-01,-207,-288,81
"Des Moines-West Des Moines, IA",19780.0,2019-12-01,-468,-521,53
"Des Moines-West Des Moines, IA",19780.0,2020-01-01,-226,-325,99
"Des Moines-West Des Moines, IA",19780.0,2020-02-01,-4,-21,17
"Des Moines-West Des Moines, IA",19780.0,2020-03-01,480,69,411
"Des Moines-West Des Moines, IA",19780.0,2020-04-01,390,134,256
"Des Moines-West Des Moines, IA",19780.0,2020-05-01,378,129,249
"Des Moines-West Des Moines, IA",19780.0,2020-06-01,229,38,191
"Des Moines-West Des Moines, IA",19780.0,2020-07-01,619,22,597
"Des Moines-West Des Moines, IA",19780.0,2020-08-01,80,-28,108
"Des Moines-West Des Moines, IA",19780.0,2020-09-01,51,-12,63
"Des Moines-West Des Moines, IA",19780.0,2020-10-01,-319,-350,31
"Des Moines-West Des Moines, IA",19780.0,2020-11-01,-271,-307,36
"Des Moines-West Des Moines, IA",19780.0,2020-12-01,-319,-387,68
"Danville, VA",19260.0,2019-01-01,-29,0,-29
"Danville, VA",19260.0,2019-02-01,-11,0,-11
"Danville, VA",19260.0,2019-03-01,14,0,14
"Danville, VA",19260.0,2019-04-01,-11,0,-11
"Danville, VA",19260.0,2019-05-01,-11,0,-11
"Danville, VA",19260.0,2019-06-01,-43,0,-43
"Danville, VA",19260.0,2019-07-01,-9,0,-9
"Danville, VA",19260.0,2019-08-01,-4,0,-4
"Danville, VA",19260.0,2019-09-01,11,0,11
"Danville, VA",19260.0,2019-10-01,23,0,23
"Danville, VA",19260.0,2019-11-01,0,0,0
"Danville, VA",19260.0,2019-12-01,0,0,0
"Danville, VA",19260.0,2020-01-01,0,0,0
"Danville, VA",19260.0,2020-02-01,0,0,0
"Danville, VA",19260.0,2020-03-01,21,0,21
"Danville, VA",19260.0,2020-04-01,-12,0,-12
"Danville, VA",19260.0,2020-05-01,-22,0,-22
"Danville, VA",19260.0,2020-06-01,-20,0,-20
"Danville, VA",19260.0,2020-07-01,27,0,27
"Danville, VA",19260.0,2020-08-01,-20,0,-20
"Danville, VA",19260.0,2020-09-01,-13,0,-13
"Danville, VA",19260.0,2020-10-01,5,0,5
"Danville, VA",19260.0,2020-11-01,-11,0,-11
"Danville, VA",19260.0,2020-12-01,-24,0,-24
"Kill Devil Hills, NC",28620.0,2019-01-01,-14,-12,-2
"Kill Devil Hills, NC",28620.0,2019-02-01,-5,0,-5
"Kill Devil Hills, NC",28620.0,2019-03-01,-5,0,-5
"Kill Devil Hills, NC",28620.0,2019-04-01,8,23,-15
"Kill Devil Hills, NC",28620.0,2019-05-01,10,12,-2
"Kill Devil Hills, NC",28620.0,2019-06-01,-3,0,-3
"Kill Devil Hills, NC",28620.0,2019-07-01,-14,0,-14
"Kill Devil Hills, NC",28620.0,2019-08-01,7,0,7
"Kill Devil Hills, NC",28620.0,2019-09-01,0,0,0
"Kill Devil Hills, NC",28620.0,2019-10-01,-15,0,-15
"Kill Devil Hills, NC",28620.0,2019-11-01,0,0,0
"Kill Devil Hills, NC",28620.0,2019-12-01,-13,0,-13
"Kill Devil Hills, NC",28620.0,2020-01-01,-16,0,-16
"Kill Devil Hills, NC",28620.0,2020-02-01,-4,0,-4
"Kill Devil Hills, NC",28620.0,2020-03-01,-11,0,-11
"Kill Devil Hills, NC",28620.0,2020-04-01,-7,11,-18
"Kill Devil Hills, NC",28620.0,2020-05-01,-4,0,-4
"Kill Devil Hills, NC",28620.0,2020-06-01,-2,0,-2
"Kill Devil Hills, NC",28620.0,2020-07-01,-5,0,-5
"Kill Devil Hills, NC",28620.0,2020-08-01,0,0,0
"Kill Devil Hills, NC",28620.0,2020-09-01,14,0,14
"Kill Devil Hills, NC",28620.0,2020-10-01,2,0,2
"Kill Devil Hills, NC",28620.0,2020-11-01,-11,0,-11
"Kill Devil Hills, NC",28620.0,2020-12-01,-3,0,-3
"Greenville, OH",24820.0,2019-01-01,-14,0,-14
"Greenville, OH",24820.0,2019-02-01,19,0,19
"Greenville, OH",24820.0,2019-03-01,-31,0,-31
"Greenville, OH",24820.0,2019-04-01,14,0,14
"Greenville, OH",24820.0,2019-05-01,-17,0,-17
"Greenville, OH",24820.0,2019-06-01,13,0,13
"Greenville, OH",24820.0,2019-07-01,-9,0,-9
"Greenville, OH",24820.0,2019-08-01,14,0,14
"Greenville, OH",24820.0,2019-09-01,9,0,9
"Greenville, OH",24820.0,2019-10-01,-13,0,-13
"Greenville, OH",24820.0,2019-11-01,5,0,5
"Greenville, OH",24820.0,2019-12-01,9,-11,20
"Greenville, OH",24820.0,2020-01-01,-3,0,-3
"Greenville, OH",24820.0,2020-02-01,5,0,5
"Greenville, OH",24820.0,2020-03-01,-3,0,-3
"Greenville, OH",24820.0,2020-04-01,-10,0,-10
"Greenville, OH",24820.0,2020-05-01,31,0,31
"Greenville, OH",24820.0,2020-06-01,-4,0,-4
"Greenville, OH",24820.0,2020-07-01,-5,0,-5
"Greenville, OH",24820.0,2020-08-01,40,0,40
"Greenville, OH",24820.0,2020-09-01,-7,0,-7
"Greenville, OH",24820.0,2020-10-01,13,0,13
"Greenville, OH",24820.0,2020-11-01,22,0,22
"Greenville, OH",24820.0,2020-12-01,11,0,11
"Florence, SC",22500.0,2019-01-01,66,0,66
"Florence, SC",22500.0,2019-02-01,52,0,52
"Florence, SC",22500.0,2019-03-01,-48,0,-48
"Florence, SC",22500.0,2019-04-01,10,0,10
"Florence, SC",22500.0,2019-05-01,-13,0,-13
"Florence, SC",22500.0,2019-06-01,-1,0,-1
"Florence, SC",22500.0,2019-07-01,-5,0,-5
"Florence, SC",22500.0,2019-08-01,35,0,35
"Florence, SC",22500.0,2019-09-01,-14,0,-14
"Florence, SC",22500.0,2019-10-01,-24,0,-24
"Florence, SC",22500.0,2019-11-01,-35,0,-35
"Florence, SC",22500.0,2019-12-01,-14,0,-14
"Florence, SC",22500.0,2020-01-01,-6,0,-6
"Florence, SC",22500.0,2020-02-01,-2,0,-2
"Florence, SC",22500.0,2020-03-01,37,0,37
"Florence, SC",22500.0,2020-04-01,45,0,45
"Florence, SC",22500.0,2020-05-01,-27,0,-27
"Florence, SC",22500.0,2020-06-01,-7,0,-7
"Florence, SC",22500.0,2020-07-01,19,0,19
"Florence, SC",22500.0,2020-08-01,-22,0,-22
"Florence, SC",22500.0,2020-09-01,13,0,13
"Florence, SC",22500.0,2020-10-01,-1,0,-1
"Florence, SC",22500.0,2020-11-01,-11,0,-11
"Florence, SC",22500.0,2020-12-01,-44,0,-44
"Winston-Salem, NC",49180.0,2019-01-01,-16,0,-16
"Winston-Salem, NC",49180.0,2019-02-01,54,0,54
"Winston-Salem, NC",49180.0,2019-03-01,32,0,32
"Winston-Salem, NC",49180.0,2019-04-01,76,11,65
"Winston-Salem, NC",49180.0,2019-05-01,16,0,16
"Winston-Salem, NC",49180.0,2019-06-01,118,0,118
"Winston-Salem, NC",49180.0,2019-07-01,101,0,101
"Winston-Salem, NC",49180.0,2019-08-01,15,0,15
"Winston-Salem, NC",49180.0,2019-09-01,-35,0,-35
"Winston-Salem, NC",49180.0,2019-10-01,35,0,35
"Winston-Salem, NC",49180.0,2019-11-01,-3,0,-3
"Winston-Salem, NC",49180.0,2019-12-01,3,0,3
"Winston-Salem, NC",49180.0,2020-01-01,10,0,10
"Winston-Salem, NC",49180.0,2020-02-01,100,0,100
"Winston-Salem, NC",49180.0,2020-03-01,-10,12,-22
"Winston-Salem, NC",49180.0,2020-04-01,144,1,143
"Winston-Salem, NC",49180.0,2020-05-01,112,23,89
"Winston-Salem, NC",49180.0,2020-06-01,144,0,144
"Winston-Salem, NC",49180.0,2020-07-01,133,0,133
"Winston-Salem, NC",49180.0,2020-08-01,183,11,172
"Winston-Salem, NC",49180.0,2020-09-01,211,0,211
"Winston-Salem, NC",49180.0,2020-10-01,18,0,18
"Winston-Salem, NC",49180.0,2020-11-01,9,0,9
"Winston-Salem, NC",49180.0,2020-12-01,192,-1,193
"Washington, IN",47780.0,2019-01-01,-15,0,-15
"Washington, IN",47780.0,2019-02-01,-3,0,-3
"Washington, IN",47780.0,2019-03-01,-24,0,-24
"Washington, IN",47780.0,2019-04-01,-31,0,-31
"Washington, IN",47780.0,2019-05-01,-21,0,-21
"Washington, IN",47780.0,2019-06-01,-14,0,-14
"Washington, IN",47780.0,2019-07-01,5,0,5
"Washington, IN",47780.0,2019-08-01,3,0,3
"Washington, IN",47780.0,2019-09-01,-17,0,-17
"Washington, IN",47780.0,2019-10-01,-30,0,-30
"Washington, IN",47780.0,2019-11-01,15,0,15
"Washington, IN",47780.0,2019-12-01,-13,-11,-2
"Washington, IN",47780.0,2020-01-01,-17,0,-17
"Washington, IN",47780.0,2020-02-01,28,0,28
"Washington, IN",47780.0,2020-03-01,-17,0,-17
"Washington, IN",47780.0,2020-04-01,23,0,23
"Washington, IN",47780.0,2020-05-01,-20,0,-20
"Washington, IN",47780.0,2020-06-01,-16,0,-16
"Washington, IN",47780.0,2020-07-01,3,0,3
"Washington, IN",47780.0,2020-08-01,-7,0,-7
"Washington, IN",47780.0,2020-09-01,3,0,3
"Washington, IN",47780.0,2020-10-01,13,0,13
"Washington, IN",47780.0,2020-11-01,6,0,6
"Washington, IN",47780.0,2020-12-01,-24,-13,-11
"Owensboro, KY",36980.0,2019-01-01,-39,0,-39
"Owensboro, KY",36980.0,2019-02-01,-20,0,-20
"Owensboro, KY",36980.0,2019-03-01,-4,0,-4
"Owensboro, KY",36980.0,2019-04-01,-25,0,-25
"Owensboro, KY",36980.0,2019-05-01,36,0,36
"Owensboro, KY",36980.0,2019-06-01,4,0,4
"Owensboro, KY",36980.0,2019-07-01,-5,0,-5
"Owensboro, KY",36980.0,2019-08-01,-18,0,-18
"Owensboro, KY",36980.0,2019-09-01,-11,0,-11
"Owensboro, KY",36980.0,2019-10-01,-42,0,-42
"Owensboro, KY",36980.0,2019-11-01,16,0,16
"Owensboro, KY",36980.0,2019-12-01,12,0,12
"Owensboro, KY",36980.0,2020-01-01,-4,0,-4
"Owensboro, KY",36980.0,2020-02-01,20,0,20
"Owensboro, KY",36980.0,2020-03-01,32,0,32
"Owensboro, KY",36980.0,2020-04-01,-15,0,-15
"Owensboro, KY",36980.0,2020-05-01,-29,0,-29
"Owensboro, KY",36980.0,2020-06-01,-15,0,-15
"Owensboro, KY",36980.0,2020-07-01,3,0,3
"Owensboro, KY",36980.0,2020-08-01,-35,0,-35
"Owensboro, KY",36980.0,2020-09-01,-4,0,-4
"Owensboro, KY",36980.0,2020-10-01,-16,0,-16
"Owensboro, KY",36980.0,2020-11-01,16,0,16
"Owensboro, KY",36980.0,2020-12-01,-17,0,-17
"Mitchell, SD",33580.0,2019-01-01,0,0,0
"Mitchell, SD",33580.0,2019-02-01,0,0,0
"Mitchell, SD",33580.0,2019-03-01,0,0,0
"Mitchell, SD",33580.0,2019-04-01,-12,0,-12
"Mitchell, SD",33580.0,2019-05-01,0,0,0
"Mitchell, SD",33580.0,2019-06-01,-20,0,-20
"Mitchell, SD",33580.0,2019-07-01,0,0,0
"Mitchell, SD",33580.0,2019-08-01,-1,0,-1
"Mitchell, SD",33580.0,2019-09-01,-11,0,-11
"Mitchell, SD",33580.0,2019-10-01,0,0,0
"Mitchell, SD",33580.0,2019-11-01,0,0,0
"Mitchell, SD",33580.0,2019-12-01,0,0,0
"Mitchell, SD",33580.0,2020-01-01,0,0,0
"Mitchell, SD",33580.0,2020-02-01,0,0,0
"Mitchell, SD",33580.0,2020-03-01,-15,0,-15
"Mitchell, SD",33580.0,2020-04-01,0,0,0
"Mitchell, SD",33580.0,2020-05-01,-16,0,-16
"Mitchell, SD",33580.0,2020-06-01,0,0,0
"Mitchell, SD",33580.0,2020-07-01,0,0,0
"Mitchell, SD",33580.0,2020-08-01,-22,0,-22
"Mitchell, SD",33580.0,2020-09-01,0,0,0
"Mitchell, SD",33580.0,2020-10-01,0,0,0
"Mitchell, SD",33580.0,2020-11-01,-15,0,-15
"Mitchell, SD",33580.0,2020-12-01,0,0,0
"Lexington, NE",30420.0,2019-01-01,13,0,13
"Lexington, NE",30420.0,2019-02-01,0,0,0
"Lexington, NE",30420.0,2019-03-01,-21,0,-21
"Lexington, NE",30420.0,2019-04-01,-18,0,-18
"Lexington, NE",30420.0,2019-05-01,-5,0,-5
"Lexington, NE",30420.0,2019-06-01,0,0,0
"Lexington, NE",30420.0,2019-07-01,-2,0,-2
"Lexington, NE",30420.0,2019-08-01,-14,0,-14
"Lexington, NE",30420.0,2019-09-01,-29,0,-29
"Lexington, NE",30420.0,2019-10-01,-40,0,-40
"Lexington, NE",30420.0,2019-11-01,12,0,12
"Lexington, NE",30420.0,2019-12-01,-13,0,-13
"Lexington, NE",30420.0,2020-01-01,0,0,0
"Lexington, NE",30420.0,2020-02-01,0,0,0
"Lexington, NE",30420.0,2020-03-01,-11,0,-11
"Lexington, NE",30420.0,2020-04-01,15,0,15
"Lexington, NE",30420.0,2020-05-01,-11,0,-11
"Lexington, NE",30420.0,2020-06-01,-12,0,-12
"Lexington, NE",30420.0,2020-07-01,0,0,0
"Lexington, NE",30420.0,2020-08-01,16,0,16
"Lexington, NE",30420.0,2020-09-01,0,0,0
"Lexington, NE",30420.0,2020-10-01,0,0,0
"Lexington, NE",30420.0,2020-11-01,-12,0,-12
"Lexington, NE",30420.0,2020-12-01,0,0,0
"Lamesa, TX",29500.0,2019-01-01,0,0,0
"Lamesa, TX",29500.0,2019-02-01,0,0,0
"Lamesa, TX",29500.0,2019-03-01,-12,0,-12
"Lamesa, TX",29500.0,2019-04-01,0,0,0
"Lamesa, TX",29500.0,2019-05-01,-12,0,-12
"Lamesa, TX",29500.0,2019-06-01,0,0,0
"Lamesa, TX",29500.0,2019-07-01,0,0,0
"Lamesa, TX",29500.0,2019-08-01,-13,0,-13
"Lamesa, TX",29500.0,2019-09-01,0,0,0
"Lamesa, TX",29500.0,2019-10-01,0,0,0
"Lamesa, TX",29500.0,2019-11-01,0,0,0
"Lamesa, TX",29500.0,2019-12-01,0,0,0
"Lamesa, TX",29500.0,2020-01-01,0,0,0
"Lamesa, TX",29500.0,2020-02-01,0,0,0
"Lamesa, TX",29500.0,2020-03-01,0,0,0
"Lamesa, TX",29500.0,2020-04-01,0,0,0
"Lamesa, TX",29500.0,2020-05-01,0,0,0
"Lamesa, TX",29500.0,2020-06-01,0,0,0
"Lamesa, TX",29500.0,2020-07-01,0,0,0
"Lamesa, TX",29500.0,2020-08-01,0,0,0
"Lamesa, TX",29500.0,2020-09-01,0,0,0
"Lamesa, TX",29500.0,2020-10-01,0,0,0
"Lamesa, TX",29500.0,2020-11-01,0,0,0
"Lamesa, TX",29500.0,2020-12-01,0,0,0
"Fort Payne, AL",22840.0,2019-01-01,31,0,31
"Fort Payne, AL",22840.0,2019-02-01,-4,0,-4
"Fort Payne, AL",22840.0,2019-03-01,-20,0,-20
"Fort Payne, AL",22840.0,2019-04-01,-39,0,-39
"Fort Payne, AL",22840.0,2019-05-01,-20,0,-20
"Fort Payne, AL",22840.0,2019-06-01,-189,0,-189
"Fort Payne, AL",22840.0,2019-07-01,21,0,21
"Fort Payne, AL",22840.0,2019-08-01,-9,0,-9
"Fort Payne, AL",22840.0,2019-09-01,9,0,9
"Fort Payne, AL",22840.0,2019-10-01,-16,0,-16
"Fort Payne, AL",22840.0,2019-11-01,6,0,6
"Fort Payne, AL",22840.0,2019-12-01,-25,0,-25
"Fort Payne, AL",22840.0,2020-01-01,13,0,13
"Fort Payne, AL",22840.0,2020-02-01,15,0,15
"Fort Payne, AL",22840.0,2020-03-01,19,0,19
"Fort Payne, AL",22840.0,2020-04-01,0,0,0
"Fort Payne, AL",22840.0,2020-05-01,15,0,15
"Fort Payne, AL",22840.0,2020-06-01,-9,0,-9
"Fort Payne, AL",22840.0,2020-07-01,-10,0,-10
"Fort Payne, AL",22840.0,2020-08-01,6,0,6
"Fort Payne, AL",22840.0,2020-09-01,-12,0,-12
"Fort Payne, AL",22840.0,2020-10-01,-27,0,-27
"Fort Payne, AL",22840.0,2020-11-01,3,0,3
"Fort Payne, AL",22840.0,2020-12-01,38,0,38
"Hereford, TX",25820.0,2019-01-01,-11,0,-11
"Hereford, TX",25820.0,2019-02-01,0,0,0
"Hereford, TX",25820.0,2019-03-01,0,0,0
"Hereford, TX",25820.0,2019-04-01,0,0,0
"Hereford, TX",25820.0,2019-05-01,0,0,0
"Hereford, TX",25820.0,2019-06-01,-14,0,-14
"Hereford, TX",25820.0,2019-07-01,-15,0,-15
"Hereford, TX",25820.0,2019-08-01,-11,0,-11
"Hereford, TX",25820.0,2019-09-01,0,0,0
"Hereford, TX",25820.0,2019-10-01,0,0,0
"Hereford, TX",25820.0,2019-11-01,0,0,0
"Hereford, TX",25820.0,2019-12-01,0,0,0
"Hereford, TX",25820.0,2020-01-01,0,0,0
"Hereford, TX",25820.0,2020-02-01,0,0,0
"Hereford, TX",25820.0,2020-03-01,-12,0,-12
"Hereford, TX",25820.0,2020-04-01,0,0,0
"Hereford, TX",25820.0,2020-05-01,12,0,12
"Hereford, TX",25820.0,2020-06-01,0,0,0
"Hereford, TX",25820.0,2020-07-01,-14,0,-14
"Hereford, TX",25820.0,2020-08-01,0,0,0
"Hereford, TX",25820.0,2020-09-01,0,0,0
"Hereford, TX",25820.0,2020-10-01,0,0,0
"Hereford, TX",25820.0,2020-11-01,-13,0,-13
"Hereford, TX",25820.0,2020-12-01,0,0,0
"Bainbridge, GA",12460.0,2019-01-01,-12,0,-12
"Bainbridge, GA",12460.0,2019-02-01,0,0,0
"Bainbridge, GA",12460.0,2019-03-01,0,0,0
"Bainbridge, GA",12460.0,2019-04-01,0,0,0
"Bainbridge, GA",12460.0,2019-05-01,0,0,0
"Bainbridge, GA",12460.0,2019-06-01,0,0,0
"Bainbridge, GA",12460.0,2019-07-01,16,0,16
"Bainbridge, GA",12460.0,2019-08-01,11,0,11
"Bainbridge, GA",12460.0,2019-09-01,0,0,0
"Bainbridge, GA",12460.0,2019-10-01,0,0,0
"Bainbridge, GA",12460.0,2019-11-01,0,0,0
"Bainbridge, GA",12460.0,2019-12-01,13,0,13
"Bainbridge, GA",12460.0,2020-01-01,0,0,0
"Bainbridge, GA",12460.0,2020-02-01,0,0,0
"Bainbridge, GA",12460.0,2020-03-01,-14,0,-14
"Bainbridge, GA",12460.0,2020-04-01,-14,0,-14
"Bainbridge, GA",12460.0,2020-05-01,0,0,0
"Bainbridge, GA",12460.0,2020-06-01,-12,0,-12
"Bainbridge, GA",12460.0,2020-07-01,-11,0,-11
"Bainbridge, GA",12460.0,2020-08-01,-15,0,-15
"Bainbridge, GA",12460.0,2020-09-01,0,0,0
"Bainbridge, GA",12460.0,2020-10-01,0,0,0
"Bainbridge, GA",12460.0,2020-11-01,0,0,0
"Bainbridge, GA",12460.0,2020-12-01,0,0,0
"Greensburg, IN",24700.0,2019-01-01,9,0,9
"Greensburg, IN",24700.0,2019-02-01,-19,0,-19
"Greensburg, IN",24700.0,2019-03-01,14,0,14
"Greensburg, IN",24700.0,2019-04-01,-38,0,-38
"Greensburg, IN",24700.0,2019-05-01,57,0,57
"Greensburg, IN",24700.0,2019-06-01,26,0,26
"Greensburg, IN",24700.0,2019-07-01,25,0,25
"Greensburg, IN",24700.0,2019-08-01,32,0,32
"Greensburg, IN",24700.0,2019-09-01,33,0,33
"Greensburg, IN",24700.0,2019-10-01,-32,0,-32
"Greensburg, IN",24700.0,2019-11-01,31,0,31
"Greensburg, IN",24700.0,2019-12-01,24,0,24
"Greensburg, IN",24700.0,2020-01-01,-16,0,-16
"Greensburg, IN",24700.0,2020-02-01,2,0,2
"Greensburg, IN",24700.0,2020-03-01,0,0,0
"Greensburg, IN",24700.0,2020-04-01,-1,0,-1
"Greensburg, IN",24700.0,2020-05-01,-13,0,-13
"Greensburg, IN",24700.0,2020-06-01,-12,0,-12
"Greensburg, IN",24700.0,2020-07-01,14,0,14
"Greensburg, IN",24700.0,2020-08-01,-14,0,-14
"Greensburg, IN",24700.0,2020-09-01,-3,0,-3
"Greensburg, IN",24700.0,2020-10-01,14,0,14
"Greensburg, IN",24700.0,2020-11-01,-11,0,-11
"Greensburg, IN",24700.0,2020-12-01,-50,0,-50
"Defiance, OH",19580.0,2019-01-01,-9,0,-9
"Defiance, OH",19580.0,2019-02-01,-8,0,-8
"Defiance, OH",19580.0,2019-03-01,-11,0,-11
"Defiance, OH",19580.0,2019-04-01,7,0,7
"Defiance, OH",19580.0,2019-05-01,2,0,2
"Defiance, OH",19580.0,2019-06-01,-11,0,-11
"Defiance, OH",19580.0,2019-07-01,25,0,25
"Defiance, OH",19580.0,2019-08-01,28,0,28
"Defiance, OH",19580.0,2019-09-01,-20,0,-20
"Defiance, OH",19580.0,2019-10-01,-31,0,-31
"Defiance, OH",19580.0,2019-11-01,3,-11,14
"Defiance, OH",19580.0,2019-12-01,-43,0,-43
"Defiance, OH",19580.0,2020-01-01,14,-11,25
"Defiance, OH",19580.0,2020-02-01,26,0,26
"Defiance, OH",19580.0,2020-03-01,27,0,27
"Defiance, OH",19580.0,2020-04-01,-16,0,-16
"Defiance, OH",19580.0,2020-05-01,-36,0,-36
"Defiance, OH",19580.0,2020-06-01,-9,0,-9
"Defiance, OH",19580.0,2020-07-01,-6,0,-6
"Defiance, OH",19580.0,2020-08-01,-1,0,-1
"Defiance, OH",19580.0,2020-09-01,-12,0,-12
"Defiance, OH",19580.0,2020-10-01,-2,0,-2
"Defiance, OH",19580.0,2020-11-01,-26,0,-26
"Defiance, OH",19580.0,2020-12-01,17,0,17
"Auburn, IN",12140.0,2019-01-01,-7,0,-7
"Auburn, IN",12140.0,2019-02-01,-14,0,-14
"Auburn, IN",12140.0,2019-03-01,-27,0,-27
"Auburn, IN",12140.0,2019-04-01,0,0,0
"Auburn, IN",12140.0,2019-05-01,23,0,23
"Auburn, IN",12140.0,2019-06-01,-10,0,-10
"Auburn, IN",12140.0,2019-07-01,-8,0,-8
"Auburn, IN",12140.0,2019-08-01,19,0,19
"Auburn, IN",12140.0,2019-09-01,-25,0,-25
"Auburn, IN",12140.0,2019-10-01,-19,0,-19
"Auburn, IN",12140.0,2019-11-01,28,0,28
"Auburn, IN",12140.0,2019-12-01,-4,0,-4
"Auburn, IN",12140.0,2020-01-01,-20,0,-20
"Auburn, IN",12140.0,2020-02-01,-21,0,-21
"Auburn, IN",12140.0,2020-03-01,7,0,7
"Auburn, IN",12140.0,2020-04-01,35,0,35
"Auburn, IN",12140.0,2020-05-01,-10,0,-10
"Auburn, IN",12140.0,2020-06-01,3,0,3
"Auburn, IN",12140.0,2020-07-01,-3,0,-3
"Auburn, IN",12140.0,2020-08-01,21,0,21
"Auburn, IN",12140.0,2020-09-01,-11,0,-11
"Auburn, IN",12140.0,2020-10-01,21,0,21
"Auburn, IN",12140.0,2020-11-01,4,0,4
"Auburn, IN",12140.0,2020-12-01,-41,0,-41
"Crescent City, CA",18860.0,2019-01-01,0,0,0
"Crescent City, CA",18860.0,2019-02-01,-11,0,-11
"Crescent City, CA",18860.0,2019-03-01,0,0,0
"Crescent City, CA",18860.0,2019-04-01,0,0,0
"Crescent City, CA",18860.0,2019-05-01,-11,0,-11
"Crescent City, CA",18860.0,2019-06-01,0,0,0
"Crescent City, CA",18860.0,2019-07-01,0,0,0
"Crescent City, CA",18860.0,2019-08-01,0,0,0
"Crescent City, CA",18860.0,2019-09-01,0,0,0
"Crescent City, CA",18860.0,2019-10-01,0,0,0
"Crescent City, CA",18860.0,2019-11-01,0,0,0
"Crescent City, CA",18860.0,2019-12-01,0,0,0
"Crescent City, CA",18860.0,2020-01-01,0,0,0
"Crescent City, CA",18860.0,2020-02-01,11,0,11
"Crescent City, CA",18860.0,2020-03-01,-12,0,-12
"Crescent City, CA",18860.0,2020-04-01,0,0,0
"Crescent City, CA",18860.0,2020-05-01,0,0,0
"Crescent City, CA",18860.0,2020-06-01,0,0,0
"Crescent City, CA",18860.0,2020-07-01,22,0,22
"Crescent City, CA",18860.0,2020-08-01,0,0,0
"Crescent City, CA",18860.0,2020-09-01,0,0,0
"Crescent City, CA",18860.0,2020-10-01,0,0,0
"Crescent City, CA",18860.0,2020-11-01,0,0,0
"Crescent City, CA",18860.0,2020-12-01,0,0,0
"Muncie, IN",34620.0,2019-01-01,-20,-16,-4
"Muncie, IN",34620.0,2019-02-01,30,0,30
"Muncie, IN",34620.0,2019-03-01,14,0,14
"Muncie, IN",34620.0,2019-04-01,57,17,40
"Muncie, IN",34620.0,2019-05-01,-13,11,-24
"Muncie, IN",34620.0,2019-06-01,-45,0,-45
"Muncie, IN",34620.0,2019-07-01,-45,0,-45
"Muncie, IN",34620.0,2019-08-01,18,0,18
"Muncie, IN",34620.0,2019-09-01,24,0,24
"Muncie, IN",34620.0,2019-10-01,-74,-27,-47
"Muncie, IN",34620.0,2019-11-01,4,-11,15
"Muncie, IN",34620.0,2019-12-01,-18,-38,20
"Muncie, IN",34620.0,2020-01-01,-57,-23,-34
"Muncie, IN",34620.0,2020-02-01,-28,0,-28
"Muncie, IN",34620.0,2020-03-01,-11,0,-11
"Muncie, IN",34620.0,2020-04-01,-22,0,-22
"Muncie, IN",34620.0,2020-05-01,31,15,16
"Muncie, IN",34620.0,2020-06-01,10,0,10
"Muncie, IN",34620.0,2020-07-01,-87,0,-87
"Muncie, IN",34620.0,2020-08-01,28,0,28
"Muncie, IN",34620.0,2020-09-01,65,0,65
"Muncie, IN",34620.0,2020-10-01,-21,-17,-4
"Muncie, IN",34620.0,2020-11-01,41,-11,52
"Muncie, IN",34620.0,2020-12-01,-29,-21,-8
"Columbus, OH",18140.0,2019-01-01,-812,-735,-77
"Columbus, OH",18140.0,2019-02-01,-118,-97,-21
"Columbus, OH",18140.0,2019-03-01,-97,24,-121
"Columbus, OH",18140.0,2019-04-01,922,681,241
"Columbus, OH",18140.0,2019-05-01,560,680,-120
"Columbus, OH",18140.0,2019-06-01,-142,79,-221
"Columbus, OH",18140.0,2019-07-01,-272,35,-307
"Columbus, OH",18140.0,2019-08-01,-470,0,-470
"Columbus, OH",18140.0,2019-09-01,-122,-31,-91
"Columbus, OH",18140.0,2019-10-01,-798,-595,-203
"Columbus, OH",18140.0,2019-11-01,-451,-328,-123
"Columbus, OH",18140.0,2019-12-01,-1191,-982,-209
"Columbus, OH",18140.0,2020-01-01,-926,-767,-159
"Columbus, OH",18140.0,2020-02-01,4,-64,68
"Columbus, OH",18140.0,2020-03-01,180,207,-27
"Columbus, OH",18140.0,2020-04-01,-39,262,-301
"Columbus, OH",18140.0,2020-05-01,391,516,-125
"Columbus, OH",18140.0,2020-06-01,205,201,4
"Columbus, OH",18140.0,2020-07-01,-424,69,-493
"Columbus, OH",18140.0,2020-08-01,-129,34,-163
"Columbus, OH",18140.0,2020-09-01,439,5,434
"Columbus, OH",18140.0,2020-10-01,-537,-585,48
"Columbus, OH",18140.0,2020-11-01,-492,-429,-63
"Columbus, OH",18140.0,2020-12-01,-955,-807,-148
"Escanaba, MI",21540.0,2019-01-01,15,0,15
"Escanaba, MI",21540.0,2019-02-01,0,0,0
"Escanaba, MI",21540.0,2019-03-01,15,0,15
"Escanaba, MI",21540.0,2019-04-01,0,0,0
"Escanaba, MI",21540.0,2019-05-01,15,15,0
"Escanaba, MI",21540.0,2019-06-01,16,0,16
"Escanaba, MI",21540.0,2019-07-01,6,0,6
"Escanaba, MI",21540.0,2019-08-01,4,0,4
"Escanaba, MI",21540.0,2019-09-01,-11,0,-11
"Escanaba, MI",21540.0,2019-10-01,-11,0,-11
"Escanaba, MI",21540.0,2019-11-01,-13,-13,0
"Escanaba, MI",21540.0,2019-12-01,-44,-44,0
"Escanaba, MI",21540.0,2020-01-01,1,-13,14
"Escanaba, MI",21540.0,2020-02-01,-13,0,-13
"Escanaba, MI",21540.0,2020-03-01,0,0,0
"Escanaba, MI",21540.0,2020-04-01,-11,0,-11
"Escanaba, MI",21540.0,2020-05-01,0,0,0
"Escanaba, MI",21540.0,2020-06-01,0,0,0
"Escanaba, MI",21540.0,2020-07-01,-13,0,-13
"Escanaba, MI",21540.0,2020-08-01,-3,0,-3
"Escanaba, MI",21540.0,2020-09-01,11,0,11
"Escanaba, MI",21540.0,2020-10-01,1,0,1
"Escanaba, MI",21540.0,2020-11-01,0,0,0
"Escanaba, MI",21540.0,2020-12-01,-27,-27,0
"Burlington, IA-IL",15460.0,2019-01-01,-18,0,-18
"Burlington, IA-IL",15460.0,2019-02-01,-19,0,-19
"Burlington, IA-IL",15460.0,2019-03-01,5,0,5
"Burlington, IA-IL",15460.0,2019-04-01,-11,0,-11
"Burlington, IA-IL",15460.0,2019-05-01,-10,0,-10
"Burlington, IA-IL",15460.0,2019-06-01,-5,0,-5
"Burlington, IA-IL",15460.0,2019-07-01,21,0,21
"Burlington, IA-IL",15460.0,2019-08-01,-1,0,-1
"Burlington, IA-IL",15460.0,2019-09-01,-2,0,-2
"Burlington, IA-IL",15460.0,2019-10-01,-17,0,-17
"Burlington, IA-IL",15460.0,2019-11-01,15,0,15
"Burlington, IA-IL",15460.0,2019-12-01,-20,0,-20
"Burlington, IA-IL",15460.0,2020-01-01,6,0,6
"Burlington, IA-IL",15460.0,2020-02-01,0,0,0
"Burlington, IA-IL",15460.0,2020-03-01,22,0,22
"Burlington, IA-IL",15460.0,2020-04-01,-13,0,-13
"Burlington, IA-IL",15460.0,2020-05-01,-12,0,-12
"Burlington, IA-IL",15460.0,2020-06-01,11,0,11
"Burlington, IA-IL",15460.0,2020-07-01,-9,0,-9
"Burlington, IA-IL",15460.0,2020-08-01,11,0,11
"Burlington, IA-IL",15460.0,2020-09-01,-9,0,-9
"Burlington, IA-IL",15460.0,2020-10-01,-13,0,-13
"Burlington, IA-IL",15460.0,2020-11-01,0,0,0
"Burlington, IA-IL",15460.0,2020-12-01,28,0,28
"Bend, OR",13460.0,2019-01-01,62,-125,187
"Bend, OR",13460.0,2019-02-01,55,-23,78
"Bend, OR",13460.0,2019-03-01,236,2,234
"Bend, OR",13460.0,2019-04-01,369,156,213
"Bend, OR",13460.0,2019-05-01,541,331,210
"Bend, OR",13460.0,2019-06-01,446,117,329
"Bend, OR",13460.0,2019-07-01,229,19,210
"Bend, OR",13460.0,2019-08-01,249,0,249
"Bend, OR",13460.0,2019-09-01,117,-39,156
"Bend, OR",13460.0,2019-10-01,-421,-452,31
"Bend, OR",13460.0,2019-11-01,-61,-200,139
"Bend, OR",13460.0,2019-12-01,-74,-119,45
"Bend, OR",13460.0,2020-01-01,-15,-149,134
"Bend, OR",13460.0,2020-02-01,55,-32,87
"Bend, OR",13460.0,2020-03-01,348,122,226
"Bend, OR",13460.0,2020-04-01,393,112,281
"Bend, OR",13460.0,2020-05-01,521,278,243
"Bend, OR",13460.0,2020-06-01,525,203,322
"Bend, OR",13460.0,2020-07-01,380,59,321
"Bend, OR",13460.0,2020-08-01,435,2,433
"Bend, OR",13460.0,2020-09-01,632,58,574
"Bend, OR",13460.0,2020-10-01,75,-309,384
"Bend, OR",13460.0,2020-11-01,51,-210,261
"Bend, OR",13460.0,2020-12-01,186,-37,223
"Arcadia, FL",11580.0,2019-01-01,32,13,19
"Arcadia, FL",11580.0,2019-02-01,16,0,16
"Arcadia, FL",11580.0,2019-03-01,16,0,16
"Arcadia, FL",11580.0,2019-04-01,6,0,6
"Arcadia, FL",11580.0,2019-05-01,11,0,11
"Arcadia, FL",11580.0,2019-06-01,14,0,14
"Arcadia, FL",11580.0,2019-07-01,7,0,7
"Arcadia, FL",11580.0,2019-08-01,6,0,6
"Arcadia, FL",11580.0,2019-09-01,26,0,26
"Arcadia, FL",11580.0,2019-10-01,14,0,14
"Arcadia, FL",11580.0,2019-11-01,15,14,1
"Arcadia, FL",11580.0,2019-12-01,39,52,-13
"Arcadia, FL",11580.0,2020-01-01,26,11,15
"Arcadia, FL",11580.0,2020-02-01,3,0,3
"Arcadia, FL",11580.0,2020-03-01,24,0,24
"Arcadia, FL",11580.0,2020-04-01,27,0,27
"Arcadia, FL",11580.0,2020-05-01,14,0,14
"Arcadia, FL",11580.0,2020-06-01,16,0,16
"Arcadia, FL",11580.0,2020-07-01,7,0,7
"Arcadia, FL",11580.0,2020-08-01,23,0,23
"Arcadia, FL",11580.0,2020-09-01,17,0,17
"Arcadia, FL",11580.0,2020-10-01,5,12,-7
"Arcadia, FL",11580.0,2020-11-01,28,25,3
"Arcadia, FL",11580.0,2020-12-01,26,41,-15
"Spirit Lake, IA",44020.0,2019-01-01,-22,-22,0
"Spirit Lake, IA",44020.0,2019-02-01,0,0,0
"Spirit Lake, IA",44020.0,2019-03-01,0,0,0
"Spirit Lake, IA",44020.0,2019-04-01,60,41,19
"Spirit Lake, IA",44020.0,2019-05-01,78,44,34
"Spirit Lake, IA",44020.0,2019-06-01,-2,11,-13
"Spirit Lake, IA",44020.0,2019-07-01,15,0,15
"Spirit Lake, IA",44020.0,2019-08-01,12,0,12
"Spirit Lake, IA",44020.0,2019-09-01,-8,-19,11
"Spirit Lake, IA",44020.0,2019-10-01,-78,-95,17
"Spirit Lake, IA",44020.0,2019-11-01,-30,-41,11
"Spirit Lake, IA",44020.0,2019-12-01,-77,-77,0
"Spirit Lake, IA",44020.0,2020-01-01,-24,-24,0
"Spirit Lake, IA",44020.0,2020-02-01,11,0,11
"Spirit Lake, IA",44020.0,2020-03-01,34,0,34
"Spirit Lake, IA",44020.0,2020-04-01,23,24,-1
"Spirit Lake, IA",44020.0,2020-05-01,72,61,11
"Spirit Lake, IA",44020.0,2020-06-01,6,18,-12
"Spirit Lake, IA",44020.0,2020-07-01,-14,0,-14
"Spirit Lake, IA",44020.0,2020-08-01,5,0,5
"Spirit Lake, IA",44020.0,2020-09-01,-20,-20,0
"Spirit Lake, IA",44020.0,2020-10-01,-138,-124,-14
"Spirit Lake, IA",44020.0,2020-11-01,-55,-55,0
"Spirit Lake, IA",44020.0,2020-12-01,-34,-22,-12
"Iron Mountain, MI-WI",27020.0,2019-01-01,-15,0,-15
"Iron Mountain, MI-WI",27020.0,2019-02-01,-11,0,-11
"Iron Mountain, MI-WI",27020.0,2019-03-01,0,0,0
"Iron Mountain, MI-WI",27020.0,2019-04-01,0,0,0
"Iron Mountain, MI-WI",27020.0,2019-05-01,13,0,13
"Iron Mountain, MI-WI",27020.0,2019-06-01,0,0,0
"Iron Mountain, MI-WI",27020.0,2019-07-01,14,0,14
"Iron Mountain, MI-WI",27020.0,2019-08-01,-12,0,-12
"Iron Mountain, MI-WI",27020.0,2019-09-01,23,0,23
"Iron Mountain, MI-WI",27020.0,2019-10-01,-22,-11,-11
"Iron Mountain, MI-WI",27020.0,2019-11-01,11,0,11
"Iron Mountain, MI-WI",27020.0,2019-12-01,-4,-22,18
"Iron Mountain, MI-WI",27020.0,2020-01-01,0,0,0
"Iron Mountain, MI-WI",27020.0,2020-02-01,-12,0,-12
"Iron Mountain, MI-WI",27020.0,2020-03-01,0,0,0
"Iron Mountain, MI-WI",27020.0,2020-04-01,-13,0,-13
"Iron Mountain, MI-WI",27020.0,2020-05-01,0,0,0
"Iron Mountain, MI-WI",27020.0,2020-06-01,13,0,13
"Iron Mountain, MI-WI",27020.0,2020-07-01,-14,0,-14
"Iron Mountain, MI-WI",27020.0,2020-08-01,0,0,0
"Iron Mountain, MI-WI",27020.0,2020-09-01,0,0,0
"Iron Mountain, MI-WI",27020.0,2020-10-01,0,0,0
"Iron Mountain, MI-WI",27020.0,2020-11-01,11,0,11
"Iron Mountain, MI-WI",27020.0,2020-12-01,-11,-11,0
"Clarksburg, WV",17220.0,2019-01-01,-14,0,-14
"Clarksburg, WV",17220.0,2019-02-01,3,0,3
"Clarksburg, WV",17220.0,2019-03-01,-43,0,-43
"Clarksburg, WV",17220.0,2019-04-01,-19,0,-19
"Clarksburg, WV",17220.0,2019-05-01,43,0,43
"Clarksburg, WV",17220.0,2019-06-01,37,0,37
"Clarksburg, WV",17220.0,2019-07-01,32,0,32
"Clarksburg, WV",17220.0,2019-08-01,-15,0,-15
"Clarksburg, WV",17220.0,2019-09-01,2,0,2
"Clarksburg, WV",17220.0,2019-10-01,-7,0,-7
"Clarksburg, WV",17220.0,2019-11-01,-23,0,-23
"Clarksburg, WV",17220.0,2019-12-01,-22,0,-22
"Clarksburg, WV",17220.0,2020-01-01,-32,0,-32
"Clarksburg, WV",17220.0,2020-02-01,12,0,12
"Clarksburg, WV",17220.0,2020-03-01,13,0,13
"Clarksburg, WV",17220.0,2020-04-01,20,0,20
"Clarksburg, WV",17220.0,2020-05-01,18,0,18
"Clarksburg, WV",17220.0,2020-06-01,-33,0,-33
"Clarksburg, WV",17220.0,2020-07-01,-3,0,-3
"Clarksburg, WV",17220.0,2020-08-01,22,0,22
"Clarksburg, WV",17220.0,2020-09-01,8,0,8
"Clarksburg, WV",17220.0,2020-10-01,-35,0,-35
"Clarksburg, WV",17220.0,2020-11-01,-5,0,-5
"Clarksburg, WV",17220.0,2020-12-01,20,0,20
"Rochester, MN",40340.0,2019-01-01,-116,-102,-14
"Rochester, MN",40340.0,2019-02-01,-1,-13,12
"Rochester, MN",40340.0,2019-03-01,11,0,11
"Rochester, MN",40340.0,2019-04-01,132,85,47
"Rochester, MN",40340.0,2019-05-01,130,83,47
"Rochester, MN",40340.0,2019-06-01,-27,0,-27
"Rochester, MN",40340.0,2019-07-01,-33,0,-33
"Rochester, MN",40340.0,2019-08-01,-17,0,-17
"Rochester, MN",40340.0,2019-09-01,-27,0,-27
"Rochester, MN",40340.0,2019-10-01,-212,-167,-45
"Rochester, MN",40340.0,2019-11-01,-224,-142,-82
"Rochester, MN",40340.0,2019-12-01,-223,-178,-45
"Rochester, MN",40340.0,2020-01-01,-85,-94,9
"Rochester, MN",40340.0,2020-02-01,-23,0,-23
"Rochester, MN",40340.0,2020-03-01,135,44,91
"Rochester, MN",40340.0,2020-04-01,14,9,5
"Rochester, MN",40340.0,2020-05-01,55,68,-13
"Rochester, MN",40340.0,2020-06-01,77,29,48
"Rochester, MN",40340.0,2020-07-01,88,0,88
"Rochester, MN",40340.0,2020-08-01,49,0,49
"Rochester, MN",40340.0,2020-09-01,0,12,-12
"Rochester, MN",40340.0,2020-10-01,-193,-173,-20
"Rochester, MN",40340.0,2020-11-01,-100,-97,-3
"Rochester, MN",40340.0,2020-12-01,-79,-119,40
"Fremont, NE",23340.0,2019-01-01,-3,-13,10
"Fremont, NE",23340.0,2019-02-01,-22,-15,-7
"Fremont, NE",23340.0,2019-03-01,-5,0,-5
"Fremont, NE",23340.0,2019-04-01,-3,0,-3
"Fremont, NE",23340.0,2019-05-01,-14,0,-14
"Fremont, NE",23340.0,2019-06-01,-8,0,-8
"Fremont, NE",23340.0,2019-07-01,-35,0,-35
"Fremont, NE",23340.0,2019-08-01,-34,0,-34
"Fremont, NE",23340.0,2019-09-01,-4,0,-4
"Fremont, NE",23340.0,2019-10-01,-12,0,-12
"Fremont, NE",23340.0,2019-11-01,3,0,3
"Fremont, NE",23340.0,2019-12-01,-23,-11,-12
"Fremont, NE",23340.0,2020-01-01,-45,-15,-30
"Fremont, NE",23340.0,2020-02-01,-2,-12,10
"Fremont, NE",23340.0,2020-03-01,9,0,9
"Fremont, NE",23340.0,2020-04-01,20,0,20
"Fremont, NE",23340.0,2020-05-01,-3,0,-3
"Fremont, NE",23340.0,2020-06-01,34,0,34
"Fremont, NE",23340.0,2020-07-01,-14,0,-14
"Fremont, NE",23340.0,2020-08-01,-20,0,-20
"Fremont, NE",23340.0,2020-09-01,24,0,24
"Fremont, NE",23340.0,2020-10-01,19,0,19
"Fremont, NE",23340.0,2020-11-01,13,0,13
"Fremont, NE",23340.0,2020-12-01,-32,0,-32
"Beaver Dam, WI",13180.0,2019-01-01,16,-16,32
"Beaver Dam, WI",13180.0,2019-02-01,22,-12,34
"Beaver Dam, WI",13180.0,2019-03-01,53,0,53
"Beaver Dam, WI",13180.0,2019-04-01,91,15,76
"Beaver Dam, WI",13180.0,2019-05-01,14,0,14
"Beaver Dam, WI",13180.0,2019-06-01,5,0,5
"Beaver Dam, WI",13180.0,2019-07-01,-11,0,-11
"Beaver Dam, WI",13180.0,2019-08-01,-26,0,-26
"Beaver Dam, WI",13180.0,2019-09-01,17,0,17
"Beaver Dam, WI",13180.0,2019-10-01,0,-41,41
"Beaver Dam, WI",13180.0,2019-11-01,-64,-41,-23
"Beaver Dam, WI",13180.0,2019-12-01,-1,-16,15
"Beaver Dam, WI",13180.0,2020-01-01,-5,-15,10
"Beaver Dam, WI",13180.0,2020-02-01,-22,0,-22
"Beaver Dam, WI",13180.0,2020-03-01,24,0,24
"Beaver Dam, WI",13180.0,2020-04-01,28,0,28
"Beaver Dam, WI",13180.0,2020-05-01,-1,0,-1
"Beaver Dam, WI",13180.0,2020-06-01,-9,0,-9
"Beaver Dam, WI",13180.0,2020-07-01,40,0,40
"Beaver Dam, WI",13180.0,2020-08-01,37,0,37
"Beaver Dam, WI",13180.0,2020-09-01,10,0,10
"Beaver Dam, WI",13180.0,2020-10-01,-16,-35,19
"Beaver Dam, WI",13180.0,2020-11-01,44,-18,62
"Beaver Dam, WI",13180.0,2020-12-01,30,-35,65
"Las Cruces, NM",29740.0,2019-01-01,13,0,13
"Las Cruces, NM",29740.0,2019-02-01,-13,0,-13
"Las Cruces, NM",29740.0,2019-03-01,52,0,52
"Las Cruces, NM",29740.0,2019-04-01,44,0,44
"Las Cruces, NM",29740.0,2019-05-01,19,0,19
"Las Cruces, NM",29740.0,2019-06-01,72,0,72
"Las Cruces, NM",29740.0,2019-07-01,12,0,12
"Las Cruces, NM",29740.0,2019-08-01,89,0,89
"Las Cruces, NM",29740.0,2019-09-01,38,0,38
"Las Cruces, NM",29740.0,2019-10-01,90,12,78
"Las Cruces, NM",29740.0,2019-11-01,17,0,17
"Las Cruces, NM",29740.0,2019-12-01,-19,0,-19
"Las Cruces, NM",29740.0,2020-01-01,16,-15,31
"Las Cruces, NM",29740.0,2020-02-01,-5,0,-5
"Las Cruces, NM",29740.0,2020-03-01,67,0,67
"Las Cruces, NM",29740.0,2020-04-01,101,12,89
"Las Cruces, NM",29740.0,2020-05-01,-31,0,-31
"Las Cruces, NM",29740.0,2020-06-01,32,0,32
"Las Cruces, NM",29740.0,2020-07-01,31,0,31
"Las Cruces, NM",29740.0,2020-08-01,25,0,25
"Las Cruces, NM",29740.0,2020-09-01,-2,0,-2
"Las Cruces, NM",29740.0,2020-10-01,55,-11,66
"Las Cruces, NM",29740.0,2020-11-01,14,0,14
"Las Cruces, NM",29740.0,2020-12-01,29,0,29
"Cambridge, MD",15700.0,2019-01-01,-33,0,-33
"Cambridge, MD",15700.0,2019-02-01,-11,0,-11
"Cambridge, MD",15700.0,2019-03-01,15,0,15
"Cambridge, MD",15700.0,2019-04-01,-21,0,-21
"Cambridge, MD",15700.0,2019-05-01,18,0,18
"Cambridge, MD",15700.0,2019-06-01,-16,0,-16
"Cambridge, MD",15700.0,2019-07-01,10,0,10
"Cambridge, MD",15700.0,2019-08-01,22,0,22
"Cambridge, MD",15700.0,2019-09-01,11,0,11
"Cambridge, MD",15700.0,2019-10-01,38,0,38
"Cambridge, MD",15700.0,2019-11-01,-16,0,-16
"Cambridge, MD",15700.0,2019-12-01,20,0,20
"Cambridge, MD",15700.0,2020-01-01,5,0,5
"Cambridge, MD",15700.0,2020-02-01,-33,0,-33
"Cambridge, MD",15700.0,2020-03-01,-7,0,-7
"Cambridge, MD",15700.0,2020-04-01,-19,0,-19
"Cambridge, MD",15700.0,2020-05-01,-31,0,-31
"Cambridge, MD",15700.0,2020-06-01,-30,0,-30
"Cambridge, MD",15700.0,2020-07-01,-28,0,-28
"Cambridge, MD",15700.0,2020-08-01,-10,0,-10
"Cambridge, MD",15700.0,2020-09-01,21,0,21
"Cambridge, MD",15700.0,2020-10-01,10,0,10
"Cambridge, MD",15700.0,2020-11-01,10,0,10
"Cambridge, MD",15700.0,2020-12-01,15,0,15
"Albany, GA",10500.0,2019-01-01,2,0,2
"Albany, GA",10500.0,2019-02-01,0,0,0
"Albany, GA",10500.0,2019-03-01,11,0,11
"Albany, GA",10500.0,2019-04-01,16,0,16
"Albany, GA",10500.0,2019-05-01,4,0,4
"Albany, GA",10500.0,2019-06-01,-50,0,-50
"Albany, GA",10500.0,2019-07-01,17,0,17
"Albany, GA",10500.0,2019-08-01,-27,0,-27
"Albany, GA",10500.0,2019-09-01,-24,0,-24
"Albany, GA",10500.0,2019-10-01,-10,0,-10
"Albany, GA",10500.0,2019-11-01,6,0,6
"Albany, GA",10500.0,2019-12-01,-22,0,-22
"Albany, GA",10500.0,2020-01-01,13,0,13
"Albany, GA",10500.0,2020-02-01,11,0,11
"Albany, GA",10500.0,2020-03-01,-1,0,-1
"Albany, GA",10500.0,2020-04-01,-1,0,-1
"Albany, GA",10500.0,2020-05-01,-15,0,-15
"Albany, GA",10500.0,2020-06-01,-13,0,-13
"Albany, GA",10500.0,2020-07-01,-3,0,-3
"Albany, GA",10500.0,2020-08-01,-3,0,-3
"Albany, GA",10500.0,2020-09-01,13,0,13
"Albany, GA",10500.0,2020-10-01,22,0,22
"Albany, GA",10500.0,2020-11-01,0,0,0
"Albany, GA",10500.0,2020-12-01,1,0,1
"Lawrence, KS",29940.0,2019-01-01,-18,0,-18
"Lawrence, KS",29940.0,2019-02-01,-14,0,-14
"Lawrence, KS",29940.0,2019-03-01,-28,0,-28
"Lawrence, KS",29940.0,2019-04-01,-45,0,-45
"Lawrence, KS",29940.0,2019-05-01,-75,0,-75
"Lawrence, KS",29940.0,2019-06-01,-58,0,-58
"Lawrence, KS",29940.0,2019-07-01,-404,0,-404
"Lawrence, KS",29940.0,2019-08-01,-72,0,-72
"Lawrence, KS",29940.0,2019-09-01,25,0,25
"Lawrence, KS",29940.0,2019-10-01,-9,0,-9
"Lawrence, KS",29940.0,2019-11-01,8,0,8
"Lawrence, KS",29940.0,2019-12-01,-10,0,-10
"Lawrence, KS",29940.0,2020-01-01,-11,0,-11
"Lawrence, KS",29940.0,2020-02-01,13,0,13
"Lawrence, KS",29940.0,2020-03-01,-19,2,-21
"Lawrence, KS",29940.0,2020-04-01,33,0,33
"Lawrence, KS",29940.0,2020-05-01,-124,0,-124
"Lawrence, KS",29940.0,2020-06-01,-125,0,-125
"Lawrence, KS",29940.0,2020-07-01,-361,0,-361
"Lawrence, KS",29940.0,2020-08-01,-40,0,-40
"Lawrence, KS",29940.0,2020-09-01,19,0,19
"Lawrence, KS",29940.0,2020-10-01,-6,0,-6
"Lawrence, KS",29940.0,2020-11-01,-2,0,-2
"Lawrence, KS",29940.0,2020-12-01,60,0,60
"Alexandria, MN",10820.0,2019-01-01,-75,-51,-24
"Alexandria, MN",10820.0,2019-02-01,0,0,0
"Alexandria, MN",10820.0,2019-03-01,-2,0,-2
"Alexandria, MN",10820.0,2019-04-01,137,109,28
"Alexandria, MN",10820.0,2019-05-01,70,52,18
"Alexandria, MN",10820.0,2019-06-01,-15,0,-15
"Alexandria, MN",10820.0,2019-07-01,-5,0,-5
"Alexandria, MN",10820.0,2019-08-01,20,0,20
"Alexandria, MN",10820.0,2019-09-01,-29,-12,-17
"Alexandria, MN",10820.0,2019-10-01,-164,-165,1
"Alexandria, MN",10820.0,2019-11-01,-85,-74,-11
"Alexandria, MN",10820.0,2019-12-01,-132,-132,0
"Alexandria, MN",10820.0,2020-01-01,-45,-45,0
"Alexandria, MN",10820.0,2020-02-01,-1,0,-1
"Alexandria, MN",10820.0,2020-03-01,58,34,24
"Alexandria, MN",10820.0,2020-04-01,87,52,35
"Alexandria, MN",10820.0,2020-05-01,79,70,9
"Alexandria, MN",10820.0,2020-06-01,55,17,38
"Alexandria, MN",10820.0,2020-07-01,23,0,23
"Alexandria, MN",10820.0,2020-08-01,24,0,24
"Alexandria, MN",10820.0,2020-09-01,-31,-15,-16
"Alexandria, MN",10820.0,2020-10-01,-143,-151,8
"Alexandria, MN",10820.0,2020-11-01,-72,-100,28
"Alexandria, MN",10820.0,2020-12-01,-85,-77,-8
"Gardnerville Ranchos, NV",23820.0,2019-01-01,-1,-11,10
"Gardnerville Ranchos, NV",23820.0,2019-02-01,-12,0,-12
"Gardnerville Ranchos, NV",23820.0,2019-03-01,-12,0,-12
"Gardnerville Ranchos, NV",23820.0,2019-04-01,-25,0,-25
"Gardnerville Ranchos, NV",23820.0,2019-05-01,45,35,10
"Gardnerville Ranchos, NV",23820.0,2019-06-01,37,11,26
"Gardnerville Ranchos, NV",23820.0,2019-07-01,20,0,20
"Gardnerville Ranchos, NV",23820.0,2019-08-01,16,0,16
"Gardnerville Ranchos, NV",23820.0,2019-09-01,12,0,12
"Gardnerville Ranchos, NV",23820.0,2019-10-01,-16,-36,20
"Gardnerville Ranchos, NV",23820.0,2019-11-01,-43,-34,-9
"Gardnerville Ranchos, NV",23820.0,2019-12-01,-62,-15,-47
"Gardnerville Ranchos, NV",23820.0,2020-01-01,-43,-14,-29
"Gardnerville Ranchos, NV",23820.0,2020-02-01,-14,-15,1
"Gardnerville Ranchos, NV",23820.0,2020-03-01,9,0,9
"Gardnerville Ranchos, NV",23820.0,2020-04-01,7,0,7
"Gardnerville Ranchos, NV",23820.0,2020-05-01,6,32,-26
"Gardnerville Ranchos, NV",23820.0,2020-06-01,44,0,44
"Gardnerville Ranchos, NV",23820.0,2020-07-01,23,0,23
"Gardnerville Ranchos, NV",23820.0,2020-08-01,26,0,26
"Gardnerville Ranchos, NV",23820.0,2020-09-01,96,0,96
"Gardnerville Ranchos, NV",23820.0,2020-10-01,20,-35,55
"Gardnerville Ranchos, NV",23820.0,2020-11-01,-19,-42,23
"Gardnerville Ranchos, NV",23820.0,2020-12-01,17,0,17
"Roseburg, OR",40700.0,2019-01-01,13,0,13
"Roseburg, OR",40700.0,2019-02-01,6,0,6
"Roseburg, OR",40700.0,2019-03-01,-2,0,-2
"Roseburg, OR",40700.0,2019-04-01,73,0,73
"Roseburg, OR",40700.0,2019-05-01,53,0,53
"Roseburg, OR",40700.0,2019-06-01,85,0,85
"Roseburg, OR",40700.0,2019-07-01,61,0,61
"Roseburg, OR",40700.0,2019-08-01,45,0,45
"Roseburg, OR",40700.0,2019-09-01,92,0,92
"Roseburg, OR",40700.0,2019-10-01,-100,-69,-31
"Roseburg, OR",40700.0,2019-11-01,-23,-35,12
"Roseburg, OR",40700.0,2019-12-01,9,-37,46
"Roseburg, OR",40700.0,2020-01-01,-16,-11,-5
"Roseburg, OR",40700.0,2020-02-01,15,0,15
"Roseburg, OR",40700.0,2020-03-01,66,0,66
"Roseburg, OR",40700.0,2020-04-01,13,0,13
"Roseburg, OR",40700.0,2020-05-01,46,0,46
"Roseburg, OR",40700.0,2020-06-01,78,0,78
"Roseburg, OR",40700.0,2020-07-01,22,0,22
"Roseburg, OR",40700.0,2020-08-01,48,0,48
"Roseburg, OR",40700.0,2020-09-01,92,0,92
"Roseburg, OR",40700.0,2020-10-01,32,-16,48
"Roseburg, OR",40700.0,2020-11-01,47,-12,59
"Roseburg, OR",40700.0,2020-12-01,59,0,59
"Jasper, IN",27540.0,2019-01-01,0,0,0
"Jasper, IN",27540.0,2019-02-01,0,0,0
"Jasper, IN",27540.0,2019-03-01,-13,0,-13
"Jasper, IN",27540.0,2019-04-01,-4,0,-4
"Jasper, IN",27540.0,2019-05-01,-11,0,-11
"Jasper, IN",27540.0,2019-06-01,-32,0,-32
"Jasper, IN",27540.0,2019-07-01,-5,0,-5
"Jasper, IN",27540.0,2019-08-01,-14,0,-14
"Jasper, IN",27540.0,2019-09-01,12,0,12
"Jasper, IN",27540.0,2019-10-01,24,0,24
"Jasper, IN",27540.0,2019-11-01,10,0,10
"Jasper, IN",27540.0,2019-12-01,11,0,11
"Jasper, IN",27540.0,2020-01-01,0,0,0
"Jasper, IN",27540.0,2020-02-01,-17,0,-17
"Jasper, IN",27540.0,2020-03-01,0,0,0
"Jasper, IN",27540.0,2020-04-01,-6,0,-6
"Jasper, IN",27540.0,2020-05-01,0,0,0
"Jasper, IN",27540.0,2020-06-01,13,0,13
"Jasper, IN",27540.0,2020-07-01,-3,0,-3
"Jasper, IN",27540.0,2020-08-01,13,0,13
"Jasper, IN",27540.0,2020-09-01,15,0,15
"Jasper, IN",27540.0,2020-10-01,0,0,0
"Jasper, IN",27540.0,2020-11-01,-15,0,-15
"Jasper, IN",27540.0,2020-12-01,0,0,0
"Dubuque, IA",20220.0,2019-01-01,-7,-55,48
"Dubuque, IA",20220.0,2019-02-01,-11,-11,0
"Dubuque, IA",20220.0,2019-03-01,49,0,49
"Dubuque, IA",20220.0,2019-04-01,60,61,-1
"Dubuque, IA",20220.0,2019-05-01,68,16,52
"Dubuque, IA",20220.0,2019-06-01,49,0,49
"Dubuque, IA",20220.0,2019-07-01,-12,0,-12
"Dubuque, IA",20220.0,2019-08-01,-45,0,-45
"Dubuque, IA",20220.0,2019-09-01,-38,0,-38
"Dubuque, IA",20220.0,2019-10-01,-34,-48,14
"Dubuque, IA",20220.0,2019-11-01,-27,-32,5
"Dubuque, IA",20220.0,2019-12-01,-78,-70,-8
"Dubuque, IA",20220.0,2020-01-01,-71,-72,1
"Dubuque, IA",20220.0,2020-02-01,15,0,15
"Dubuque, IA",20220.0,2020-03-01,10,0,10
"Dubuque, IA",20220.0,2020-04-01,28,11,17
"Dubuque, IA",20220.0,2020-05-01,52,28,24
"Dubuque, IA",20220.0,2020-06-01,18,0,18
"Dubuque, IA",20220.0,2020-07-01,-28,0,-28
"Dubuque, IA",20220.0,2020-08-01,-26,0,-26
"Dubuque, IA",20220.0,2020-09-01,-11,0,-11
"Dubuque, IA",20220.0,2020-10-01,-74,-54,-20
"Dubuque, IA",20220.0,2020-11-01,3,-30,33
"Dubuque, IA",20220.0,2020-12-01,-69,-48,-21
"Vineyard Haven, MA",47240.0,2019-01-01,0,0,0
"Vineyard Haven, MA",47240.0,2019-02-01,0,0,0
"Vineyard Haven, MA",47240.0,2019-03-01,0,0,0
"Vineyard Haven, MA",47240.0,2019-04-01,2,2,0
"Vineyard Haven, MA",47240.0,2019-05-01,209,198,11
"Vineyard Haven, MA",47240.0,2019-06-01,259,263,-4
"Vineyard Haven, MA",47240.0,2019-07-01,54,54,0
"Vineyard Haven, MA",47240.0,2019-08-01,-11,-11,0
"Vineyard Haven, MA",47240.0,2019-09-01,-110,-79,-31
"Vineyard Haven, MA",47240.0,2019-10-01,-161,-161,0
"Vineyard Haven, MA",47240.0,2019-11-01,-73,-73,0
"Vineyard Haven, MA",47240.0,2019-12-01,-28,-28,0
"Vineyard Haven, MA",47240.0,2020-01-01,-23,-23,0
"Vineyard Haven, MA",47240.0,2020-02-01,0,0,0
"Vineyard Haven, MA",47240.0,2020-03-01,75,86,-11
"Vineyard Haven, MA",47240.0,2020-04-01,88,88,0
"Vineyard Haven, MA",47240.0,2020-05-01,221,220,1
"Vineyard Haven, MA",47240.0,2020-06-01,440,414,26
"Vineyard Haven, MA",47240.0,2020-07-01,93,91,2
"Vineyard Haven, MA",47240.0,2020-08-01,102,67,35
"Vineyard Haven, MA",47240.0,2020-09-01,10,14,-4
"Vineyard Haven, MA",47240.0,2020-10-01,-175,-154,-21
"Vineyard Haven, MA",47240.0,2020-11-01,-25,-25,0
"Vineyard Haven, MA",47240.0,2020-12-01,0,-26,26
"Kennett, MO",28380.0,2019-01-01,-11,0,-11
"Kennett, MO",28380.0,2019-02-01,14,0,14
"Kennett, MO",28380.0,2019-03-01,13,0,13
"Kennett, MO",28380.0,2019-04-01,-13,0,-13
"Kennett, MO",28380.0,2019-05-01,24,0,24
"Kennett, MO",28380.0,2019-06-01,-2,0,-2
"Kennett, MO",28380.0,2019-07-01,11,0,11
"Kennett, MO",28380.0,2019-08-01,-15,0,-15
"Kennett, MO",28380.0,2019-09-01,0,0,0
"Kennett, MO",28380.0,2019-10-01,13,0,13
"Kennett, MO",28380.0,2019-11-01,-17,0,-17
"Kennett, MO",28380.0,2019-12-01,-1,0,-1
"Kennett, MO",28380.0,2020-01-01,-4,0,-4
"Kennett, MO",28380.0,2020-02-01,16,0,16
"Kennett, MO",28380.0,2020-03-01,-40,0,-40
"Kennett, MO",28380.0,2020-04-01,13,0,13
"Kennett, MO",28380.0,2020-05-01,-2,0,-2
"Kennett, MO",28380.0,2020-06-01,-14,0,-14
"Kennett, MO",28380.0,2020-07-01,-24,0,-24
"Kennett, MO",28380.0,2020-08-01,-28,0,-28
"Kennett, MO",28380.0,2020-09-01,-1,0,-1
"Kennett, MO",28380.0,2020-10-01,27,0,27
"Kennett, MO",28380.0,2020-11-01,41,0,41
"Kennett, MO",28380.0,2020-12-01,-4,0,-4
"Menomonie, WI",32860.0,2019-01-01,5,0,5
"Menomonie, WI",32860.0,2019-02-01,18,0,18
"Menomonie, WI",32860.0,2019-03-01,-2,0,-2
"Menomonie, WI",32860.0,2019-04-01,12,13,-1
"Menomonie, WI",32860.0,2019-05-01,-47,0,-47
"Menomonie, WI",32860.0,2019-06-01,13,0,13
"Menomonie, WI",32860.0,2019-07-01,-31,0,-31
"Menomonie, WI",32860.0,2019-08-01,-16,0,-16
"Menomonie, WI",32860.0,2019-09-01,14,0,14
"Menomonie, WI",32860.0,2019-10-01,-1,0,-1
"Menomonie, WI",32860.0,2019-11-01,26,0,26
"Menomonie, WI",32860.0,2019-12-01,-33,-14,-19
"Menomonie, WI",32860.0,2020-01-01,-7,-12,5
"Menomonie, WI",32860.0,2020-02-01,3,0,3
"Menomonie, WI",32860.0,2020-03-01,26,0,26
"Menomonie, WI",32860.0,2020-04-01,19,0,19
"Menomonie, WI",32860.0,2020-05-01,-50,0,-50
"Menomonie, WI",32860.0,2020-06-01,-18,0,-18
"Menomonie, WI",32860.0,2020-07-01,20,0,20
"Menomonie, WI",32860.0,2020-08-01,26,0,26
"Menomonie, WI",32860.0,2020-09-01,-7,0,-7
"Menomonie, WI",32860.0,2020-10-01,-11,-12,1
"Menomonie, WI",32860.0,2020-11-01,-8,0,-8
"Menomonie, WI",32860.0,2020-12-01,1,0,1
"Poughkeepsie-Newburgh-Middletown, NY",39100.0,2019-01-01,-143,-479,336
"Poughkeepsie-Newburgh-Middletown, NY",39100.0,2019-02-01,315,-12,327
"Poughkeepsie-Newburgh-Middletown, NY",39100.0,2019-03-01,290,14,276
"Poughkeepsie-Newburgh-Middletown, NY",39100.0,2019-04-01,615,238,377
"Poughkeepsie-Newburgh-Middletown, NY",39100.0,2019-05-01,366,373,-7
"Poughkeepsie-Newburgh-Middletown, NY",39100.0,2019-06-01,457,106,351
"Poughkeepsie-Newburgh-Middletown, NY",39100.0,2019-07-01,235,27,208
"Poughkeepsie-Newburgh-Middletown, NY",39100.0,2019-08-01,403,0,403
"Poughkeepsie-Newburgh-Middletown, NY",39100.0,2019-09-01,341,-11,352
"Poughkeepsie-Newburgh-Middletown, NY",39100.0,2019-10-01,82,-215,297
"Poughkeepsie-Newburgh-Middletown, NY",39100.0,2019-11-01,63,-149,212
"Poughkeepsie-Newburgh-Middletown, NY",39100.0,2019-12-01,-123,-373,250
"Poughkeepsie-Newburgh-Middletown, NY",39100.0,2020-01-01,-278,-368,90
"Poughkeepsie-Newburgh-Middletown, NY",39100.0,2020-02-01,253,0,253
"Poughkeepsie-Newburgh-Middletown, NY",39100.0,2020-03-01,1176,679,497
"Poughkeepsie-Newburgh-Middletown, NY",39100.0,2020-04-01,898,537,361
"Poughkeepsie-Newburgh-Middletown, NY",39100.0,2020-05-01,944,498,446
"Poughkeepsie-Newburgh-Middletown, NY",39100.0,2020-06-01,997,484,513
"Poughkeepsie-Newburgh-Middletown, NY",39100.0,2020-07-01,913,218,695
"Poughkeepsie-Newburgh-Middletown, NY",39100.0,2020-08-01,700,128,572
"Poughkeepsie-Newburgh-Middletown, NY",39100.0,2020-09-01,910,167,743
"Poughkeepsie-Newburgh-Middletown, NY",39100.0,2020-10-01,784,-35,819
"Poughkeepsie-Newburgh-Middletown, NY",39100.0,2020-11-01,519,-37,556
"Poughkeepsie-Newburgh-Middletown, NY",39100.0,2020-12-01,394,-163,557
"Alice, TX",10860.0,2019-01-01,0,0,0
"Alice, TX",10860.0,2019-02-01,16,0,16
"Alice, TX",10860.0,2019-03-01,9,0,9
"Alice, TX",10860.0,2019-04-01,0,0,0
"Alice, TX",10860.0,2019-05-01,-6,0,-6
"Alice, TX",10860.0,2019-06-01,27,0,27
"Alice, TX",10860.0,2019-07-01,3,0,3
"Alice, TX",10860.0,2019-08-01,0,0,0
"Alice, TX",10860.0,2019-09-01,37,0,37
"Alice, TX",10860.0,2019-10-01,14,0,14
"Alice, TX",10860.0,2019-11-01,-14,0,-14
"Alice, TX",10860.0,2019-12-01,-8,0,-8
"Alice, TX",10860.0,2020-01-01,20,0,20
"Alice, TX",10860.0,2020-02-01,14,0,14
"Alice, TX",10860.0,2020-03-01,-6,0,-6
"Alice, TX",10860.0,2020-04-01,9,0,9
"Alice, TX",10860.0,2020-05-01,1,0,1
"Alice, TX",10860.0,2020-06-01,17,0,17
"Alice, TX",10860.0,2020-07-01,27,0,27
"Alice, TX",10860.0,2020-08-01,21,0,21
"Alice, TX",10860.0,2020-09-01,49,0,49
"Alice, TX",10860.0,2020-10-01,22,0,22
"Alice, TX",10860.0,2020-11-01,14,0,14
"Alice, TX",10860.0,2020-12-01,-15,0,-15
"Dyersburg, TN",20540.0,2019-01-01,21,0,21
"Dyersburg, TN",20540.0,2019-02-01,6,0,6
"Dyersburg, TN",20540.0,2019-03-01,14,0,14
"Dyersburg, TN",20540.0,2019-04-01,-12,0,-12
"Dyersburg, TN",20540.0,2019-05-01,-14,0,-14
"Dyersburg, TN",20540.0,2019-06-01,-9,0,-9
"Dyersburg, TN",20540.0,2019-07-01,-14,0,-14
"Dyersburg, TN",20540.0,2019-08-01,8,0,8
"Dyersburg, TN",20540.0,2019-09-01,-7,0,-7
"Dyersburg, TN",20540.0,2019-10-01,-24,0,-24
"Dyersburg, TN",20540.0,2019-11-01,14,0,14
"Dyersburg, TN",20540.0,2019-12-01,3,0,3
"Dyersburg, TN",20540.0,2020-01-01,0,0,0
"Dyersburg, TN",20540.0,2020-02-01,0,0,0
"Dyersburg, TN",20540.0,2020-03-01,-31,0,-31
"Dyersburg, TN",20540.0,2020-04-01,-2,0,-2
"Dyersburg, TN",20540.0,2020-05-01,4,0,4
"Dyersburg, TN",20540.0,2020-06-01,-3,0,-3
"Dyersburg, TN",20540.0,2020-07-01,8,0,8
"Dyersburg, TN",20540.0,2020-08-01,-4,0,-4
"Dyersburg, TN",20540.0,2020-09-01,5,0,5
"Dyersburg, TN",20540.0,2020-10-01,7,0,7
"Dyersburg, TN",20540.0,2020-11-01,13,0,13
"Dyersburg, TN",20540.0,2020-12-01,4,0,4
"Edwards, CO",20780.0,2019-01-01,-12,-17,5
"Edwards, CO",20780.0,2019-02-01,-13,0,-13
"Edwards, CO",20780.0,2019-03-01,-25,0,-25
"Edwards, CO",20780.0,2019-04-01,10,0,10
"Edwards, CO",20780.0,2019-05-01,110,97,13
"Edwards, CO",20780.0,2019-06-01,147,110,37
"Edwards, CO",20780.0,2019-07-01,13,13,0
"Edwards, CO",20780.0,2019-08-01,-21,0,-21
"Edwards, CO",20780.0,2019-09-01,33,0,33
"Edwards, CO",20780.0,2019-10-01,-101,-75,-26
"Edwards, CO",20780.0,2019-11-01,42,0,42
"Edwards, CO",20780.0,2019-12-01,-16,-16,0
"Edwards, CO",20780.0,2020-01-01,-27,-19,-8
"Edwards, CO",20780.0,2020-02-01,20,0,20
"Edwards, CO",20780.0,2020-03-01,-10,-12,2
"Edwards, CO",20780.0,2020-04-01,-19,0,-19
"Edwards, CO",20780.0,2020-05-01,92,84,8
"Edwards, CO",20780.0,2020-06-01,142,113,29
"Edwards, CO",20780.0,2020-07-01,13,16,-3
"Edwards, CO",20780.0,2020-08-01,61,0,61
"Edwards, CO",20780.0,2020-09-01,48,0,48
"Edwards, CO",20780.0,2020-10-01,-52,-78,26
"Edwards, CO",20780.0,2020-11-01,51,-14,65
"Edwards, CO",20780.0,2020-12-01,41,13,28
"Odessa, TX",36220.0,2019-01-01,50,0,50
"Odessa, TX",36220.0,2019-02-01,-34,0,-34
"Odessa, TX",36220.0,2019-03-01,-41,0,-41
"Odessa, TX",36220.0,2019-04-01,-55,0,-55
"Odessa, TX",36220.0,2019-05-01,-133,0,-133
"Odessa, TX",36220.0,2019-06-01,-28,0,-28
"Odessa, TX",36220.0,2019-07-01,-18,0,-18
"Odessa, TX",36220.0,2019-08-01,20,0,20
"Odessa, TX",36220.0,2019-09-01,-22,0,-22
"Odessa, TX",36220.0,2019-10-01,-43,0,-43
"Odessa, TX",36220.0,2019-11-01,-23,0,-23
"Odessa, TX",36220.0,2019-12-01,-73,0,-73
"Odessa, TX",36220.0,2020-01-01,-80,0,-80
"Odessa, TX",36220.0,2020-02-01,-23,0,-23
"Odessa, TX",36220.0,2020-03-01,-92,0,-92
"Odessa, TX",36220.0,2020-04-01,-146,0,-146
"Odessa, TX",36220.0,2020-05-01,-243,0,-243
"Odessa, TX",36220.0,2020-06-01,-231,0,-231
"Odessa, TX",36220.0,2020-07-01,-143,0,-143
"Odessa, TX",36220.0,2020-08-01,-132,0,-132
"Odessa, TX",36220.0,2020-09-01,-142,0,-142
"Odessa, TX",36220.0,2020-10-01,-81,0,-81
"Odessa, TX",36220.0,2020-11-01,-45,0,-45
"Odessa, TX",36220.0,2020-12-01,-105,0,-105
"Carlsbad-Artesia, NM",16100.0,2019-01-01,-19,0,-19
"Carlsbad-Artesia, NM",16100.0,2019-02-01,-28,0,-28
"Carlsbad-Artesia, NM",16100.0,2019-03-01,2,0,2
"Carlsbad-Artesia, NM",16100.0,2019-04-01,-27,0,-27
"Carlsbad-Artesia, NM",16100.0,2019-05-01,-39,0,-39
"Carlsbad-Artesia, NM",16100.0,2019-06-01,-28,0,-28
"Carlsbad-Artesia, NM",16100.0,2019-07-01,-36,0,-36
"Carlsbad-Artesia, NM",16100.0,2019-08-01,-23,0,-23
"Carlsbad-Artesia, NM",16100.0,2019-09-01,-11,0,-11
"Carlsbad-Artesia, NM",16100.0,2019-10-01,-3,0,-3
"Carlsbad-Artesia, NM",16100.0,2019-11-01,2,0,2
"Carlsbad-Artesia, NM",16100.0,2019-12-01,0,0,0
"Carlsbad-Artesia, NM",16100.0,2020-01-01,-27,0,-27
"Carlsbad-Artesia, NM",16100.0,2020-02-01,-19,0,-19
"Carlsbad-Artesia, NM",16100.0,2020-03-01,-37,0,-37
"Carlsbad-Artesia, NM",16100.0,2020-04-01,-20,0,-20
"Carlsbad-Artesia, NM",16100.0,2020-05-01,-27,0,-27
"Carlsbad-Artesia, NM",16100.0,2020-06-01,17,0,17
"Carlsbad-Artesia, NM",16100.0,2020-07-01,-31,0,-31
"Carlsbad-Artesia, NM",16100.0,2020-08-01,-21,0,-21
"Carlsbad-Artesia, NM",16100.0,2020-09-01,-7,0,-7
"Carlsbad-Artesia, NM",16100.0,2020-10-01,-3,0,-3
"Carlsbad-Artesia, NM",16100.0,2020-11-01,-11,0,-11
"Carlsbad-Artesia, NM",16100.0,2020-12-01,-39,0,-39
"Rocky Mount, NC",40580.0,2019-01-01,13,0,13
"Rocky Mount, NC",40580.0,2019-02-01,2,0,2
"Rocky Mount, NC",40580.0,2019-03-01,-14,0,-14
"Rocky Mount, NC",40580.0,2019-04-01,-13,0,-13
"Rocky Mount, NC",40580.0,2019-05-01,52,0,52
"Rocky Mount, NC",40580.0,2019-06-01,-11,0,-11
"Rocky Mount, NC",40580.0,2019-07-01,-9,0,-9
"Rocky Mount, NC",40580.0,2019-08-01,26,0,26
"Rocky Mount, NC",40580.0,2019-09-01,-13,0,-13
"Rocky Mount, NC",40580.0,2019-10-01,47,0,47
"Rocky Mount, NC",40580.0,2019-11-01,5,0,5
"Rocky Mount, NC",40580.0,2019-12-01,11,0,11
"Rocky Mount, NC",40580.0,2020-01-01,0,0,0
"Rocky Mount, NC",40580.0,2020-02-01,-19,0,-19
"Rocky Mount, NC",40580.0,2020-03-01,38,0,38
"Rocky Mount, NC",40580.0,2020-04-01,74,0,74
"Rocky Mount, NC",40580.0,2020-05-01,81,0,81
"Rocky Mount, NC",40580.0,2020-06-01,-2,0,-2
"Rocky Mount, NC",40580.0,2020-07-01,-13,0,-13
"Rocky Mount, NC",40580.0,2020-08-01,14,0,14
"Rocky Mount, NC",40580.0,2020-09-01,-8,0,-8
"Rocky Mount, NC",40580.0,2020-10-01,66,0,66
"Rocky Mount, NC",40580.0,2020-11-01,-15,0,-15
"Rocky Mount, NC",40580.0,2020-12-01,-11,0,-11
"Effingham, IL",20820.0,2019-01-01,-15,0,-15
"Effingham, IL",20820.0,2019-02-01,2,0,2
"Effingham, IL",20820.0,2019-03-01,-2,0,-2
"Effingham, IL",20820.0,2019-04-01,-1,0,-1
"Effingham, IL",20820.0,2019-05-01,-22,0,-22
"Effingham, IL",20820.0,2019-06-01,0,0,0
"Effingham, IL",20820.0,2019-07-01,42,0,42
"Effingham, IL",20820.0,2019-08-01,0,0,0
"Effingham, IL",20820.0,2019-09-01,0,0,0
"Effingham, IL",20820.0,2019-10-01,11,0,11
"Effingham, IL",20820.0,2019-11-01,24,0,24
"Effingham, IL",20820.0,2019-12-01,-11,0,-11
"Effingham, IL",20820.0,2020-01-01,12,0,12
"Effingham, IL",20820.0,2020-02-01,-13,0,-13
"Effingham, IL",20820.0,2020-03-01,14,0,14
"Effingham, IL",20820.0,2020-04-01,11,0,11
"Effingham, IL",20820.0,2020-05-01,-6,0,-6
"Effingham, IL",20820.0,2020-06-01,0,0,0
"Effingham, IL",20820.0,2020-07-01,0,0,0
"Effingham, IL",20820.0,2020-08-01,-1,0,-1
"Effingham, IL",20820.0,2020-09-01,-28,0,-28
"Effingham, IL",20820.0,2020-10-01,-35,0,-35
"Effingham, IL",20820.0,2020-11-01,-17,0,-17
"Effingham, IL",20820.0,2020-12-01,0,0,0
"Sacramento-Roseville-Folsom, CA",40900.0,2019-01-01,558,-19,577
"Sacramento-Roseville-Folsom, CA",40900.0,2019-02-01,722,40,682
"Sacramento-Roseville-Folsom, CA",40900.0,2019-03-01,685,17,668
"Sacramento-Roseville-Folsom, CA",40900.0,2019-04-01,553,60,493
"Sacramento-Roseville-Folsom, CA",40900.0,2019-05-01,1101,119,982
"Sacramento-Roseville-Folsom, CA",40900.0,2019-06-01,1134,150,984
"Sacramento-Roseville-Folsom, CA",40900.0,2019-07-01,871,32,839
"Sacramento-Roseville-Folsom, CA",40900.0,2019-08-01,496,13,483
"Sacramento-Roseville-Folsom, CA",40900.0,2019-09-01,274,-25,299
"Sacramento-Roseville-Folsom, CA",40900.0,2019-10-01,312,-169,481
"Sacramento-Roseville-Folsom, CA",40900.0,2019-11-01,469,-66,535
"Sacramento-Roseville-Folsom, CA",40900.0,2019-12-01,413,-94,507
"Sacramento-Roseville-Folsom, CA",40900.0,2020-01-01,483,-107,590
"Sacramento-Roseville-Folsom, CA",40900.0,2020-02-01,342,-42,384
"Sacramento-Roseville-Folsom, CA",40900.0,2020-03-01,1115,304,811
"Sacramento-Roseville-Folsom, CA",40900.0,2020-04-01,1086,270,816
"Sacramento-Roseville-Folsom, CA",40900.0,2020-05-01,1495,191,1304
"Sacramento-Roseville-Folsom, CA",40900.0,2020-06-01,1605,233,1372
"Sacramento-Roseville-Folsom, CA",40900.0,2020-07-01,1487,47,1440
"Sacramento-Roseville-Folsom, CA",40900.0,2020-08-01,1098,57,1041
"Sacramento-Roseville-Folsom, CA",40900.0,2020-09-01,1254,84,1170
"Sacramento-Roseville-Folsom, CA",40900.0,2020-10-01,1380,-14,1394
"Sacramento-Roseville-Folsom, CA",40900.0,2020-11-01,1118,7,1111
"Sacramento-Roseville-Folsom, CA",40900.0,2020-12-01,712,60,652
"Colorado Springs, CO",17820.0,2019-01-01,56,-166,222
"Colorado Springs, CO",17820.0,2019-02-01,11,-16,27
"Colorado Springs, CO",17820.0,2019-03-01,237,25,212
"Colorado Springs, CO",17820.0,2019-04-01,304,123,181
"Colorado Springs, CO",17820.0,2019-05-01,-198,257,-455
"Colorado Springs, CO",17820.0,2019-06-01,494,58,436
"Colorado Springs, CO",17820.0,2019-07-01,434,12,422
"Colorado Springs, CO",17820.0,2019-08-01,83,-5,88
"Colorado Springs, CO",17820.0,2019-09-01,-125,-12,-113
"Colorado Springs, CO",17820.0,2019-10-01,-258,-255,-3
"Colorado Springs, CO",17820.0,2019-11-01,-58,-140,82
"Colorado Springs, CO",17820.0,2019-12-01,-130,-126,-4
"Colorado Springs, CO",17820.0,2020-01-01,-125,-164,39
"Colorado Springs, CO",17820.0,2020-02-01,83,-42,125
"Colorado Springs, CO",17820.0,2020-03-01,-98,-228,130
"Colorado Springs, CO",17820.0,2020-04-01,-400,-13,-387
"Colorado Springs, CO",17820.0,2020-05-01,376,225,151
"Colorado Springs, CO",17820.0,2020-06-01,387,108,279
"Colorado Springs, CO",17820.0,2020-07-01,406,59,347
"Colorado Springs, CO",17820.0,2020-08-01,485,15,470
"Colorado Springs, CO",17820.0,2020-09-01,343,-25,368
"Colorado Springs, CO",17820.0,2020-10-01,167,-198,365
"Colorado Springs, CO",17820.0,2020-11-01,175,-161,336
"Colorado Springs, CO",17820.0,2020-12-01,64,-145,209
"El Paso, TX",21340.0,2019-01-01,-20,-11,-9
"El Paso, TX",21340.0,2019-02-01,48,0,48
"El Paso, TX",21340.0,2019-03-01,-39,0,-39
"El Paso, TX",21340.0,2019-04-01,-27,0,-27
"El Paso, TX",21340.0,2019-05-01,-62,0,-62
"El Paso, TX",21340.0,2019-06-01,-210,0,-210
"El Paso, TX",21340.0,2019-07-01,-654,0,-654
"El Paso, TX",21340.0,2019-08-01,21,0,21
"El Paso, TX",21340.0,2019-09-01,-20,0,-20
"El Paso, TX",21340.0,2019-10-01,-110,-12,-98
"El Paso, TX",21340.0,2019-11-01,8,0,8
"El Paso, TX",21340.0,2019-12-01,-22,0,-22
"El Paso, TX",21340.0,2020-01-01,-49,15,-64
"El Paso, TX",21340.0,2020-02-01,164,0,164
"El Paso, TX",21340.0,2020-03-01,-83,11,-94
"El Paso, TX",21340.0,2020-04-01,102,2,100
"El Paso, TX",21340.0,2020-05-01,132,0,132
"El Paso, TX",21340.0,2020-06-01,-26,0,-26
"El Paso, TX",21340.0,2020-07-01,-14,0,-14
"El Paso, TX",21340.0,2020-08-01,-6,0,-6
"El Paso, TX",21340.0,2020-09-01,-18,0,-18
"El Paso, TX",21340.0,2020-10-01,10,43,-33
"El Paso, TX",21340.0,2020-11-01,-28,11,-39
"El Paso, TX",21340.0,2020-12-01,-118,-11,-107
"St. Marys, PA",41260.0,2019-01-01,0,0,0
"St. Marys, PA",41260.0,2019-02-01,0,0,0
"St. Marys, PA",41260.0,2019-03-01,0,0,0
"St. Marys, PA",41260.0,2019-04-01,0,0,0
"St. Marys, PA",41260.0,2019-05-01,12,0,12
"St. Marys, PA",41260.0,2019-06-01,22,0,22
"St. Marys, PA",41260.0,2019-07-01,9,0,9
"St. Marys, PA",41260.0,2019-08-01,0,0,0
"St. Marys, PA",41260.0,2019-09-01,11,0,11
"St. Marys, PA",41260.0,2019-10-01,17,0,17
"St. Marys, PA",41260.0,2019-11-01,0,0,0
"St. Marys, PA",41260.0,2019-12-01,0,0,0
"St. Marys, PA",41260.0,2020-01-01,-19,0,-19
"St. Marys, PA",41260.0,2020-02-01,0,0,0
"St. Marys, PA",41260.0,2020-03-01,16,0,16
"St. Marys, PA",41260.0,2020-04-01,0,0,0
"St. Marys, PA",41260.0,2020-05-01,0,0,0
"St. Marys, PA",41260.0,2020-06-01,0,0,0
"St. Marys, PA",41260.0,2020-07-01,19,0,19
"St. Marys, PA",41260.0,2020-08-01,-15,0,-15
"St. Marys, PA",41260.0,2020-09-01,-13,0,-13
"St. Marys, PA",41260.0,2020-10-01,0,0,0
"St. Marys, PA",41260.0,2020-11-01,0,0,0
"St. Marys, PA",41260.0,2020-12-01,13,0,13
"Elkhart-Goshen, IN",21140.0,2019-01-01,-73,-73,0
"Elkhart-Goshen, IN",21140.0,2019-02-01,-70,0,-70
"Elkhart-Goshen, IN",21140.0,2019-03-01,-15,0,-15
"Elkhart-Goshen, IN",21140.0,2019-04-01,160,111,49
"Elkhart-Goshen, IN",21140.0,2019-05-01,85,49,36
"Elkhart-Goshen, IN",21140.0,2019-06-01,60,0,60
"Elkhart-Goshen, IN",21140.0,2019-07-01,-8,0,-8
"Elkhart-Goshen, IN",21140.0,2019-08-01,-24,0,-24
"Elkhart-Goshen, IN",21140.0,2019-09-01,-37,0,-37
"Elkhart-Goshen, IN",21140.0,2019-10-01,-120,-116,-4
"Elkhart-Goshen, IN",21140.0,2019-11-01,-141,-125,-16
"Elkhart-Goshen, IN",21140.0,2019-12-01,-247,-181,-66
"Elkhart-Goshen, IN",21140.0,2020-01-01,-116,-69,-47
"Elkhart-Goshen, IN",21140.0,2020-02-01,26,0,26
"Elkhart-Goshen, IN",21140.0,2020-03-01,-6,37,-43
"Elkhart-Goshen, IN",21140.0,2020-04-01,-16,44,-60
"Elkhart-Goshen, IN",21140.0,2020-05-01,38,53,-15
"Elkhart-Goshen, IN",21140.0,2020-06-01,30,0,30
"Elkhart-Goshen, IN",21140.0,2020-07-01,-51,0,-51
"Elkhart-Goshen, IN",21140.0,2020-08-01,12,0,12
"Elkhart-Goshen, IN",21140.0,2020-09-01,4,0,4
"Elkhart-Goshen, IN",21140.0,2020-10-01,-203,-141,-62
"Elkhart-Goshen, IN",21140.0,2020-11-01,-146,-98,-48
"Elkhart-Goshen, IN",21140.0,2020-12-01,-213,-117,-96
"Elko, NV",21220.0,2019-01-01,0,0,0
"Elko, NV",21220.0,2019-02-01,0,0,0
"Elko, NV",21220.0,2019-03-01,-12,0,-12
"Elko, NV",21220.0,2019-04-01,-37,0,-37
"Elko, NV",21220.0,2019-05-01,20,0,20
"Elko, NV",21220.0,2019-06-01,30,0,30
"Elko, NV",21220.0,2019-07-01,-1,0,-1
"Elko, NV",21220.0,2019-08-01,-40,0,-40
"Elko, NV",21220.0,2019-09-01,0,0,0
"Elko, NV",21220.0,2019-10-01,-10,0,-10
"Elko, NV",21220.0,2019-11-01,-14,0,-14
"Elko, NV",21220.0,2019-12-01,0,0,0
"Elko, NV",21220.0,2020-01-01,-2,0,-2
"Elko, NV",21220.0,2020-02-01,2,0,2
"Elko, NV",21220.0,2020-03-01,19,0,19
"Elko, NV",21220.0,2020-04-01,34,0,34
"Elko, NV",21220.0,2020-05-01,38,13,25
"Elko, NV",21220.0,2020-06-01,35,0,35
"Elko, NV",21220.0,2020-07-01,-29,0,-29
"Elko, NV",21220.0,2020-08-01,24,0,24
"Elko, NV",21220.0,2020-09-01,20,0,20
"Elko, NV",21220.0,2020-10-01,4,0,4
"Elko, NV",21220.0,2020-11-01,12,0,12
"Elko, NV",21220.0,2020-12-01,12,0,12
"Hays, KS",25700.0,2019-01-01,13,0,13
"Hays, KS",25700.0,2019-02-01,0,0,0
"Hays, KS",25700.0,2019-03-01,0,0,0
"Hays, KS",25700.0,2019-04-01,0,0,0
"Hays, KS",25700.0,2019-05-01,-53,0,-53
"Hays, KS",25700.0,2019-06-01,13,0,13
"Hays, KS",25700.0,2019-07-01,-16,0,-16
"Hays, KS",25700.0,2019-08-01,-23,0,-23
"Hays, KS",25700.0,2019-09-01,0,0,0
"Hays, KS",25700.0,2019-10-01,0,0,0
"Hays, KS",25700.0,2019-11-01,0,0,0
"Hays, KS",25700.0,2019-12-01,11,0,11
"Hays, KS",25700.0,2020-01-01,0,0,0
"Hays, KS",25700.0,2020-02-01,0,0,0
"Hays, KS",25700.0,2020-03-01,-23,0,-23
"Hays, KS",25700.0,2020-04-01,0,0,0
"Hays, KS",25700.0,2020-05-01,-36,0,-36
"Hays, KS",25700.0,2020-06-01,-29,0,-29
"Hays, KS",25700.0,2020-07-01,-11,0,-11
"Hays, KS",25700.0,2020-08-01,0,0,0
"Hays, KS",25700.0,2020-09-01,0,0,0
"Hays, KS",25700.0,2020-10-01,0,0,0
"Hays, KS",25700.0,2020-11-01,0,0,0
"Hays, KS",25700.0,2020-12-01,0,0,0
"Mountain Home, ID",34300.0,2019-01-01,0,0,0
"Mountain Home, ID",34300.0,2019-02-01,-15,0,-15
"Mountain Home, ID",34300.0,2019-03-01,49,0,49
"Mountain Home, ID",34300.0,2019-04-01,20,0,20
"Mountain Home, ID",34300.0,2019-05-01,30,0,30
"Mountain Home, ID",34300.0,2019-06-01,25,0,25
"Mountain Home, ID",34300.0,2019-07-01,44,0,44
"Mountain Home, ID",34300.0,2019-08-01,19,0,19
"Mountain Home, ID",34300.0,2019-09-01,13,0,13
"Mountain Home, ID",34300.0,2019-10-01,13,0,13
"Mountain Home, ID",34300.0,2019-11-01,16,0,16
"Mountain Home, ID",34300.0,2019-12-01,5,0,5
"Mountain Home, ID",34300.0,2020-01-01,30,0,30
"Mountain Home, ID",34300.0,2020-02-01,0,0,0
"Mountain Home, ID",34300.0,2020-03-01,26,0,26
"Mountain Home, ID",34300.0,2020-04-01,50,0,50
"Mountain Home, ID",34300.0,2020-05-01,6,0,6
"Mountain Home, ID",34300.0,2020-06-01,25,0,25
"Mountain Home, ID",34300.0,2020-07-01,18,0,18
"Mountain Home, ID",34300.0,2020-08-01,0,0,0
"Mountain Home, ID",34300.0,2020-09-01,22,0,22
"Mountain Home, ID",34300.0,2020-10-01,35,0,35
"Mountain Home, ID",34300.0,2020-11-01,11,0,11
"Mountain Home, ID",34300.0,2020-12-01,20,0,20
"Stephenville, TX",44500.0,2019-01-01,-7,0,-7
"Stephenville, TX",44500.0,2019-02-01,1,0,1
"Stephenville, TX",44500.0,2019-03-01,20,0,20
"Stephenville, TX",44500.0,2019-04-01,-2,0,-2
"Stephenville, TX",44500.0,2019-05-01,-41,0,-41
"Stephenville, TX",44500.0,2019-06-01,7,0,7
"Stephenville, TX",44500.0,2019-07-01,-6,0,-6
"Stephenville, TX",44500.0,2019-08-01,-40,0,-40
"Stephenville, TX",44500.0,2019-09-01,14,0,14
"Stephenville, TX",44500.0,2019-10-01,-17,0,-17
"Stephenville, TX",44500.0,2019-11-01,-15,0,-15
"Stephenville, TX",44500.0,2019-12-01,32,0,32
"Stephenville, TX",44500.0,2020-01-01,1,0,1
"Stephenville, TX",44500.0,2020-02-01,7,0,7
"Stephenville, TX",44500.0,2020-03-01,-1,0,-1
"Stephenville, TX",44500.0,2020-04-01,-39,0,-39
"Stephenville, TX",44500.0,2020-05-01,5,0,5
"Stephenville, TX",44500.0,2020-06-01,-16,0,-16
"Stephenville, TX",44500.0,2020-07-01,21,0,21
"Stephenville, TX",44500.0,2020-08-01,4,0,4
"Stephenville, TX",44500.0,2020-09-01,-6,0,-6
"Stephenville, TX",44500.0,2020-10-01,5,0,5
"Stephenville, TX",44500.0,2020-11-01,21,0,21
"Stephenville, TX",44500.0,2020-12-01,29,0,29
"Buffalo-Cheektowaga, NY",15380.0,2019-01-01,-1605,-1633,28
"Buffalo-Cheektowaga, NY",15380.0,2019-02-01,-402,-295,-107
"Buffalo-Cheektowaga, NY",15380.0,2019-03-01,152,-14,166
"Buffalo-Cheektowaga, NY",15380.0,2019-04-01,1641,955,686
"Buffalo-Cheektowaga, NY",15380.0,2019-05-01,2157,1788,369
"Buffalo-Cheektowaga, NY",15380.0,2019-06-01,393,415,-22
"Buffalo-Cheektowaga, NY",15380.0,2019-07-01,-83,80,-163
"Buffalo-Cheektowaga, NY",15380.0,2019-08-01,-81,0,-81
"Buffalo-Cheektowaga, NY",15380.0,2019-09-01,-312,-149,-163
"Buffalo-Cheektowaga, NY",15380.0,2019-10-01,-1551,-1260,-291
"Buffalo-Cheektowaga, NY",15380.0,2019-11-01,-964,-868,-96
"Buffalo-Cheektowaga, NY",15380.0,2019-12-01,-1348,-1209,-139
"Buffalo-Cheektowaga, NY",15380.0,2020-01-01,-1767,-1726,-41
"Buffalo-Cheektowaga, NY",15380.0,2020-02-01,-357,-270,-87
"Buffalo-Cheektowaga, NY",15380.0,2020-03-01,531,163,368
"Buffalo-Cheektowaga, NY",15380.0,2020-04-01,643,267,376
"Buffalo-Cheektowaga, NY",15380.0,2020-05-01,1364,1013,351
"Buffalo-Cheektowaga, NY",15380.0,2020-06-01,953,814,139
"Buffalo-Cheektowaga, NY",15380.0,2020-07-01,404,200,204
"Buffalo-Cheektowaga, NY",15380.0,2020-08-01,199,64,135
"Buffalo-Cheektowaga, NY",15380.0,2020-09-01,33,-15,48
"Buffalo-Cheektowaga, NY",15380.0,2020-10-01,-1152,-1003,-149
"Buffalo-Cheektowaga, NY",15380.0,2020-11-01,-726,-723,-3
"Buffalo-Cheektowaga, NY",15380.0,2020-12-01,-986,-1064,78
"Sandusky, OH",41780.0,2019-01-01,-87,-76,-11
"Sandusky, OH",41780.0,2019-02-01,-22,-12,-10
"Sandusky, OH",41780.0,2019-03-01,28,0,28
"Sandusky, OH",41780.0,2019-04-01,149,67,82
"Sandusky, OH",41780.0,2019-05-01,53,106,-53
"Sandusky, OH",41780.0,2019-06-01,16,0,16
"Sandusky, OH",41780.0,2019-07-01,34,0,34
"Sandusky, OH",41780.0,2019-08-01,-17,0,-17
"Sandusky, OH",41780.0,2019-09-01,-21,0,-21
"Sandusky, OH",41780.0,2019-10-01,-137,-91,-46
"Sandusky, OH",41780.0,2019-11-01,-70,-66,-4
"Sandusky, OH",41780.0,2019-12-01,-67,-103,36
"Sandusky, OH",41780.0,2020-01-01,-101,-70,-31
"Sandusky, OH",41780.0,2020-02-01,7,0,7
"Sandusky, OH",41780.0,2020-03-01,6,0,6
"Sandusky, OH",41780.0,2020-04-01,49,34,15
"Sandusky, OH",41780.0,2020-05-01,126,66,60
"Sandusky, OH",41780.0,2020-06-01,-24,0,-24
"Sandusky, OH",41780.0,2020-07-01,22,0,22
"Sandusky, OH",41780.0,2020-08-01,21,0,21
"Sandusky, OH",41780.0,2020-09-01,12,0,12
"Sandusky, OH",41780.0,2020-10-01,-58,-49,-9
"Sandusky, OH",41780.0,2020-11-01,-27,-52,25
"Sandusky, OH",41780.0,2020-12-01,-40,-55,15
"Erie, PA",21500.0,2019-01-01,-324,-322,-2
"Erie, PA",21500.0,2019-02-01,-13,-16,3
"Erie, PA",21500.0,2019-03-01,2,0,2
"Erie, PA",21500.0,2019-04-01,406,241,165
"Erie, PA",21500.0,2019-05-01,336,312,24
"Erie, PA",21500.0,2019-06-01,-18,60,-78
"Erie, PA",21500.0,2019-07-01,-43,0,-43
"Erie, PA",21500.0,2019-08-01,6,0,6
"Erie, PA",21500.0,2019-09-01,-39,0,-39
"Erie, PA",21500.0,2019-10-01,-298,-262,-36
"Erie, PA",21500.0,2019-11-01,-181,-200,19
"Erie, PA",21500.0,2019-12-01,-306,-302,-4
"Erie, PA",21500.0,2020-01-01,-265,-285,20
"Erie, PA",21500.0,2020-02-01,-28,-12,-16
"Erie, PA",21500.0,2020-03-01,76,40,36
"Erie, PA",21500.0,2020-04-01,99,64,35
"Erie, PA",21500.0,2020-05-01,241,218,23
"Erie, PA",21500.0,2020-06-01,-4,90,-94
"Erie, PA",21500.0,2020-07-01,-26,19,-45
"Erie, PA",21500.0,2020-08-01,6,0,6
"Erie, PA",21500.0,2020-09-01,-64,-12,-52
"Erie, PA",21500.0,2020-10-01,-233,-244,11
"Erie, PA",21500.0,2020-11-01,-250,-224,-26
"Erie, PA",21500.0,2020-12-01,-283,-214,-69
"Atmore, AL",12120.0,2019-01-01,13,0,13
"Atmore, AL",12120.0,2019-02-01,28,0,28
"Atmore, AL",12120.0,2019-03-01,11,0,11
"Atmore, AL",12120.0,2019-04-01,-25,0,-25
"Atmore, AL",12120.0,2019-05-01,12,0,12
"Atmore, AL",12120.0,2019-06-01,-32,0,-32
"Atmore, AL",12120.0,2019-07-01,-27,0,-27
"Atmore, AL",12120.0,2019-08-01,16,0,16
"Atmore, AL",12120.0,2019-09-01,13,0,13
"Atmore, AL",12120.0,2019-10-01,-16,0,-16
"Atmore, AL",12120.0,2019-11-01,-19,0,-19
"Atmore, AL",12120.0,2019-12-01,3,0,3
"Atmore, AL",12120.0,2020-01-01,-13,0,-13
"Atmore, AL",12120.0,2020-02-01,-5,0,-5
"Atmore, AL",12120.0,2020-03-01,17,0,17
"Atmore, AL",12120.0,2020-04-01,24,0,24
"Atmore, AL",12120.0,2020-05-01,1,0,1
"Atmore, AL",12120.0,2020-06-01,4,0,4
"Atmore, AL",12120.0,2020-07-01,17,0,17
"Atmore, AL",12120.0,2020-08-01,-4,0,-4
"Atmore, AL",12120.0,2020-09-01,0,0,0
"Atmore, AL",12120.0,2020-10-01,29,0,29
"Atmore, AL",12120.0,2020-11-01,-16,0,-16
"Atmore, AL",12120.0,2020-12-01,23,0,23
"Pensacola-Ferry Pass-Brent, FL",37860.0,2019-01-01,-43,0,-43
"Pensacola-Ferry Pass-Brent, FL",37860.0,2019-02-01,-13,0,-13
"Pensacola-Ferry Pass-Brent, FL",37860.0,2019-03-01,47,0,47
"Pensacola-Ferry Pass-Brent, FL",37860.0,2019-04-01,78,0,78
"Pensacola-Ferry Pass-Brent, FL",37860.0,2019-05-01,-37,0,-37
"Pensacola-Ferry Pass-Brent, FL",37860.0,2019-06-01,108,0,108
"Pensacola-Ferry Pass-Brent, FL",37860.0,2019-07-01,-29,0,-29
"Pensacola-Ferry Pass-Brent, FL",37860.0,2019-08-01,-38,0,-38
"Pensacola-Ferry Pass-Brent, FL",37860.0,2019-09-01,28,0,28
"Pensacola-Ferry Pass-Brent, FL",37860.0,2019-10-01,-33,0,-33
"Pensacola-Ferry Pass-Brent, FL",37860.0,2019-11-01,10,0,10
"Pensacola-Ferry Pass-Brent, FL",37860.0,2019-12-01,5,0,5
"Pensacola-Ferry Pass-Brent, FL",37860.0,2020-01-01,-14,0,-14
"Pensacola-Ferry Pass-Brent, FL",37860.0,2020-02-01,-7,0,-7
"Pensacola-Ferry Pass-Brent, FL",37860.0,2020-03-01,-70,0,-70
"Pensacola-Ferry Pass-Brent, FL",37860.0,2020-04-01,-17,0,-17
"Pensacola-Ferry Pass-Brent, FL",37860.0,2020-05-01,144,0,144
"Pensacola-Ferry Pass-Brent, FL",37860.0,2020-06-01,90,13,77
"Pensacola-Ferry Pass-Brent, FL",37860.0,2020-07-01,-2,0,-2
"Pensacola-Ferry Pass-Brent, FL",37860.0,2020-08-01,-131,0,-131
"Pensacola-Ferry Pass-Brent, FL",37860.0,2020-09-01,-81,0,-81
"Pensacola-Ferry Pass-Brent, FL",37860.0,2020-10-01,-103,0,-103
"Pensacola-Ferry Pass-Brent, FL",37860.0,2020-11-01,-58,0,-58
"Pensacola-Ferry Pass-Brent, FL",37860.0,2020-12-01,-29,0,-29
"Boston-Cambridge-Newton, MA-NH",14460.0,2019-01-01,-5675,-4436,-1239
"Boston-Cambridge-Newton, MA-NH",14460.0,2019-02-01,-1587,-665,-922
"Boston-Cambridge-Newton, MA-NH",14460.0,2019-03-01,-418,72,-490
"Boston-Cambridge-Newton, MA-NH",14460.0,2019-04-01,3341,2823,518
"Boston-Cambridge-Newton, MA-NH",14460.0,2019-05-01,4531,5427,-896
"Boston-Cambridge-Newton, MA-NH",14460.0,2019-06-01,-2223,157,-2380
"Boston-Cambridge-Newton, MA-NH",14460.0,2019-07-01,-2413,68,-2481
"Boston-Cambridge-Newton, MA-NH",14460.0,2019-08-01,-4209,70,-4279
"Boston-Cambridge-Newton, MA-NH",14460.0,2019-09-01,-2721,-163,-2558
"Boston-Cambridge-Newton, MA-NH",14460.0,2019-10-01,-5040,-2686,-2354
"Boston-Cambridge-Newton, MA-NH",14460.0,2019-11-01,-2501,-1379,-1122
"Boston-Cambridge-Newton, MA-NH",14460.0,2019-12-01,-5662,-4279,-1383
"Boston-Cambridge-Newton, MA-NH",14460.0,2020-01-01,-5844,-4382,-1462
"Boston-Cambridge-Newton, MA-NH",14460.0,2020-02-01,-1213,-687,-526
"Boston-Cambridge-Newton, MA-NH",14460.0,2020-03-01,-801,-263,-538
"Boston-Cambridge-Newton, MA-NH",14460.0,2020-04-01,-1290,-326,-964
"Boston-Cambridge-Newton, MA-NH",14460.0,2020-05-01,-185,1244,-1429
"Boston-Cambridge-Newton, MA-NH",14460.0,2020-06-01,-1086,1370,-2456
"Boston-Cambridge-Newton, MA-NH",14460.0,2020-07-01,-2610,573,-3183
"Boston-Cambridge-Newton, MA-NH",14460.0,2020-08-01,-5441,1,-5442
"Boston-Cambridge-Newton, MA-NH",14460.0,2020-09-01,-3498,-293,-3205
"Boston-Cambridge-Newton, MA-NH",14460.0,2020-10-01,-4757,-2260,-2497
"Boston-Cambridge-Newton, MA-NH",14460.0,2020-11-01,-4450,-2187,-2263
"Boston-Cambridge-Newton, MA-NH",14460.0,2020-12-01,-6089,-3940,-2149
"Richmond-Berea, KY",40080.0,2019-01-01,-9,0,-9
"Richmond-Berea, KY",40080.0,2019-02-01,14,0,14
"Richmond-Berea, KY",40080.0,2019-03-01,39,0,39
"Richmond-Berea, KY",40080.0,2019-04-01,7,0,7
"Richmond-Berea, KY",40080.0,2019-05-01,23,0,23
"Richmond-Berea, KY",40080.0,2019-06-01,32,0,32
"Richmond-Berea, KY",40080.0,2019-07-01,3,0,3
"Richmond-Berea, KY",40080.0,2019-08-01,49,0,49
"Richmond-Berea, KY",40080.0,2019-09-01,31,0,31
"Richmond-Berea, KY",40080.0,2019-10-01,21,0,21
"Richmond-Berea, KY",40080.0,2019-11-01,-13,0,-13
"Richmond-Berea, KY",40080.0,2019-12-01,7,0,7
"Richmond-Berea, KY",40080.0,2020-01-01,-22,0,-22
"Richmond-Berea, KY",40080.0,2020-02-01,14,0,14
"Richmond-Berea, KY",40080.0,2020-03-01,32,0,32
"Richmond-Berea, KY",40080.0,2020-04-01,15,0,15
"Richmond-Berea, KY",40080.0,2020-05-01,9,0,9
"Richmond-Berea, KY",40080.0,2020-06-01,35,0,35
"Richmond-Berea, KY",40080.0,2020-07-01,57,0,57
"Richmond-Berea, KY",40080.0,2020-08-01,39,0,39
"Richmond-Berea, KY",40080.0,2020-09-01,6,0,6
"Richmond-Berea, KY",40080.0,2020-10-01,55,0,55
"Richmond-Berea, KY",40080.0,2020-11-01,53,0,53
"Richmond-Berea, KY",40080.0,2020-12-01,-20,0,-20
"Gadsden, AL",23460.0,2019-01-01,-23,0,-23
"Gadsden, AL",23460.0,2019-02-01,-29,0,-29
"Gadsden, AL",23460.0,2019-03-01,24,0,24
"Gadsden, AL",23460.0,2019-04-01,-40,0,-40
"Gadsden, AL",23460.0,2019-05-01,8,0,8
"Gadsden, AL",23460.0,2019-06-01,-29,0,-29
"Gadsden, AL",23460.0,2019-07-01,9,0,9
"Gadsden, AL",23460.0,2019-08-01,24,0,24
"Gadsden, AL",23460.0,2019-09-01,18,0,18
"Gadsden, AL",23460.0,2019-10-01,39,0,39
"Gadsden, AL",23460.0,2019-11-01,18,0,18
"Gadsden, AL",23460.0,2019-12-01,45,0,45
"Gadsden, AL",23460.0,2020-01-01,58,0,58
"Gadsden, AL",23460.0,2020-02-01,34,0,34
"Gadsden, AL",23460.0,2020-03-01,-2,0,-2
"Gadsden, AL",23460.0,2020-04-01,-4,0,-4
"Gadsden, AL",23460.0,2020-05-01,-6,0,-6
"Gadsden, AL",23460.0,2020-06-01,65,0,65
"Gadsden, AL",23460.0,2020-07-01,73,0,73
"Gadsden, AL",23460.0,2020-08-01,3,0,3
"Gadsden, AL",23460.0,2020-09-01,-8,0,-8
"Gadsden, AL",23460.0,2020-10-01,-18,0,-18
"Gadsden, AL",23460.0,2020-11-01,-26,0,-26
"Gadsden, AL",23460.0,2020-12-01,-14,0,-14
"Fairbanks, AK",21820.0,2019-01-01,-6,-12,6
"Fairbanks, AK",21820.0,2019-02-01,-4,0,-4
"Fairbanks, AK",21820.0,2019-03-01,1,0,1
"Fairbanks, AK",21820.0,2019-04-01,11,0,11
"Fairbanks, AK",21820.0,2019-05-01,2,27,-25
"Fairbanks, AK",21820.0,2019-06-01,-33,0,-33
"Fairbanks, AK",21820.0,2019-07-01,-61,0,-61
"Fairbanks, AK",21820.0,2019-08-01,-33,0,-33
"Fairbanks, AK",21820.0,2019-09-01,-29,0,-29
"Fairbanks, AK",21820.0,2019-10-01,-21,-27,6
"Fairbanks, AK",21820.0,2019-11-01,-36,-35,-1
"Fairbanks, AK",21820.0,2019-12-01,6,0,6
"Fairbanks, AK",21820.0,2020-01-01,-15,0,-15
"Fairbanks, AK",21820.0,2020-02-01,15,0,15
"Fairbanks, AK",21820.0,2020-03-01,19,0,19
"Fairbanks, AK",21820.0,2020-04-01,-29,0,-29
"Fairbanks, AK",21820.0,2020-05-01,20,27,-7
"Fairbanks, AK",21820.0,2020-06-01,11,0,11
"Fairbanks, AK",21820.0,2020-07-01,-27,0,-27
"Fairbanks, AK",21820.0,2020-08-01,-4,0,-4
"Fairbanks, AK",21820.0,2020-09-01,3,-11,14
"Fairbanks, AK",21820.0,2020-10-01,-18,-29,11
"Fairbanks, AK",21820.0,2020-11-01,-2,-11,9
"Fairbanks, AK",21820.0,2020-12-01,-17,-12,-5
"Bridgeport-Stamford-Norwalk, CT",14860.0,2019-01-01,-728,-708,-20
"Bridgeport-Stamford-Norwalk, CT",14860.0,2019-02-01,-56,-54,-2
"Bridgeport-Stamford-Norwalk, CT",14860.0,2019-03-01,95,31,64
"Bridgeport-Stamford-Norwalk, CT",14860.0,2019-04-01,976,637,339
"Bridgeport-Stamford-Norwalk, CT",14860.0,2019-05-01,1771,1474,297
"Bridgeport-Stamford-Norwalk, CT",14860.0,2019-06-01,299,342,-43
"Bridgeport-Stamford-Norwalk, CT",14860.0,2019-07-01,-40,175,-215
"Bridgeport-Stamford-Norwalk, CT",14860.0,2019-08-01,82,89,-7
"Bridgeport-Stamford-Norwalk, CT",14860.0,2019-09-01,-138,-13,-125
"Bridgeport-Stamford-Norwalk, CT",14860.0,2019-10-01,-842,-580,-262
"Bridgeport-Stamford-Norwalk, CT",14860.0,2019-11-01,-117,-205,88
"Bridgeport-Stamford-Norwalk, CT",14860.0,2019-12-01,-891,-791,-100
"Bridgeport-Stamford-Norwalk, CT",14860.0,2020-01-01,-722,-716,-6
"Bridgeport-Stamford-Norwalk, CT",14860.0,2020-02-01,-11,-36,25
"Bridgeport-Stamford-Norwalk, CT",14860.0,2020-03-01,1654,1163,491
"Bridgeport-Stamford-Norwalk, CT",14860.0,2020-04-01,1187,703,484
"Bridgeport-Stamford-Norwalk, CT",14860.0,2020-05-01,1748,865,883
"Bridgeport-Stamford-Norwalk, CT",14860.0,2020-06-01,2275,1161,1114
"Bridgeport-Stamford-Norwalk, CT",14860.0,2020-07-01,1488,612,876
"Bridgeport-Stamford-Norwalk, CT",14860.0,2020-08-01,1226,301,925
"Bridgeport-Stamford-Norwalk, CT",14860.0,2020-09-01,838,213,625
"Bridgeport-Stamford-Norwalk, CT",14860.0,2020-10-01,103,-345,448
"Bridgeport-Stamford-Norwalk, CT",14860.0,2020-11-01,318,-141,459
"Bridgeport-Stamford-Norwalk, CT",14860.0,2020-12-01,-214,-495,281
"Waco, TX",47380.0,2019-01-01,8,0,8
"Waco, TX",47380.0,2019-02-01,-88,0,-88
"Waco, TX",47380.0,2019-03-01,33,0,33
"Waco, TX",47380.0,2019-04-01,-27,0,-27
"Waco, TX",47380.0,2019-05-01,-113,0,-113
"Waco, TX",47380.0,2019-06-01,-19,0,-19
"Waco, TX",47380.0,2019-07-01,-54,0,-54
"Waco, TX",47380.0,2019-08-01,5,0,5
"Waco, TX",47380.0,2019-09-01,-2,0,-2
"Waco, TX",47380.0,2019-10-01,6,0,6
"Waco, TX",47380.0,2019-11-01,-26,0,-26
"Waco, TX",47380.0,2019-12-01,-31,0,-31
"Waco, TX",47380.0,2020-01-01,-36,0,-36
"Waco, TX",47380.0,2020-02-01,-46,0,-46
"Waco, TX",47380.0,2020-03-01,29,0,29
"Waco, TX",47380.0,2020-04-01,-42,0,-42
"Waco, TX",47380.0,2020-05-01,-105,0,-105
"Waco, TX",47380.0,2020-06-01,-16,0,-16
"Waco, TX",47380.0,2020-07-01,-71,0,-71
"Waco, TX",47380.0,2020-08-01,14,0,14
"Waco, TX",47380.0,2020-09-01,33,0,33
"Waco, TX",47380.0,2020-10-01,5,0,5
"Waco, TX",47380.0,2020-11-01,95,0,95
"Waco, TX",47380.0,2020-12-01,-35,0,-35
"Bonham, TX",14300.0,2019-01-01,15,0,15
"Bonham, TX",14300.0,2019-02-01,49,0,49
"Bonham, TX",14300.0,2019-03-01,18,0,18
"Bonham, TX",14300.0,2019-04-01,21,0,21
"Bonham, TX",14300.0,2019-05-01,24,0,24
"Bonham, TX",14300.0,2019-06-01,5,0,5
"Bonham, TX",14300.0,2019-07-01,37,0,37
"Bonham, TX",14300.0,2019-08-01,2,0,2
"Bonham, TX",14300.0,2019-09-01,21,0,21
"Bonham, TX",14300.0,2019-10-01,16,0,16
"Bonham, TX",14300.0,2019-11-01,16,0,16
"Bonham, TX",14300.0,2019-12-01,7,0,7
"Bonham, TX",14300.0,2020-01-01,24,0,24
"Bonham, TX",14300.0,2020-02-01,27,0,27
"Bonham, TX",14300.0,2020-03-01,35,0,35
"Bonham, TX",14300.0,2020-04-01,58,0,58
"Bonham, TX",14300.0,2020-05-01,22,0,22
"Bonham, TX",14300.0,2020-06-01,36,0,36
"Bonham, TX",14300.0,2020-07-01,31,0,31
"Bonham, TX",14300.0,2020-08-01,52,0,52
"Bonham, TX",14300.0,2020-09-01,45,0,45
"Bonham, TX",14300.0,2020-10-01,40,0,40
"Bonham, TX",14300.0,2020-11-01,22,0,22
"Bonham, TX",14300.0,2020-12-01,44,0,44
"Little Rock-North Little Rock-Conway, AR",30780.0,2019-01-01,-22,0,-22
"Little Rock-North Little Rock-Conway, AR",30780.0,2019-02-01,22,0,22
"Little Rock-North Little Rock-Conway, AR",30780.0,2019-03-01,0,0,0
"Little Rock-North Little Rock-Conway, AR",30780.0,2019-04-01,84,0,84
"Little Rock-North Little Rock-Conway, AR",30780.0,2019-05-01,-37,0,-37
"Little Rock-North Little Rock-Conway, AR",30780.0,2019-06-01,-54,0,-54
"Little Rock-North Little Rock-Conway, AR",30780.0,2019-07-01,-68,0,-68
"Little Rock-North Little Rock-Conway, AR",30780.0,2019-08-01,60,0,60
"Little Rock-North Little Rock-Conway, AR",30780.0,2019-09-01,104,0,104
"Little Rock-North Little Rock-Conway, AR",30780.0,2019-10-01,36,0,36
"Little Rock-North Little Rock-Conway, AR",30780.0,2019-11-01,-7,0,-7
"Little Rock-North Little Rock-Conway, AR",30780.0,2019-12-01,-45,0,-45
"Little Rock-North Little Rock-Conway, AR",30780.0,2020-01-01,17,0,17
"Little Rock-North Little Rock-Conway, AR",30780.0,2020-02-01,10,0,10
"Little Rock-North Little Rock-Conway, AR",30780.0,2020-03-01,-37,0,-37
"Little Rock-North Little Rock-Conway, AR",30780.0,2020-04-01,-30,-20,-10
"Little Rock-North Little Rock-Conway, AR",30780.0,2020-05-01,10,0,10
"Little Rock-North Little Rock-Conway, AR",30780.0,2020-06-01,-3,0,-3
"Little Rock-North Little Rock-Conway, AR",30780.0,2020-07-01,96,0,96
"Little Rock-North Little Rock-Conway, AR",30780.0,2020-08-01,27,11,16
"Little Rock-North Little Rock-Conway, AR",30780.0,2020-09-01,1,0,1
"Little Rock-North Little Rock-Conway, AR",30780.0,2020-10-01,-49,0,-49
"Little Rock-North Little Rock-Conway, AR",30780.0,2020-11-01,40,0,40
"Little Rock-North Little Rock-Conway, AR",30780.0,2020-12-01,-15,0,-15
"Connersville, IN",18220.0,2019-01-01,11,0,11
"Connersville, IN",18220.0,2019-02-01,-15,0,-15
"Connersville, IN",18220.0,2019-03-01,9,0,9
"Connersville, IN",18220.0,2019-04-01,-15,0,-15
"Connersville, IN",18220.0,2019-05-01,21,0,21
"Connersville, IN",18220.0,2019-06-01,-21,0,-21
"Connersville, IN",18220.0,2019-07-01,-3,0,-3
"Connersville, IN",18220.0,2019-08-01,6,0,6
"Connersville, IN",18220.0,2019-09-01,1,0,1
"Connersville, IN",18220.0,2019-10-01,-12,0,-12
"Connersville, IN",18220.0,2019-11-01,7,0,7
"Connersville, IN",18220.0,2019-12-01,28,0,28
"Connersville, IN",18220.0,2020-01-01,-11,0,-11
"Connersville, IN",18220.0,2020-02-01,22,0,22
"Connersville, IN",18220.0,2020-03-01,10,0,10
"Connersville, IN",18220.0,2020-04-01,21,0,21
"Connersville, IN",18220.0,2020-05-01,11,0,11
"Connersville, IN",18220.0,2020-06-01,12,0,12
"Connersville, IN",18220.0,2020-07-01,-23,0,-23
"Connersville, IN",18220.0,2020-08-01,-4,0,-4
"Connersville, IN",18220.0,2020-09-01,0,0,0
"Connersville, IN",18220.0,2020-10-01,34,0,34
"Connersville, IN",18220.0,2020-11-01,-13,0,-13
"Connersville, IN",18220.0,2020-12-01,-12,0,-12
"Washington Court House, OH",47920.0,2019-01-01,-8,0,-8
"Washington Court House, OH",47920.0,2019-02-01,-42,0,-42
"Washington Court House, OH",47920.0,2019-03-01,12,0,12
"Washington Court House, OH",47920.0,2019-04-01,-15,0,-15
"Washington Court House, OH",47920.0,2019-05-01,25,0,25
"Washington Court House, OH",47920.0,2019-06-01,-15,0,-15
"Washington Court House, OH",47920.0,2019-07-01,16,0,16
"Washington Court House, OH",47920.0,2019-08-01,-13,0,-13
"Washington Court House, OH",47920.0,2019-09-01,19,0,19
"Washington Court House, OH",47920.0,2019-10-01,22,0,22
"Washington Court House, OH",47920.0,2019-11-01,23,0,23
"Washington Court House, OH",47920.0,2019-12-01,-16,0,-16
"Washington Court House, OH",47920.0,2020-01-01,20,0,20
"Washington Court House, OH",47920.0,2020-02-01,-9,0,-9
"Washington Court House, OH",47920.0,2020-03-01,-30,0,-30
"Washington Court House, OH",47920.0,2020-04-01,11,0,11
"Washington Court House, OH",47920.0,2020-05-01,21,0,21
"Washington Court House, OH",47920.0,2020-06-01,4,0,4
"Washington Court House, OH",47920.0,2020-07-01,40,0,40
"Washington Court House, OH",47920.0,2020-08-01,16,0,16
"Washington Court House, OH",47920.0,2020-09-01,12,0,12
"Washington Court House, OH",47920.0,2020-10-01,27,0,27
"Washington Court House, OH",47920.0,2020-11-01,13,0,13
"Washington Court House, OH",47920.0,2020-12-01,24,0,24
"Beckley, WV",13220.0,2019-01-01,-4,0,-4
"Beckley, WV",13220.0,2019-02-01,-2,0,-2
"Beckley, WV",13220.0,2019-03-01,-32,0,-32
"Beckley, WV",13220.0,2019-04-01,8,0,8
"Beckley, WV",13220.0,2019-05-01,12,0,12
"Beckley, WV",13220.0,2019-06-01,15,0,15
"Beckley, WV",13220.0,2019-07-01,-5,0,-5
"Beckley, WV",13220.0,2019-08-01,28,0,28
"Beckley, WV",13220.0,2019-09-01,-1,0,-1
"Beckley, WV",13220.0,2019-10-01,-35,0,-35
"Beckley, WV",13220.0,2019-11-01,-27,0,-27
"Beckley, WV",13220.0,2019-12-01,0,0,0
"Beckley, WV",13220.0,2020-01-01,-3,0,-3
"Beckley, WV",13220.0,2020-02-01,-2,0,-2
"Beckley, WV",13220.0,2020-03-01,25,0,25
"Beckley, WV",13220.0,2020-04-01,16,0,16
"Beckley, WV",13220.0,2020-05-01,-38,0,-38
"Beckley, WV",13220.0,2020-06-01,44,0,44
"Beckley, WV",13220.0,2020-07-01,-11,0,-11
"Beckley, WV",13220.0,2020-08-01,-6,0,-6
"Beckley, WV",13220.0,2020-09-01,9,0,9
"Beckley, WV",13220.0,2020-10-01,-14,0,-14
"Beckley, WV",13220.0,2020-11-01,16,0,16
"Beckley, WV",13220.0,2020-12-01,0,0,0
"Garden City, KS",23780.0,2019-01-01,0,0,0
"Garden City, KS",23780.0,2019-02-01,0,0,0
"Garden City, KS",23780.0,2019-03-01,0,0,0
"Garden City, KS",23780.0,2019-04-01,0,0,0
"Garden City, KS",23780.0,2019-05-01,-18,0,-18
"Garden City, KS",23780.0,2019-06-01,11,0,11
"Garden City, KS",23780.0,2019-07-01,-27,0,-27
"Garden City, KS",23780.0,2019-08-01,-13,0,-13
"Garden City, KS",23780.0,2019-09-01,0,0,0
"Garden City, KS",23780.0,2019-10-01,0,0,0
"Garden City, KS",23780.0,2019-11-01,0,0,0
"Garden City, KS",23780.0,2019-12-01,-26,0,-26
"Garden City, KS",23780.0,2020-01-01,-14,0,-14
"Garden City, KS",23780.0,2020-02-01,0,0,0
"Garden City, KS",23780.0,2020-03-01,11,0,11
"Garden City, KS",23780.0,2020-04-01,0,0,0
"Garden City, KS",23780.0,2020-05-01,-12,0,-12
"Garden City, KS",23780.0,2020-06-01,0,0,0
"Garden City, KS",23780.0,2020-07-01,0,0,0
"Garden City, KS",23780.0,2020-08-01,0,0,0
"Garden City, KS",23780.0,2020-09-01,0,0,0
"Garden City, KS",23780.0,2020-10-01,0,0,0
"Garden City, KS",23780.0,2020-11-01,0,0,0
"Garden City, KS",23780.0,2020-12-01,0,0,0
"Deltona-Daytona Beach-Ormond Beach, FL",19660.0,2019-01-01,1335,1196,139
"Deltona-Daytona Beach-Ormond Beach, FL",19660.0,2019-02-01,304,58,246
"Deltona-Daytona Beach-Ormond Beach, FL",19660.0,2019-03-01,414,0,414
"Deltona-Daytona Beach-Ormond Beach, FL",19660.0,2019-04-01,-355,-545,190
"Deltona-Daytona Beach-Ormond Beach, FL",19660.0,2019-05-01,-1124,-1571,447
"Deltona-Daytona Beach-Ormond Beach, FL",19660.0,2019-06-01,111,-391,502
"Deltona-Daytona Beach-Ormond Beach, FL",19660.0,2019-07-01,687,-16,703
"Deltona-Daytona Beach-Ormond Beach, FL",19660.0,2019-08-01,373,14,359
"Deltona-Daytona Beach-Ormond Beach, FL",19660.0,2019-09-01,528,52,476
"Deltona-Daytona Beach-Ormond Beach, FL",19660.0,2019-10-01,1431,926,505
"Deltona-Daytona Beach-Ormond Beach, FL",19660.0,2019-11-01,824,465,359
"Deltona-Daytona Beach-Ormond Beach, FL",19660.0,2019-12-01,1648,1314,334
"Deltona-Daytona Beach-Ormond Beach, FL",19660.0,2020-01-01,1607,1261,346
"Deltona-Daytona Beach-Ormond Beach, FL",19660.0,2020-02-01,362,54,308
"Deltona-Daytona Beach-Ormond Beach, FL",19660.0,2020-03-01,282,35,247
"Deltona-Daytona Beach-Ormond Beach, FL",19660.0,2020-04-01,555,62,493
"Deltona-Daytona Beach-Ormond Beach, FL",19660.0,2020-05-01,-247,-645,398
"Deltona-Daytona Beach-Ormond Beach, FL",19660.0,2020-06-01,246,-562,808
"Deltona-Daytona Beach-Ormond Beach, FL",19660.0,2020-07-01,521,-7,528
"Deltona-Daytona Beach-Ormond Beach, FL",19660.0,2020-08-01,769,-2,771
"Deltona-Daytona Beach-Ormond Beach, FL",19660.0,2020-09-01,712,-3,715
"Deltona-Daytona Beach-Ormond Beach, FL",19660.0,2020-10-01,1486,734,752
"Deltona-Daytona Beach-Ormond Beach, FL",19660.0,2020-11-01,1165,503,662
"Deltona-Daytona Beach-Ormond Beach, FL",19660.0,2020-12-01,1371,816,555
"Kalispell, MT",28060.0,2019-01-01,-76,-57,-19
"Kalispell, MT",28060.0,2019-02-01,13,0,13
"Kalispell, MT",28060.0,2019-03-01,18,0,18
"Kalispell, MT",28060.0,2019-04-01,344,198,146
"Kalispell, MT",28060.0,2019-05-01,447,285,162
"Kalispell, MT",28060.0,2019-06-01,247,140,107
"Kalispell, MT",28060.0,2019-07-01,75,17,58
"Kalispell, MT",28060.0,2019-08-01,70,0,70
"Kalispell, MT",28060.0,2019-09-01,-89,-67,-22
"Kalispell, MT",28060.0,2019-10-01,-364,-366,2
"Kalispell, MT",28060.0,2019-11-01,-242,-223,-19
"Kalispell, MT",28060.0,2019-12-01,-82,-75,-7
"Kalispell, MT",28060.0,2020-01-01,-45,-79,34
"Kalispell, MT",28060.0,2020-02-01,-11,-16,5
"Kalispell, MT",28060.0,2020-03-01,220,100,120
"Kalispell, MT",28060.0,2020-04-01,205,115,90
"Kalispell, MT",28060.0,2020-05-01,339,237,102
"Kalispell, MT",28060.0,2020-06-01,200,134,66
"Kalispell, MT",28060.0,2020-07-01,75,38,37
"Kalispell, MT",28060.0,2020-08-01,222,14,208
"Kalispell, MT",28060.0,2020-09-01,30,-36,66
"Kalispell, MT",28060.0,2020-10-01,-303,-357,54
"Kalispell, MT",28060.0,2020-11-01,-231,-240,9
"Kalispell, MT",28060.0,2020-12-01,3,-40,43
"Rome, GA",40660.0,2019-01-01,-13,0,-13
"Rome, GA",40660.0,2019-02-01,33,0,33
"Rome, GA",40660.0,2019-03-01,-28,0,-28
"Rome, GA",40660.0,2019-04-01,6,0,6
"Rome, GA",40660.0,2019-05-01,42,0,42
"Rome, GA",40660.0,2019-06-01,37,0,37
"Rome, GA",40660.0,2019-07-01,14,0,14
"Rome, GA",40660.0,2019-08-01,12,0,12
"Rome, GA",40660.0,2019-09-01,35,0,35
"Rome, GA",40660.0,2019-10-01,39,0,39
"Rome, GA",40660.0,2019-11-01,25,0,25
"Rome, GA",40660.0,2019-12-01,-32,0,-32
"Rome, GA",40660.0,2020-01-01,19,0,19
"Rome, GA",40660.0,2020-02-01,14,0,14
"Rome, GA",40660.0,2020-03-01,27,0,27
"Rome, GA",40660.0,2020-04-01,6,0,6
"Rome, GA",40660.0,2020-05-01,68,0,68
"Rome, GA",40660.0,2020-06-01,50,0,50
"Rome, GA",40660.0,2020-07-01,5,0,5
"Rome, GA",40660.0,2020-08-01,-10,0,-10
"Rome, GA",40660.0,2020-09-01,28,0,28
"Rome, GA",40660.0,2020-10-01,41,0,41
"Rome, GA",40660.0,2020-11-01,13,0,13
"Rome, GA",40660.0,2020-12-01,-17,0,-17
"Fond du Lac, WI",22540.0,2019-01-01,-33,-13,-20
"Fond du Lac, WI",22540.0,2019-02-01,32,0,32
"Fond du Lac, WI",22540.0,2019-03-01,0,0,0
"Fond du Lac, WI",22540.0,2019-04-01,47,14,33
"Fond du Lac, WI",22540.0,2019-05-01,65,40,25
"Fond du Lac, WI",22540.0,2019-06-01,33,0,33
"Fond du Lac, WI",22540.0,2019-07-01,6,0,6
"Fond du Lac, WI",22540.0,2019-08-01,54,0,54
"Fond du Lac, WI",22540.0,2019-09-01,-58,0,-58
"Fond du Lac, WI",22540.0,2019-10-01,-79,-31,-48
"Fond du Lac, WI",22540.0,2019-11-01,5,0,5
"Fond du Lac, WI",22540.0,2019-12-01,-52,-49,-3
"Fond du Lac, WI",22540.0,2020-01-01,-48,-41,-7
"Fond du Lac, WI",22540.0,2020-02-01,-6,0,-6
"Fond du Lac, WI",22540.0,2020-03-01,45,0,45
"Fond du Lac, WI",22540.0,2020-04-01,74,0,74
"Fond du Lac, WI",22540.0,2020-05-01,28,12,16
"Fond du Lac, WI",22540.0,2020-06-01,-14,0,-14
"Fond du Lac, WI",22540.0,2020-07-01,-30,0,-30
"Fond du Lac, WI",22540.0,2020-08-01,44,0,44
"Fond du Lac, WI",22540.0,2020-09-01,8,0,8
"Fond du Lac, WI",22540.0,2020-10-01,-60,-32,-28
"Fond du Lac, WI",22540.0,2020-11-01,-17,0,-17
"Fond du Lac, WI",22540.0,2020-12-01,-26,-26,0
"Dodge City, KS",19980.0,2019-01-01,0,0,0
"Dodge City, KS",19980.0,2019-02-01,0,0,0
"Dodge City, KS",19980.0,2019-03-01,0,0,0
"Dodge City, KS",19980.0,2019-04-01,-12,0,-12
"Dodge City, KS",19980.0,2019-05-01,-1,0,-1
"Dodge City, KS",19980.0,2019-06-01,-13,0,-13
"Dodge City, KS",19980.0,2019-07-01,-15,0,-15
"Dodge City, KS",19980.0,2019-08-01,-16,0,-16
"Dodge City, KS",19980.0,2019-09-01,0,0,0
"Dodge City, KS",19980.0,2019-10-01,-11,0,-11
"Dodge City, KS",19980.0,2019-11-01,0,0,0
"Dodge City, KS",19980.0,2019-12-01,0,0,0
"Dodge City, KS",19980.0,2020-01-01,0,0,0
"Dodge City, KS",19980.0,2020-02-01,0,0,0
"Dodge City, KS",19980.0,2020-03-01,-11,0,-11
"Dodge City, KS",19980.0,2020-04-01,0,0,0
"Dodge City, KS",19980.0,2020-05-01,0,0,0
"Dodge City, KS",19980.0,2020-06-01,-13,0,-13
"Dodge City, KS",19980.0,2020-07-01,-26,0,-26
"Dodge City, KS",19980.0,2020-08-01,0,0,0
"Dodge City, KS",19980.0,2020-09-01,0,0,0
"Dodge City, KS",19980.0,2020-10-01,0,0,0
"Dodge City, KS",19980.0,2020-11-01,-18,0,-18
"Dodge City, KS",19980.0,2020-12-01,0,0,0
"Ottawa, KS",36840.0,2019-01-01,15,0,15
"Ottawa, KS",36840.0,2019-02-01,2,0,2
"Ottawa, KS",36840.0,2019-03-01,10,0,10
"Ottawa, KS",36840.0,2019-04-01,-9,0,-9
"Ottawa, KS",36840.0,2019-05-01,0,0,0
"Ottawa, KS",36840.0,2019-06-01,22,0,22
"Ottawa, KS",36840.0,2019-07-01,-1,0,-1
"Ottawa, KS",36840.0,2019-08-01,42,0,42
"Ottawa, KS",36840.0,2019-09-01,21,0,21
"Ottawa, KS",36840.0,2019-10-01,5,0,5
"Ottawa, KS",36840.0,2019-11-01,11,0,11
"Ottawa, KS",36840.0,2019-12-01,-13,0,-13
"Ottawa, KS",36840.0,2020-01-01,20,0,20
"Ottawa, KS",36840.0,2020-02-01,-25,0,-25
"Ottawa, KS",36840.0,2020-03-01,-24,0,-24
"Ottawa, KS",36840.0,2020-04-01,-13,0,-13
"Ottawa, KS",36840.0,2020-05-01,0,0,0
"Ottawa, KS",36840.0,2020-06-01,1,0,1
"Ottawa, KS",36840.0,2020-07-01,-11,0,-11
"Ottawa, KS",36840.0,2020-08-01,15,0,15
"Ottawa, KS",36840.0,2020-09-01,10,0,10
"Ottawa, KS",36840.0,2020-10-01,35,0,35
"Ottawa, KS",36840.0,2020-11-01,-15,0,-15
"Ottawa, KS",36840.0,2020-12-01,-3,0,-3
"Springfield, MA",44140.0,2019-01-01,-533,-506,-27
"Springfield, MA",44140.0,2019-02-01,-49,-36,-13
"Springfield, MA",44140.0,2019-03-01,102,-11,113
"Springfield, MA",44140.0,2019-04-01,410,243,167
"Springfield, MA",44140.0,2019-05-01,470,446,24
"Springfield, MA",44140.0,2019-06-01,-121,-31,-90
"Springfield, MA",44140.0,2019-07-01,-136,-12,-124
"Springfield, MA",44140.0,2019-08-01,71,0,71
"Springfield, MA",44140.0,2019-09-01,-68,-14,-54
"Springfield, MA",44140.0,2019-10-01,-386,-317,-69
"Springfield, MA",44140.0,2019-11-01,-244,-172,-72
"Springfield, MA",44140.0,2019-12-01,-404,-417,13
"Springfield, MA",44140.0,2020-01-01,-384,-412,28
"Springfield, MA",44140.0,2020-02-01,-76,-15,-61
"Springfield, MA",44140.0,2020-03-01,229,163,66
"Springfield, MA",44140.0,2020-04-01,144,99,45
"Springfield, MA",44140.0,2020-05-01,286,294,-8
"Springfield, MA",44140.0,2020-06-01,214,131,83
"Springfield, MA",44140.0,2020-07-01,158,30,128
"Springfield, MA",44140.0,2020-08-01,191,0,191
"Springfield, MA",44140.0,2020-09-01,26,-22,48
"Springfield, MA",44140.0,2020-10-01,-312,-243,-69
"Springfield, MA",44140.0,2020-11-01,-42,-168,126
"Springfield, MA",44140.0,2020-12-01,-318,-291,-27
"Raleigh-Cary, NC",39580.0,2019-01-01,369,-40,409
"Raleigh-Cary, NC",39580.0,2019-02-01,274,-15,289
"Raleigh-Cary, NC",39580.0,2019-03-01,473,11,462
"Raleigh-Cary, NC",39580.0,2019-04-01,307,-11,318
"Raleigh-Cary, NC",39580.0,2019-05-01,784,63,721
"Raleigh-Cary, NC",39580.0,2019-06-01,1066,19,1047
"Raleigh-Cary, NC",39580.0,2019-07-01,792,-7,799
"Raleigh-Cary, NC",39580.0,2019-08-01,696,-12,708
"Raleigh-Cary, NC",39580.0,2019-09-01,649,17,632
"Raleigh-Cary, NC",39580.0,2019-10-01,329,-9,338
"Raleigh-Cary, NC",39580.0,2019-11-01,330,2,328
"Raleigh-Cary, NC",39580.0,2019-12-01,450,-13,463
"Raleigh-Cary, NC",39580.0,2020-01-01,344,-15,359
"Raleigh-Cary, NC",39580.0,2020-02-01,306,1,305
"Raleigh-Cary, NC",39580.0,2020-03-01,800,30,770
"Raleigh-Cary, NC",39580.0,2020-04-01,306,12,294
"Raleigh-Cary, NC",39580.0,2020-05-01,667,44,623
"Raleigh-Cary, NC",39580.0,2020-06-01,1296,14,1282
"Raleigh-Cary, NC",39580.0,2020-07-01,1445,20,1425
"Raleigh-Cary, NC",39580.0,2020-08-01,1088,15,1073
"Raleigh-Cary, NC",39580.0,2020-09-01,938,40,898
"Raleigh-Cary, NC",39580.0,2020-10-01,860,-4,864
"Raleigh-Cary, NC",39580.0,2020-11-01,858,15,843
"Raleigh-Cary, NC",39580.0,2020-12-01,771,48,723
"Malone, NY",31660.0,2019-01-01,0,-11,11
"Malone, NY",31660.0,2019-02-01,-9,0,-9
"Malone, NY",31660.0,2019-03-01,8,0,8
"Malone, NY",31660.0,2019-04-01,-9,14,-23
"Malone, NY",31660.0,2019-05-01,39,64,-25
"Malone, NY",31660.0,2019-06-01,-1,0,-1
"Malone, NY",31660.0,2019-07-01,18,0,18
"Malone, NY",31660.0,2019-08-01,-7,0,-7
"Malone, NY",31660.0,2019-09-01,-21,0,-21
"Malone, NY",31660.0,2019-10-01,-83,-93,10
"Malone, NY",31660.0,2019-11-01,-70,-40,-30
"Malone, NY",31660.0,2019-12-01,14,0,14
"Malone, NY",31660.0,2020-01-01,-3,0,-3
"Malone, NY",31660.0,2020-02-01,3,0,3
"Malone, NY",31660.0,2020-03-01,-21,0,-21
"Malone, NY",31660.0,2020-04-01,17,0,17
"Malone, NY",31660.0,2020-05-01,22,23,-1
"Malone, NY",31660.0,2020-06-01,25,23,2
"Malone, NY",31660.0,2020-07-01,-2,0,-2
"Malone, NY",31660.0,2020-08-01,-7,0,-7
"Malone, NY",31660.0,2020-09-01,-32,0,-32
"Malone, NY",31660.0,2020-10-01,-38,-16,-22
"Malone, NY",31660.0,2020-11-01,-20,-15,-5
"Malone, NY",31660.0,2020-12-01,1,-11,12
"Chambersburg-Waynesboro, PA",16540.0,2019-01-01,-2,-15,13
"Chambersburg-Waynesboro, PA",16540.0,2019-02-01,11,0,11
"Chambersburg-Waynesboro, PA",16540.0,2019-03-01,39,0,39
"Chambersburg-Waynesboro, PA",16540.0,2019-04-01,27,0,27
"Chambersburg-Waynesboro, PA",16540.0,2019-05-01,51,0,51
"Chambersburg-Waynesboro, PA",16540.0,2019-06-01,-1,0,-1
"Chambersburg-Waynesboro, PA",16540.0,2019-07-01,44,0,44
"Chambersburg-Waynesboro, PA",16540.0,2019-08-01,30,0,30
"Chambersburg-Waynesboro, PA",16540.0,2019-09-01,27,0,27
"Chambersburg-Waynesboro, PA",16540.0,2019-10-01,-16,0,-16
"Chambersburg-Waynesboro, PA",16540.0,2019-11-01,39,0,39
"Chambersburg-Waynesboro, PA",16540.0,2019-12-01,-59,-37,-22
"Chambersburg-Waynesboro, PA",16540.0,2020-01-01,48,0,48
"Chambersburg-Waynesboro, PA",16540.0,2020-02-01,25,0,25
"Chambersburg-Waynesboro, PA",16540.0,2020-03-01,-15,0,-15
"Chambersburg-Waynesboro, PA",16540.0,2020-04-01,5,0,5
"Chambersburg-Waynesboro, PA",16540.0,2020-05-01,19,0,19
"Chambersburg-Waynesboro, PA",16540.0,2020-06-01,56,0,56
"Chambersburg-Waynesboro, PA",16540.0,2020-07-01,11,-25,36
"Chambersburg-Waynesboro, PA",16540.0,2020-08-01,27,0,27
"Chambersburg-Waynesboro, PA",16540.0,2020-09-01,52,0,52
"Chambersburg-Waynesboro, PA",16540.0,2020-10-01,45,0,45
"Chambersburg-Waynesboro, PA",16540.0,2020-11-01,27,0,27
"Chambersburg-Waynesboro, PA",16540.0,2020-12-01,43,0,43
"Winchester, VA-WV",49020.0,2019-01-01,-4,0,-4
"Winchester, VA-WV",49020.0,2019-02-01,93,0,93
"Winchester, VA-WV",49020.0,2019-03-01,54,0,54
"Winchester, VA-WV",49020.0,2019-04-01,25,0,25
"Winchester, VA-WV",49020.0,2019-05-01,34,0,34
"Winchester, VA-WV",49020.0,2019-06-01,19,0,19
"Winchester, VA-WV",49020.0,2019-07-01,-6,0,-6
"Winchester, VA-WV",49020.0,2019-08-01,40,0,40
"Winchester, VA-WV",49020.0,2019-09-01,39,0,39
"Winchester, VA-WV",49020.0,2019-10-01,42,0,42
"Winchester, VA-WV",49020.0,2019-11-01,20,0,20
"Winchester, VA-WV",49020.0,2019-12-01,7,0,7
"Winchester, VA-WV",49020.0,2020-01-01,-51,0,-51
"Winchester, VA-WV",49020.0,2020-02-01,61,0,61
"Winchester, VA-WV",49020.0,2020-03-01,2,0,2
"Winchester, VA-WV",49020.0,2020-04-01,9,0,9
"Winchester, VA-WV",49020.0,2020-05-01,91,0,91
"Winchester, VA-WV",49020.0,2020-06-01,131,0,131
"Winchester, VA-WV",49020.0,2020-07-01,129,0,129
"Winchester, VA-WV",49020.0,2020-08-01,98,0,98
"Winchester, VA-WV",49020.0,2020-09-01,101,0,101
"Winchester, VA-WV",49020.0,2020-10-01,105,0,105
"Winchester, VA-WV",49020.0,2020-11-01,81,0,81
"Winchester, VA-WV",49020.0,2020-12-01,49,0,49
"Albert Lea, MN",10660.0,2019-01-01,1,-11,12
"Albert Lea, MN",10660.0,2019-02-01,11,0,11
"Albert Lea, MN",10660.0,2019-03-01,-11,0,-11
"Albert Lea, MN",10660.0,2019-04-01,41,12,29
"Albert Lea, MN",10660.0,2019-05-01,12,0,12
"Albert Lea, MN",10660.0,2019-06-01,22,0,22
"Albert Lea, MN",10660.0,2019-07-01,0,0,0
"Albert Lea, MN",10660.0,2019-08-01,27,0,27
"Albert Lea, MN",10660.0,2019-09-01,18,0,18
"Albert Lea, MN",10660.0,2019-10-01,-17,-20,3
"Albert Lea, MN",10660.0,2019-11-01,-35,-35,0
"Albert Lea, MN",10660.0,2019-12-01,-32,-32,0
"Albert Lea, MN",10660.0,2020-01-01,16,0,16
"Albert Lea, MN",10660.0,2020-02-01,0,0,0
"Albert Lea, MN",10660.0,2020-03-01,11,0,11
"Albert Lea, MN",10660.0,2020-04-01,12,0,12
"Albert Lea, MN",10660.0,2020-05-01,-1,0,-1
"Albert Lea, MN",10660.0,2020-06-01,0,0,0
"Albert Lea, MN",10660.0,2020-07-01,24,0,24
"Albert Lea, MN",10660.0,2020-08-01,2,0,2
"Albert Lea, MN",10660.0,2020-09-01,9,0,9
"Albert Lea, MN",10660.0,2020-10-01,8,-19,27
"Albert Lea, MN",10660.0,2020-11-01,-27,-27,0
"Albert Lea, MN",10660.0,2020-12-01,-23,-11,-12
"Cañon City, CO",15860.0,2019-01-01,-27,0,-27
"Cañon City, CO",15860.0,2019-02-01,-11,0,-11
"Cañon City, CO",15860.0,2019-03-01,31,0,31
"Cañon City, CO",15860.0,2019-04-01,-3,0,-3
"Cañon City, CO",15860.0,2019-05-01,31,0,31
"Cañon City, CO",15860.0,2019-06-01,13,0,13
"Cañon City, CO",15860.0,2019-07-01,23,0,23
"Cañon City, CO",15860.0,2019-08-01,34,0,34
"Cañon City, CO",15860.0,2019-09-01,-26,0,-26
"Cañon City, CO",15860.0,2019-10-01,2,0,2
"Cañon City, CO",15860.0,2019-11-01,0,0,0
"Cañon City, CO",15860.0,2019-12-01,5,0,5
"Cañon City, CO",15860.0,2020-01-01,9,0,9
"Cañon City, CO",15860.0,2020-02-01,14,0,14
"Cañon City, CO",15860.0,2020-03-01,-22,0,-22
"Cañon City, CO",15860.0,2020-04-01,35,0,35
"Cañon City, CO",15860.0,2020-05-01,22,0,22
"Cañon City, CO",15860.0,2020-06-01,-6,0,-6
"Cañon City, CO",15860.0,2020-07-01,6,0,6
"Cañon City, CO",15860.0,2020-08-01,23,0,23
"Cañon City, CO",15860.0,2020-09-01,32,0,32
"Cañon City, CO",15860.0,2020-10-01,19,0,19
"Cañon City, CO",15860.0,2020-11-01,-13,0,-13
"Cañon City, CO",15860.0,2020-12-01,6,0,6
"Rexburg, ID",39940.0,2019-01-01,-71,0,-71
"Rexburg, ID",39940.0,2019-02-01,-20,0,-20
"Rexburg, ID",39940.0,2019-03-01,-38,0,-38
"Rexburg, ID",39940.0,2019-04-01,-191,0,-191
"Rexburg, ID",39940.0,2019-05-01,-15,61,-76
"Rexburg, ID",39940.0,2019-06-01,-2,21,-23
"Rexburg, ID",39940.0,2019-07-01,-181,0,-181
"Rexburg, ID",39940.0,2019-08-01,-137,0,-137
"Rexburg, ID",39940.0,2019-09-01,-66,-12,-54
"Rexburg, ID",39940.0,2019-10-01,-85,-65,-20
"Rexburg, ID",39940.0,2019-11-01,-13,0,-13
"Rexburg, ID",39940.0,2019-12-01,-87,0,-87
"Rexburg, ID",39940.0,2020-01-01,-111,0,-111
"Rexburg, ID",39940.0,2020-02-01,-18,0,-18
"Rexburg, ID",39940.0,2020-03-01,-84,0,-84
"Rexburg, ID",39940.0,2020-04-01,-191,0,-191
"Rexburg, ID",39940.0,2020-05-01,48,47,1
"Rexburg, ID",39940.0,2020-06-01,-37,14,-51
"Rexburg, ID",39940.0,2020-07-01,-88,0,-88
"Rexburg, ID",39940.0,2020-08-01,-60,0,-60
"Rexburg, ID",39940.0,2020-09-01,-104,0,-104
"Rexburg, ID",39940.0,2020-10-01,-121,-80,-41
"Rexburg, ID",39940.0,2020-11-01,-42,0,-42
"Rexburg, ID",39940.0,2020-12-01,-117,0,-117
"Riverton, WY",40180.0,2019-01-01,0,0,0
"Riverton, WY",40180.0,2019-02-01,0,0,0
"Riverton, WY",40180.0,2019-03-01,0,0,0
"Riverton, WY",40180.0,2019-04-01,11,11,0
"Riverton, WY",40180.0,2019-05-01,15,0,15
"Riverton, WY",40180.0,2019-06-01,-2,12,-14
"Riverton, WY",40180.0,2019-07-01,-14,0,-14
"Riverton, WY",40180.0,2019-08-01,-26,0,-26
"Riverton, WY",40180.0,2019-09-01,-24,-12,-12
"Riverton, WY",40180.0,2019-10-01,-57,-42,-15
"Riverton, WY",40180.0,2019-11-01,-22,-11,-11
"Riverton, WY",40180.0,2019-12-01,0,0,0
"Riverton, WY",40180.0,2020-01-01,0,0,0
"Riverton, WY",40180.0,2020-02-01,0,0,0
"Riverton, WY",40180.0,2020-03-01,0,0,0
"Riverton, WY",40180.0,2020-04-01,13,0,13
"Riverton, WY",40180.0,2020-05-01,0,0,0
"Riverton, WY",40180.0,2020-06-01,-14,0,-14
"Riverton, WY",40180.0,2020-07-01,0,0,0
"Riverton, WY",40180.0,2020-08-01,-11,0,-11
"Riverton, WY",40180.0,2020-09-01,0,0,0
"Riverton, WY",40180.0,2020-10-01,-12,-12,0
"Riverton, WY",40180.0,2020-11-01,-30,-30,0
"Riverton, WY",40180.0,2020-12-01,0,0,0
"Fresno, CA",23420.0,2019-01-01,276,12,264
"Fresno, CA",23420.0,2019-02-01,-51,0,-51
"Fresno, CA",23420.0,2019-03-01,47,0,47
"Fresno, CA",23420.0,2019-04-01,145,0,145
"Fresno, CA",23420.0,2019-05-01,88,0,88
"Fresno, CA",23420.0,2019-06-01,102,0,102
"Fresno, CA",23420.0,2019-07-01,22,0,22
"Fresno, CA",23420.0,2019-08-01,-17,0,-17
"Fresno, CA",23420.0,2019-09-01,31,0,31
"Fresno, CA",23420.0,2019-10-01,22,0,22
"Fresno, CA",23420.0,2019-11-01,87,0,87
"Fresno, CA",23420.0,2019-12-01,66,0,66
"Fresno, CA",23420.0,2020-01-01,77,-11,88
"Fresno, CA",23420.0,2020-02-01,-37,0,-37
"Fresno, CA",23420.0,2020-03-01,204,57,147
"Fresno, CA",23420.0,2020-04-01,155,23,132
"Fresno, CA",23420.0,2020-05-01,136,23,113
"Fresno, CA",23420.0,2020-06-01,271,0,271
"Fresno, CA",23420.0,2020-07-01,142,28,114
"Fresno, CA",23420.0,2020-08-01,92,0,92
"Fresno, CA",23420.0,2020-09-01,102,-10,112
"Fresno, CA",23420.0,2020-10-01,188,0,188
"Fresno, CA",23420.0,2020-11-01,76,0,76
"Fresno, CA",23420.0,2020-12-01,110,0,110
"Pearsall, TX",37770.0,2019-01-01,-9,0,-9
"Pearsall, TX",37770.0,2019-02-01,0,0,0
"Pearsall, TX",37770.0,2019-03-01,-11,0,-11
"Pearsall, TX",37770.0,2019-04-01,0,0,0
"Pearsall, TX",37770.0,2019-05-01,-11,0,-11
"Pearsall, TX",37770.0,2019-06-01,17,0,17
"Pearsall, TX",37770.0,2019-07-01,14,0,14
"Pearsall, TX",37770.0,2019-08-01,13,0,13
"Pearsall, TX",37770.0,2019-09-01,11,0,11
"Pearsall, TX",37770.0,2019-10-01,26,0,26
"Pearsall, TX",37770.0,2019-11-01,-12,0,-12
"Pearsall, TX",37770.0,2019-12-01,0,0,0
"Pearsall, TX",37770.0,2020-01-01,-14,0,-14
"Pearsall, TX",37770.0,2020-02-01,0,0,0
"Pearsall, TX",37770.0,2020-03-01,0,0,0
"Pearsall, TX",37770.0,2020-04-01,15,0,15
"Pearsall, TX",37770.0,2020-05-01,-2,0,-2
"Pearsall, TX",37770.0,2020-06-01,0,0,0
"Pearsall, TX",37770.0,2020-07-01,1,0,1
"Pearsall, TX",37770.0,2020-08-01,-9,0,-9
"Pearsall, TX",37770.0,2020-09-01,0,0,0
"Pearsall, TX",37770.0,2020-10-01,12,0,12
"Pearsall, TX",37770.0,2020-11-01,19,0,19
"Pearsall, TX",37770.0,2020-12-01,0,0,0
"Peoria, IL",37900.0,2019-01-01,-198,-175,-23
"Peoria, IL",37900.0,2019-02-01,19,0,19
"Peoria, IL",37900.0,2019-03-01,-3,0,-3
"Peoria, IL",37900.0,2019-04-01,200,138,62
"Peoria, IL",37900.0,2019-05-01,89,68,21
"Peoria, IL",37900.0,2019-06-01,28,0,28
"Peoria, IL",37900.0,2019-07-01,-20,-15,-5
"Peoria, IL",37900.0,2019-08-01,6,0,6
"Peoria, IL",37900.0,2019-09-01,-24,-11,-13
"Peoria, IL",37900.0,2019-10-01,-131,-119,-12
"Peoria, IL",37900.0,2019-11-01,-166,-130,-36
"Peoria, IL",37900.0,2019-12-01,-240,-234,-6
"Peoria, IL",37900.0,2020-01-01,-186,-151,-35
"Peoria, IL",37900.0,2020-02-01,-54,0,-54
"Peoria, IL",37900.0,2020-03-01,87,11,76
"Peoria, IL",37900.0,2020-04-01,105,56,49
"Peoria, IL",37900.0,2020-05-01,170,70,100
"Peoria, IL",37900.0,2020-06-01,41,0,41
"Peoria, IL",37900.0,2020-07-01,35,0,35
"Peoria, IL",37900.0,2020-08-01,-3,0,-3
"Peoria, IL",37900.0,2020-09-01,11,0,11
"Peoria, IL",37900.0,2020-10-01,-138,-133,-5
"Peoria, IL",37900.0,2020-11-01,-53,-111,58
"Peoria, IL",37900.0,2020-12-01,-150,-143,-7
"Gloversville, NY",24100.0,2019-01-01,-3,0,-3
"Gloversville, NY",24100.0,2019-02-01,-7,0,-7
"Gloversville, NY",24100.0,2019-03-01,0,0,0
"Gloversville, NY",24100.0,2019-04-01,15,0,15
"Gloversville, NY",24100.0,2019-05-01,139,106,33
"Gloversville, NY",24100.0,2019-06-01,-9,11,-20
"Gloversville, NY",24100.0,2019-07-01,55,0,55
"Gloversville, NY",24100.0,2019-08-01,13,0,13
"Gloversville, NY",24100.0,2019-09-01,19,0,19
"Gloversville, NY",24100.0,2019-10-01,-57,-54,-3
"Gloversville, NY",24100.0,2019-11-01,11,0,11
"Gloversville, NY",24100.0,2019-12-01,-98,-49,-49
"Gloversville, NY",24100.0,2020-01-01,64,0,64
"Gloversville, NY",24100.0,2020-02-01,-15,0,-15
"Gloversville, NY",24100.0,2020-03-01,16,0,16
"Gloversville, NY",24100.0,2020-04-01,7,0,7
"Gloversville, NY",24100.0,2020-05-01,46,33,13
"Gloversville, NY",24100.0,2020-06-01,18,15,3
"Gloversville, NY",24100.0,2020-07-01,29,0,29
"Gloversville, NY",24100.0,2020-08-01,2,0,2
"Gloversville, NY",24100.0,2020-09-01,34,0,34
"Gloversville, NY",24100.0,2020-10-01,-15,-38,23
"Gloversville, NY",24100.0,2020-11-01,3,0,3
"Gloversville, NY",24100.0,2020-12-01,-7,-22,15
"Toledo, OH",45780.0,2019-01-01,-374,-323,-51
"Toledo, OH",45780.0,2019-02-01,-67,-24,-43
"Toledo, OH",45780.0,2019-03-01,2,0,2
"Toledo, OH",45780.0,2019-04-01,520,354,166
"Toledo, OH",45780.0,2019-05-01,330,476,-146
"Toledo, OH",45780.0,2019-06-01,-25,47,-72
"Toledo, OH",45780.0,2019-07-01,64,0,64
"Toledo, OH",45780.0,2019-08-01,-55,0,-55
"Toledo, OH",45780.0,2019-09-01,-2,-43,41
"Toledo, OH",45780.0,2019-10-01,-563,-558,-5
"Toledo, OH",45780.0,2019-11-01,-321,-326,5
"Toledo, OH",45780.0,2019-12-01,-636,-540,-96
"Toledo, OH",45780.0,2020-01-01,-298,-337,39
"Toledo, OH",45780.0,2020-02-01,-98,-16,-82
"Toledo, OH",45780.0,2020-03-01,67,39,28
"Toledo, OH",45780.0,2020-04-01,165,117,48
"Toledo, OH",45780.0,2020-05-01,214,350,-136
"Toledo, OH",45780.0,2020-06-01,66,151,-85
"Toledo, OH",45780.0,2020-07-01,-16,0,-16
"Toledo, OH",45780.0,2020-08-01,-3,0,-3
"Toledo, OH",45780.0,2020-09-01,-55,-20,-35
"Toledo, OH",45780.0,2020-10-01,-670,-520,-150
"Toledo, OH",45780.0,2020-11-01,-390,-354,-36
"Toledo, OH",45780.0,2020-12-01,-397,-361,-36
"Tallahassee, FL",45220.0,2019-01-01,21,0,21
"Tallahassee, FL",45220.0,2019-02-01,55,0,55
"Tallahassee, FL",45220.0,2019-03-01,-6,0,-6
"Tallahassee, FL",45220.0,2019-04-01,-6,0,-6
"Tallahassee, FL",45220.0,2019-05-01,-318,-11,-307
"Tallahassee, FL",45220.0,2019-06-01,-161,0,-161
"Tallahassee, FL",45220.0,2019-07-01,-331,0,-331
"Tallahassee, FL",45220.0,2019-08-01,-176,12,-188
"Tallahassee, FL",45220.0,2019-09-01,-41,0,-41
"Tallahassee, FL",45220.0,2019-10-01,-51,0,-51
"Tallahassee, FL",45220.0,2019-11-01,-43,0,-43
"Tallahassee, FL",45220.0,2019-12-01,-8,0,-8
"Tallahassee, FL",45220.0,2020-01-01,-16,0,-16
"Tallahassee, FL",45220.0,2020-02-01,-57,0,-57
"Tallahassee, FL",45220.0,2020-03-01,-101,0,-101
"Tallahassee, FL",45220.0,2020-04-01,-101,-12,-89
"Tallahassee, FL",45220.0,2020-05-01,-73,11,-84
"Tallahassee, FL",45220.0,2020-06-01,-175,0,-175
"Tallahassee, FL",45220.0,2020-07-01,-379,0,-379
"Tallahassee, FL",45220.0,2020-08-01,-54,0,-54
"Tallahassee, FL",45220.0,2020-09-01,63,0,63
"Tallahassee, FL",45220.0,2020-10-01,-50,0,-50
"Tallahassee, FL",45220.0,2020-11-01,22,0,22
"Tallahassee, FL",45220.0,2020-12-01,-82,0,-82
"Beatrice, NE",13100.0,2019-01-01,-4,0,-4
"Beatrice, NE",13100.0,2019-02-01,13,0,13
"Beatrice, NE",13100.0,2019-03-01,1,0,1
"Beatrice, NE",13100.0,2019-04-01,1,0,1
"Beatrice, NE",13100.0,2019-05-01,10,0,10
"Beatrice, NE",13100.0,2019-06-01,-13,0,-13
"Beatrice, NE",13100.0,2019-07-01,23,0,23
"Beatrice, NE",13100.0,2019-08-01,-2,0,-2
"Beatrice, NE",13100.0,2019-09-01,-5,0,-5
"Beatrice, NE",13100.0,2019-10-01,4,0,4
"Beatrice, NE",13100.0,2019-11-01,-11,0,-11
"Beatrice, NE",13100.0,2019-12-01,7,0,7
"Beatrice, NE",13100.0,2020-01-01,-5,0,-5
"Beatrice, NE",13100.0,2020-02-01,-13,0,-13
"Beatrice, NE",13100.0,2020-03-01,-7,0,-7
"Beatrice, NE",13100.0,2020-04-01,-3,0,-3
"Beatrice, NE",13100.0,2020-05-01,6,0,6
"Beatrice, NE",13100.0,2020-06-01,-11,0,-11
"Beatrice, NE",13100.0,2020-07-01,3,0,3
"Beatrice, NE",13100.0,2020-08-01,-4,0,-4
"Beatrice, NE",13100.0,2020-09-01,-2,0,-2
"Beatrice, NE",13100.0,2020-10-01,5,0,5
"Beatrice, NE",13100.0,2020-11-01,-7,0,-7
"Beatrice, NE",13100.0,2020-12-01,-7,-12,5
"Bozeman, MT",14580.0,2019-01-01,-93,-60,-33
"Bozeman, MT",14580.0,2019-02-01,-37,0,-37
"Bozeman, MT",14580.0,2019-03-01,7,0,7
"Bozeman, MT",14580.0,2019-04-01,0,46,-46
"Bozeman, MT",14580.0,2019-05-01,81,145,-64
"Bozeman, MT",14580.0,2019-06-01,4,60,-56
"Bozeman, MT",14580.0,2019-07-01,-63,0,-63
"Bozeman, MT",14580.0,2019-08-01,-29,0,-29
"Bozeman, MT",14580.0,2019-09-01,-70,-26,-44
"Bozeman, MT",14580.0,2019-10-01,-155,-146,-9
"Bozeman, MT",14580.0,2019-11-01,-74,-67,-7
"Bozeman, MT",14580.0,2019-12-01,-44,-41,-3
"Bozeman, MT",14580.0,2020-01-01,-129,-61,-68
"Bozeman, MT",14580.0,2020-02-01,-17,-13,-4
"Bozeman, MT",14580.0,2020-03-01,-15,-18,3
"Bozeman, MT",14580.0,2020-04-01,28,32,-4
"Bozeman, MT",14580.0,2020-05-01,20,97,-77
"Bozeman, MT",14580.0,2020-06-01,-1,91,-92
"Bozeman, MT",14580.0,2020-07-01,-50,13,-63
"Bozeman, MT",14580.0,2020-08-01,-29,0,-29
"Bozeman, MT",14580.0,2020-09-01,-80,-12,-68
"Bozeman, MT",14580.0,2020-10-01,-184,-141,-43
"Bozeman, MT",14580.0,2020-11-01,-150,-90,-60
"Bozeman, MT",14580.0,2020-12-01,-79,-48,-31
"Point Pleasant, WV-OH",38580.0,2019-01-01,14,0,14
"Point Pleasant, WV-OH",38580.0,2019-02-01,0,0,0
"Point Pleasant, WV-OH",38580.0,2019-03-01,22,0,22
"Point Pleasant, WV-OH",38580.0,2019-04-01,14,0,14
"Point Pleasant, WV-OH",38580.0,2019-05-01,-11,0,-11
"Point Pleasant, WV-OH",38580.0,2019-06-01,0,0,0
"Point Pleasant, WV-OH",38580.0,2019-07-01,-38,0,-38
"Point Pleasant, WV-OH",38580.0,2019-08-01,0,0,0
"Point Pleasant, WV-OH",38580.0,2019-09-01,0,0,0
"Point Pleasant, WV-OH",38580.0,2019-10-01,-39,0,-39
"Point Pleasant, WV-OH",38580.0,2019-11-01,0,0,0
"Point Pleasant, WV-OH",38580.0,2019-12-01,-11,0,-11
"Point Pleasant, WV-OH",38580.0,2020-01-01,-13,0,-13
"Point Pleasant, WV-OH",38580.0,2020-02-01,0,0,0
"Point Pleasant, WV-OH",38580.0,2020-03-01,11,0,11
"Point Pleasant, WV-OH",38580.0,2020-04-01,0,0,0
"Point Pleasant, WV-OH",38580.0,2020-05-01,-23,0,-23
"Point Pleasant, WV-OH",38580.0,2020-06-01,-12,0,-12
"Point Pleasant, WV-OH",38580.0,2020-07-01,-12,0,-12
"Point Pleasant, WV-OH",38580.0,2020-08-01,-12,0,-12
"Point Pleasant, WV-OH",38580.0,2020-09-01,-15,0,-15
"Point Pleasant, WV-OH",38580.0,2020-10-01,0,0,0
"Point Pleasant, WV-OH",38580.0,2020-11-01,0,0,0
"Point Pleasant, WV-OH",38580.0,2020-12-01,-12,0,-12
"Glenwood Springs, CO",24060.0,2019-01-01,-10,0,-10
"Glenwood Springs, CO",24060.0,2019-02-01,6,0,6
"Glenwood Springs, CO",24060.0,2019-03-01,-15,0,-15
"Glenwood Springs, CO",24060.0,2019-04-01,9,18,-9
"Glenwood Springs, CO",24060.0,2019-05-01,42,32,10
"Glenwood Springs, CO",24060.0,2019-06-01,64,70,-6
"Glenwood Springs, CO",24060.0,2019-07-01,-17,0,-17
"Glenwood Springs, CO",24060.0,2019-08-01,11,0,11
"Glenwood Springs, CO",24060.0,2019-09-01,-27,0,-27
"Glenwood Springs, CO",24060.0,2019-10-01,-35,-39,4
"Glenwood Springs, CO",24060.0,2019-11-01,-58,-53,-5
"Glenwood Springs, CO",24060.0,2019-12-01,-12,0,-12
"Glenwood Springs, CO",24060.0,2020-01-01,-6,-11,5
"Glenwood Springs, CO",24060.0,2020-02-01,-31,0,-31
"Glenwood Springs, CO",24060.0,2020-03-01,32,0,32
"Glenwood Springs, CO",24060.0,2020-04-01,22,11,11
"Glenwood Springs, CO",24060.0,2020-05-01,43,29,14
"Glenwood Springs, CO",24060.0,2020-06-01,55,44,11
"Glenwood Springs, CO",24060.0,2020-07-01,12,0,12
"Glenwood Springs, CO",24060.0,2020-08-01,58,0,58
"Glenwood Springs, CO",24060.0,2020-09-01,52,0,52
"Glenwood Springs, CO",24060.0,2020-10-01,-6,-35,29
"Glenwood Springs, CO",24060.0,2020-11-01,-8,-28,20
"Glenwood Springs, CO",24060.0,2020-12-01,8,0,8
"Enid, OK",21420.0,2019-01-01,-3,0,-3
"Enid, OK",21420.0,2019-02-01,-6,0,-6
"Enid, OK",21420.0,2019-03-01,-12,0,-12
"Enid, OK",21420.0,2019-04-01,-14,0,-14
"Enid, OK",21420.0,2019-05-01,2,0,2
"Enid, OK",21420.0,2019-06-01,-19,0,-19
"Enid, OK",21420.0,2019-07-01,-20,0,-20
"Enid, OK",21420.0,2019-08-01,-20,0,-20
"Enid, OK",21420.0,2019-09-01,-6,0,-6
"Enid, OK",21420.0,2019-10-01,7,0,7
"Enid, OK",21420.0,2019-11-01,-20,0,-20
"Enid, OK",21420.0,2019-12-01,-17,0,-17
"Enid, OK",21420.0,2020-01-01,12,0,12
"Enid, OK",21420.0,2020-02-01,-24,0,-24
"Enid, OK",21420.0,2020-03-01,4,0,4
"Enid, OK",21420.0,2020-04-01,31,0,31
"Enid, OK",21420.0,2020-05-01,-7,0,-7
"Enid, OK",21420.0,2020-06-01,-40,0,-40
"Enid, OK",21420.0,2020-07-01,-10,0,-10
"Enid, OK",21420.0,2020-08-01,-2,0,-2
"Enid, OK",21420.0,2020-09-01,7,0,7
"Enid, OK",21420.0,2020-10-01,0,0,0
"Enid, OK",21420.0,2020-11-01,-13,0,-13
"Enid, OK",21420.0,2020-12-01,-30,0,-30
"Hot Springs, AR",26300.0,2019-01-01,-21,0,-21
"Hot Springs, AR",26300.0,2019-02-01,-23,0,-23
"Hot Springs, AR",26300.0,2019-03-01,37,0,37
"Hot Springs, AR",26300.0,2019-04-01,10,0,10
"Hot Springs, AR",26300.0,2019-05-01,2,0,2
"Hot Springs, AR",26300.0,2019-06-01,25,0,25
"Hot Springs, AR",26300.0,2019-07-01,8,0,8
"Hot Springs, AR",26300.0,2019-08-01,-24,0,-24
"Hot Springs, AR",26300.0,2019-09-01,-26,0,-26
"Hot Springs, AR",26300.0,2019-10-01,-19,0,-19
"Hot Springs, AR",26300.0,2019-11-01,-18,0,-18
"Hot Springs, AR",26300.0,2019-12-01,-16,0,-16
"Hot Springs, AR",26300.0,2020-01-01,-20,0,-20
"Hot Springs, AR",26300.0,2020-02-01,8,0,8
"Hot Springs, AR",26300.0,2020-03-01,29,0,29
"Hot Springs, AR",26300.0,2020-04-01,5,0,5
"Hot Springs, AR",26300.0,2020-05-01,-6,0,-6
"Hot Springs, AR",26300.0,2020-06-01,-10,0,-10
"Hot Springs, AR",26300.0,2020-07-01,15,0,15
"Hot Springs, AR",26300.0,2020-08-01,-15,0,-15
"Hot Springs, AR",26300.0,2020-09-01,-33,0,-33
"Hot Springs, AR",26300.0,2020-10-01,8,0,8
"Hot Springs, AR",26300.0,2020-11-01,-16,0,-16
"Hot Springs, AR",26300.0,2020-12-01,-64,0,-64
"Manhattan, KS",31740.0,2019-01-01,-126,0,-126
"Manhattan, KS",31740.0,2019-02-01,-18,0,-18
"Manhattan, KS",31740.0,2019-03-01,-65,0,-65
"Manhattan, KS",31740.0,2019-04-01,-36,0,-36
"Manhattan, KS",31740.0,2019-05-01,-195,0,-195
"Manhattan, KS",31740.0,2019-06-01,-167,0,-167
"Manhattan, KS",31740.0,2019-07-01,-214,0,-214
"Manhattan, KS",31740.0,2019-08-01,-88,0,-88
"Manhattan, KS",31740.0,2019-09-01,-34,0,-34
"Manhattan, KS",31740.0,2019-10-01,-22,0,-22
"Manhattan, KS",31740.0,2019-11-01,-38,0,-38
"Manhattan, KS",31740.0,2019-12-01,-30,0,-30
"Manhattan, KS",31740.0,2020-01-01,-74,0,-74
"Manhattan, KS",31740.0,2020-02-01,-68,0,-68
"Manhattan, KS",31740.0,2020-03-01,-70,0,-70
"Manhattan, KS",31740.0,2020-04-01,-58,0,-58
"Manhattan, KS",31740.0,2020-05-01,-113,0,-113
"Manhattan, KS",31740.0,2020-06-01,-133,0,-133
"Manhattan, KS",31740.0,2020-07-01,-271,0,-271
"Manhattan, KS",31740.0,2020-08-01,-21,0,-21
"Manhattan, KS",31740.0,2020-09-01,-27,0,-27
"Manhattan, KS",31740.0,2020-10-01,21,0,21
"Manhattan, KS",31740.0,2020-11-01,-26,0,-26
"Manhattan, KS",31740.0,2020-12-01,-52,0,-52
"Flint, MI",22420.0,2019-01-01,-550,-616,66
"Flint, MI",22420.0,2019-02-01,-16,-85,69
"Flint, MI",22420.0,2019-03-01,219,-2,221
"Flint, MI",22420.0,2019-04-01,975,432,543
"Flint, MI",22420.0,2019-05-01,489,397,92
"Flint, MI",22420.0,2019-06-01,108,35,73
"Flint, MI",22420.0,2019-07-01,64,0,64
"Flint, MI",22420.0,2019-08-01,34,0,34
"Flint, MI",22420.0,2019-09-01,45,15,30
"Flint, MI",22420.0,2019-10-01,-559,-529,-30
"Flint, MI",22420.0,2019-11-01,-511,-538,27
"Flint, MI",22420.0,2019-12-01,-793,-830,37
"Flint, MI",22420.0,2020-01-01,-510,-545,35
"Flint, MI",22420.0,2020-02-01,-59,-57,-2
"Flint, MI",22420.0,2020-03-01,304,27,277
"Flint, MI",22420.0,2020-04-01,185,52,133
"Flint, MI",22420.0,2020-05-01,518,324,194
"Flint, MI",22420.0,2020-06-01,234,128,106
"Flint, MI",22420.0,2020-07-01,105,28,77
"Flint, MI",22420.0,2020-08-01,38,0,38
"Flint, MI",22420.0,2020-09-01,84,-13,97
"Flint, MI",22420.0,2020-10-01,-450,-488,38
"Flint, MI",22420.0,2020-11-01,-427,-460,33
"Flint, MI",22420.0,2020-12-01,-534,-591,57
"Batavia, NY",12860.0,2019-01-01,-21,-22,1
"Batavia, NY",12860.0,2019-02-01,13,0,13
"Batavia, NY",12860.0,2019-03-01,-7,0,-7
"Batavia, NY",12860.0,2019-04-01,0,22,-22
"Batavia, NY",12860.0,2019-05-01,0,12,-12
"Batavia, NY",12860.0,2019-06-01,2,0,2
"Batavia, NY",12860.0,2019-07-01,15,0,15
"Batavia, NY",12860.0,2019-08-01,3,0,3
"Batavia, NY",12860.0,2019-09-01,9,0,9
"Batavia, NY",12860.0,2019-10-01,37,0,37
"Batavia, NY",12860.0,2019-11-01,-27,-12,-15
"Batavia, NY",12860.0,2019-12-01,7,0,7
"Batavia, NY",12860.0,2020-01-01,-25,0,-25
"Batavia, NY",12860.0,2020-02-01,26,0,26
"Batavia, NY",12860.0,2020-03-01,-32,0,-32
"Batavia, NY",12860.0,2020-04-01,-28,0,-28
"Batavia, NY",12860.0,2020-05-01,-20,0,-20
"Batavia, NY",12860.0,2020-06-01,3,0,3
"Batavia, NY",12860.0,2020-07-01,4,0,4
"Batavia, NY",12860.0,2020-08-01,-6,0,-6
"Batavia, NY",12860.0,2020-09-01,-16,0,-16
"Batavia, NY",12860.0,2020-10-01,40,-13,53
"Batavia, NY",12860.0,2020-11-01,-29,0,-29
"Batavia, NY",12860.0,2020-12-01,-4,0,-4
"Dothan, AL",20020.0,2019-01-01,14,0,14
"Dothan, AL",20020.0,2019-02-01,56,0,56
"Dothan, AL",20020.0,2019-03-01,48,0,48
"Dothan, AL",20020.0,2019-04-01,23,0,23
"Dothan, AL",20020.0,2019-05-01,34,0,34
"Dothan, AL",20020.0,2019-06-01,71,0,71
"Dothan, AL",20020.0,2019-07-01,27,0,27
"Dothan, AL",20020.0,2019-08-01,44,0,44
"Dothan, AL",20020.0,2019-09-01,18,0,18
"Dothan, AL",20020.0,2019-10-01,25,0,25
"Dothan, AL",20020.0,2019-11-01,10,0,10
"Dothan, AL",20020.0,2019-12-01,-24,0,-24
"Dothan, AL",20020.0,2020-01-01,26,0,26
"Dothan, AL",20020.0,2020-02-01,31,0,31
"Dothan, AL",20020.0,2020-03-01,43,0,43
"Dothan, AL",20020.0,2020-04-01,-1,0,-1
"Dothan, AL",20020.0,2020-05-01,12,0,12
"Dothan, AL",20020.0,2020-06-01,-67,0,-67
"Dothan, AL",20020.0,2020-07-01,-26,0,-26
"Dothan, AL",20020.0,2020-08-01,-14,0,-14
"Dothan, AL",20020.0,2020-09-01,8,0,8
"Dothan, AL",20020.0,2020-10-01,17,0,17
"Dothan, AL",20020.0,2020-11-01,13,0,13
"Dothan, AL",20020.0,2020-12-01,17,0,17
"Georgetown, SC",23860.0,2019-01-01,1,0,1
"Georgetown, SC",23860.0,2019-02-01,-2,0,-2
"Georgetown, SC",23860.0,2019-03-01,-22,0,-22
"Georgetown, SC",23860.0,2019-04-01,8,0,8
"Georgetown, SC",23860.0,2019-05-01,-4,0,-4
"Georgetown, SC",23860.0,2019-06-01,-6,0,-6
"Georgetown, SC",23860.0,2019-07-01,9,0,9
"Georgetown, SC",23860.0,2019-08-01,0,0,0
"Georgetown, SC",23860.0,2019-09-01,4,0,4
"Georgetown, SC",23860.0,2019-10-01,3,0,3
"Georgetown, SC",23860.0,2019-11-01,-15,0,-15
"Georgetown, SC",23860.0,2019-12-01,4,0,4
"Georgetown, SC",23860.0,2020-01-01,-24,0,-24
"Georgetown, SC",23860.0,2020-02-01,-12,0,-12
"Georgetown, SC",23860.0,2020-03-01,0,0,0
"Georgetown, SC",23860.0,2020-04-01,-36,0,-36
"Georgetown, SC",23860.0,2020-05-01,3,0,3
"Georgetown, SC",23860.0,2020-06-01,-13,0,-13
"Georgetown, SC",23860.0,2020-07-01,-3,0,-3
"Georgetown, SC",23860.0,2020-08-01,44,0,44
"Georgetown, SC",23860.0,2020-09-01,-4,0,-4
"Georgetown, SC",23860.0,2020-10-01,27,0,27
"Georgetown, SC",23860.0,2020-11-01,5,0,5
"Georgetown, SC",23860.0,2020-12-01,73,0,73
"Payson, AZ",37740.0,2019-01-01,-45,-35,-10
"Payson, AZ",37740.0,2019-02-01,-9,-12,3
"Payson, AZ",37740.0,2019-03-01,17,-13,30
"Payson, AZ",37740.0,2019-04-01,51,28,23
"Payson, AZ",37740.0,2019-05-01,115,119,-4
"Payson, AZ",37740.0,2019-06-01,28,23,5
"Payson, AZ",37740.0,2019-07-01,44,16,28
"Payson, AZ",37740.0,2019-08-01,-33,-16,-17
"Payson, AZ",37740.0,2019-09-01,-38,-25,-13
"Payson, AZ",37740.0,2019-10-01,-78,-80,2
"Payson, AZ",37740.0,2019-11-01,-53,-74,21
"Payson, AZ",37740.0,2019-12-01,7,-28,35
"Payson, AZ",37740.0,2020-01-01,-32,-22,-10
"Payson, AZ",37740.0,2020-02-01,12,-11,23
"Payson, AZ",37740.0,2020-03-01,67,22,45
"Payson, AZ",37740.0,2020-04-01,159,77,82
"Payson, AZ",37740.0,2020-05-01,185,136,49
"Payson, AZ",37740.0,2020-06-01,95,47,48
"Payson, AZ",37740.0,2020-07-01,61,14,47
"Payson, AZ",37740.0,2020-08-01,50,9,41
"Payson, AZ",37740.0,2020-09-01,62,-5,67
"Payson, AZ",37740.0,2020-10-01,-19,-62,43
"Payson, AZ",37740.0,2020-11-01,-54,-74,20
"Payson, AZ",37740.0,2020-12-01,7,-15,22
"Blacksburg-Christiansburg, VA",13980.0,2019-01-01,-3,0,-3
"Blacksburg-Christiansburg, VA",13980.0,2019-02-01,-16,0,-16
"Blacksburg-Christiansburg, VA",13980.0,2019-03-01,-14,0,-14
"Blacksburg-Christiansburg, VA",13980.0,2019-04-01,-30,0,-30
"Blacksburg-Christiansburg, VA",13980.0,2019-05-01,-164,-11,-153
"Blacksburg-Christiansburg, VA",13980.0,2019-06-01,-188,0,-188
"Blacksburg-Christiansburg, VA",13980.0,2019-07-01,-231,0,-231
"Blacksburg-Christiansburg, VA",13980.0,2019-08-01,-43,0,-43
"Blacksburg-Christiansburg, VA",13980.0,2019-09-01,-47,0,-47
"Blacksburg-Christiansburg, VA",13980.0,2019-10-01,-16,0,-16
"Blacksburg-Christiansburg, VA",13980.0,2019-11-01,-12,0,-12
"Blacksburg-Christiansburg, VA",13980.0,2019-12-01,-17,0,-17
"Blacksburg-Christiansburg, VA",13980.0,2020-01-01,6,0,6
"Blacksburg-Christiansburg, VA",13980.0,2020-02-01,-32,0,-32
"Blacksburg-Christiansburg, VA",13980.0,2020-03-01,-15,0,-15
"Blacksburg-Christiansburg, VA",13980.0,2020-04-01,-18,0,-18
"Blacksburg-Christiansburg, VA",13980.0,2020-05-01,-149,0,-149
"Blacksburg-Christiansburg, VA",13980.0,2020-06-01,-110,11,-121
"Blacksburg-Christiansburg, VA",13980.0,2020-07-01,-184,0,-184
"Blacksburg-Christiansburg, VA",13980.0,2020-08-01,-43,0,-43
"Blacksburg-Christiansburg, VA",13980.0,2020-09-01,0,0,0
"Blacksburg-Christiansburg, VA",13980.0,2020-10-01,-21,0,-21
"Blacksburg-Christiansburg, VA",13980.0,2020-11-01,-11,0,-11
"Blacksburg-Christiansburg, VA",13980.0,2020-12-01,8,0,8
"Fredericksburg, TX",23240.0,2019-01-01,14,0,14
"Fredericksburg, TX",23240.0,2019-02-01,0,0,0
"Fredericksburg, TX",23240.0,2019-03-01,12,0,12
"Fredericksburg, TX",23240.0,2019-04-01,-15,0,-15
"Fredericksburg, TX",23240.0,2019-05-01,8,0,8
"Fredericksburg, TX",23240.0,2019-06-01,-14,0,-14
"Fredericksburg, TX",23240.0,2019-07-01,21,0,21
"Fredericksburg, TX",23240.0,2019-08-01,27,0,27
"Fredericksburg, TX",23240.0,2019-09-01,0,0,0
"Fredericksburg, TX",23240.0,2019-10-01,22,0,22
"Fredericksburg, TX",23240.0,2019-11-01,1,0,1
"Fredericksburg, TX",23240.0,2019-12-01,-13,0,-13
"Fredericksburg, TX",23240.0,2020-01-01,19,0,19
"Fredericksburg, TX",23240.0,2020-02-01,0,0,0
"Fredericksburg, TX",23240.0,2020-03-01,25,0,25
"Fredericksburg, TX",23240.0,2020-04-01,23,0,23
"Fredericksburg, TX",23240.0,2020-05-01,-11,0,-11
"Fredericksburg, TX",23240.0,2020-06-01,34,0,34
"Fredericksburg, TX",23240.0,2020-07-01,27,0,27
"Fredericksburg, TX",23240.0,2020-08-01,20,0,20
"Fredericksburg, TX",23240.0,2020-09-01,1,0,1
"Fredericksburg, TX",23240.0,2020-10-01,31,0,31
"Fredericksburg, TX",23240.0,2020-11-01,16,0,16
"Fredericksburg, TX",23240.0,2020-12-01,-13,0,-13
"Victoria, TX",47020.0,2019-01-01,20,0,20
"Victoria, TX",47020.0,2019-02-01,6,0,6
"Victoria, TX",47020.0,2019-03-01,-18,0,-18
"Victoria, TX",47020.0,2019-04-01,19,0,19
"Victoria, TX",47020.0,2019-05-01,60,0,60
"Victoria, TX",47020.0,2019-06-01,-18,0,-18
"Victoria, TX",47020.0,2019-07-01,-47,0,-47
"Victoria, TX",47020.0,2019-08-01,-8,0,-8
"Victoria, TX",47020.0,2019-09-01,3,0,3
"Victoria, TX",47020.0,2019-10-01,16,0,16
"Victoria, TX",47020.0,2019-11-01,-19,0,-19
"Victoria, TX",47020.0,2019-12-01,-53,0,-53
"Victoria, TX",47020.0,2020-01-01,5,0,5
"Victoria, TX",47020.0,2020-02-01,-13,0,-13
"Victoria, TX",47020.0,2020-03-01,12,0,12
"Victoria, TX",47020.0,2020-04-01,-43,0,-43
"Victoria, TX",47020.0,2020-05-01,4,0,4
"Victoria, TX",47020.0,2020-06-01,-28,0,-28
"Victoria, TX",47020.0,2020-07-01,2,0,2
"Victoria, TX",47020.0,2020-08-01,-44,0,-44
"Victoria, TX",47020.0,2020-09-01,-30,0,-30
"Victoria, TX",47020.0,2020-10-01,18,0,18
"Victoria, TX",47020.0,2020-11-01,-27,0,-27
"Victoria, TX",47020.0,2020-12-01,-33,0,-33
"Red Wing, MN",39860.0,2019-01-01,6,-15,21
"Red Wing, MN",39860.0,2019-02-01,14,0,14
"Red Wing, MN",39860.0,2019-03-01,0,0,0
"Red Wing, MN",39860.0,2019-04-01,16,0,16
"Red Wing, MN",39860.0,2019-05-01,15,11,4
"Red Wing, MN",39860.0,2019-06-01,22,0,22
"Red Wing, MN",39860.0,2019-07-01,58,0,58
"Red Wing, MN",39860.0,2019-08-01,7,0,7
"Red Wing, MN",39860.0,2019-09-01,18,0,18
"Red Wing, MN",39860.0,2019-10-01,-43,-17,-26
"Red Wing, MN",39860.0,2019-11-01,16,-12,28
"Red Wing, MN",39860.0,2019-12-01,-8,-29,21
"Red Wing, MN",39860.0,2020-01-01,-19,-18,-1
"Red Wing, MN",39860.0,2020-02-01,39,0,39
"Red Wing, MN",39860.0,2020-03-01,-12,0,-12
"Red Wing, MN",39860.0,2020-04-01,60,0,60
"Red Wing, MN",39860.0,2020-05-01,71,13,58
"Red Wing, MN",39860.0,2020-06-01,46,0,46
"Red Wing, MN",39860.0,2020-07-01,-4,0,-4
"Red Wing, MN",39860.0,2020-08-01,22,0,22
"Red Wing, MN",39860.0,2020-09-01,7,0,7
"Red Wing, MN",39860.0,2020-10-01,11,-20,31
"Red Wing, MN",39860.0,2020-11-01,66,0,66
"Red Wing, MN",39860.0,2020-12-01,-34,-29,-5
"Calhoun, GA",15660.0,2019-01-01,55,0,55
"Calhoun, GA",15660.0,2019-02-01,1,0,1
"Calhoun, GA",15660.0,2019-03-01,14,0,14
"Calhoun, GA",15660.0,2019-04-01,53,0,53
"Calhoun, GA",15660.0,2019-05-01,13,0,13
"Calhoun, GA",15660.0,2019-06-01,31,0,31
"Calhoun, GA",15660.0,2019-07-01,80,0,80
"Calhoun, GA",15660.0,2019-08-01,18,0,18
"Calhoun, GA",15660.0,2019-09-01,23,0,23
"Calhoun, GA",15660.0,2019-10-01,22,0,22
"Calhoun, GA",15660.0,2019-11-01,4,0,4
"Calhoun, GA",15660.0,2019-12-01,71,0,71
"Calhoun, GA",15660.0,2020-01-01,38,0,38
"Calhoun, GA",15660.0,2020-02-01,-17,0,-17
"Calhoun, GA",15660.0,2020-03-01,13,0,13
"Calhoun, GA",15660.0,2020-04-01,30,0,30
"Calhoun, GA",15660.0,2020-05-01,-9,0,-9
"Calhoun, GA",15660.0,2020-06-01,39,0,39
"Calhoun, GA",15660.0,2020-07-01,2,0,2
"Calhoun, GA",15660.0,2020-08-01,23,0,23
"Calhoun, GA",15660.0,2020-09-01,31,0,31
"Calhoun, GA",15660.0,2020-10-01,56,0,56
"Calhoun, GA",15660.0,2020-11-01,3,0,3
"Calhoun, GA",15660.0,2020-12-01,7,0,7
"Lebanon, NH-VT",30100.0,2019-01-01,-21,-24,3
"Lebanon, NH-VT",30100.0,2019-02-01,23,0,23
"Lebanon, NH-VT",30100.0,2019-03-01,53,0,53
"Lebanon, NH-VT",30100.0,2019-04-01,69,91,-22
"Lebanon, NH-VT",30100.0,2019-05-01,491,380,111
"Lebanon, NH-VT",30100.0,2019-06-01,-18,59,-77
"Lebanon, NH-VT",30100.0,2019-07-01,62,0,62
"Lebanon, NH-VT",30100.0,2019-08-01,-67,0,-67
"Lebanon, NH-VT",30100.0,2019-09-01,58,0,58
"Lebanon, NH-VT",30100.0,2019-10-01,-340,-398,58
"Lebanon, NH-VT",30100.0,2019-11-01,-121,-98,-23
"Lebanon, NH-VT",30100.0,2019-12-01,-42,-73,31
"Lebanon, NH-VT",30100.0,2020-01-01,-35,-36,1
"Lebanon, NH-VT",30100.0,2020-02-01,48,0,48
"Lebanon, NH-VT",30100.0,2020-03-01,231,208,23
"Lebanon, NH-VT",30100.0,2020-04-01,186,140,46
"Lebanon, NH-VT",30100.0,2020-05-01,377,316,61
"Lebanon, NH-VT",30100.0,2020-06-01,409,302,107
"Lebanon, NH-VT",30100.0,2020-07-01,138,35,103
"Lebanon, NH-VT",30100.0,2020-08-01,173,30,143
"Lebanon, NH-VT",30100.0,2020-09-01,240,43,197
"Lebanon, NH-VT",30100.0,2020-10-01,-138,-258,120
"Lebanon, NH-VT",30100.0,2020-11-01,-30,-75,45
"Lebanon, NH-VT",30100.0,2020-12-01,143,36,107
"Safford, AZ",40940.0,2019-01-01,39,0,39
"Safford, AZ",40940.0,2019-02-01,15,0,15
"Safford, AZ",40940.0,2019-03-01,15,0,15
"Safford, AZ",40940.0,2019-04-01,-20,0,-20
"Safford, AZ",40940.0,2019-05-01,17,0,17
"Safford, AZ",40940.0,2019-06-01,-11,0,-11
"Safford, AZ",40940.0,2019-07-01,1,0,1
"Safford, AZ",40940.0,2019-08-01,-10,0,-10
"Safford, AZ",40940.0,2019-09-01,28,0,28
"Safford, AZ",40940.0,2019-10-01,18,0,18
"Safford, AZ",40940.0,2019-11-01,27,0,27
"Safford, AZ",40940.0,2019-12-01,-3,0,-3
"Safford, AZ",40940.0,2020-01-01,30,0,30
"Safford, AZ",40940.0,2020-02-01,15,0,15
"Safford, AZ",40940.0,2020-03-01,-10,0,-10
"Safford, AZ",40940.0,2020-04-01,40,0,40
"Safford, AZ",40940.0,2020-05-01,-15,0,-15
"Safford, AZ",40940.0,2020-06-01,30,0,30
"Safford, AZ",40940.0,2020-07-01,-45,0,-45
"Safford, AZ",40940.0,2020-08-01,-10,0,-10
"Safford, AZ",40940.0,2020-09-01,46,0,46
"Safford, AZ",40940.0,2020-10-01,33,0,33
"Safford, AZ",40940.0,2020-11-01,-10,0,-10
"Safford, AZ",40940.0,2020-12-01,-4,0,-4
"Morristown, TN",34100.0,2019-01-01,19,0,19
"Morristown, TN",34100.0,2019-02-01,-39,0,-39
"Morristown, TN",34100.0,2019-03-01,47,0,47
"Morristown, TN",34100.0,2019-04-01,24,0,24
"Morristown, TN",34100.0,2019-05-01,66,0,66
"Morristown, TN",34100.0,2019-06-01,6,0,6
"Morristown, TN",34100.0,2019-07-01,7,0,7
"Morristown, TN",34100.0,2019-08-01,3,0,3
"Morristown, TN",34100.0,2019-09-01,-44,0,-44
"Morristown, TN",34100.0,2019-10-01,47,0,47
"Morristown, TN",34100.0,2019-11-01,0,0,0
"Morristown, TN",34100.0,2019-12-01,69,0,69
"Morristown, TN",34100.0,2020-01-01,55,0,55
"Morristown, TN",34100.0,2020-02-01,58,0,58
"Morristown, TN",34100.0,2020-03-01,12,0,12
"Morristown, TN",34100.0,2020-04-01,92,0,92
"Morristown, TN",34100.0,2020-05-01,7,0,7
"Morristown, TN",34100.0,2020-06-01,23,0,23
"Morristown, TN",34100.0,2020-07-01,46,0,46
"Morristown, TN",34100.0,2020-08-01,-7,0,-7
"Morristown, TN",34100.0,2020-09-01,22,0,22
"Morristown, TN",34100.0,2020-10-01,7,0,7
"Morristown, TN",34100.0,2020-11-01,21,0,21
"Morristown, TN",34100.0,2020-12-01,34,0,34
"Grand Forks, ND-MN",24220.0,2019-01-01,-90,-68,-22
"Grand Forks, ND-MN",24220.0,2019-02-01,-6,0,-6
"Grand Forks, ND-MN",24220.0,2019-03-01,-27,0,-27
"Grand Forks, ND-MN",24220.0,2019-04-01,87,78,9
"Grand Forks, ND-MN",24220.0,2019-05-01,-43,69,-112
"Grand Forks, ND-MN",24220.0,2019-06-01,-80,12,-92
"Grand Forks, ND-MN",24220.0,2019-07-01,-23,-11,-12
"Grand Forks, ND-MN",24220.0,2019-08-01,-93,0,-93
"Grand Forks, ND-MN",24220.0,2019-09-01,-39,0,-39
"Grand Forks, ND-MN",24220.0,2019-10-01,-165,-117,-48
"Grand Forks, ND-MN",24220.0,2019-11-01,-112,-95,-17
"Grand Forks, ND-MN",24220.0,2019-12-01,-124,-94,-30
"Grand Forks, ND-MN",24220.0,2020-01-01,-116,-74,-42
"Grand Forks, ND-MN",24220.0,2020-02-01,-15,0,-15
"Grand Forks, ND-MN",24220.0,2020-03-01,-9,0,-9
"Grand Forks, ND-MN",24220.0,2020-04-01,37,61,-24
"Grand Forks, ND-MN",24220.0,2020-05-01,2,29,-27
"Grand Forks, ND-MN",24220.0,2020-06-01,-76,12,-88
"Grand Forks, ND-MN",24220.0,2020-07-01,-43,0,-43
"Grand Forks, ND-MN",24220.0,2020-08-01,-24,0,-24
"Grand Forks, ND-MN",24220.0,2020-09-01,-20,0,-20
"Grand Forks, ND-MN",24220.0,2020-10-01,-108,-127,19
"Grand Forks, ND-MN",24220.0,2020-11-01,-118,-101,-17
"Grand Forks, ND-MN",24220.0,2020-12-01,-46,-47,1
"Marion, IN",31980.0,2019-01-01,38,0,38
"Marion, IN",31980.0,2019-02-01,-19,0,-19
"Marion, IN",31980.0,2019-03-01,-2,0,-2
"Marion, IN",31980.0,2019-04-01,-11,15,-26
"Marion, IN",31980.0,2019-05-01,1,0,1
"Marion, IN",31980.0,2019-06-01,-58,0,-58
"Marion, IN",31980.0,2019-07-01,16,0,16
"Marion, IN",31980.0,2019-08-01,-4,0,-4
"Marion, IN",31980.0,2019-09-01,29,0,29
"Marion, IN",31980.0,2019-10-01,-4,-12,8
"Marion, IN",31980.0,2019-11-01,-29,-17,-12
"Marion, IN",31980.0,2019-12-01,-17,-14,-3
"Marion, IN",31980.0,2020-01-01,-4,0,-4
"Marion, IN",31980.0,2020-02-01,-3,0,-3
"Marion, IN",31980.0,2020-03-01,8,0,8
"Marion, IN",31980.0,2020-04-01,4,0,4
"Marion, IN",31980.0,2020-05-01,13,0,13
"Marion, IN",31980.0,2020-06-01,-13,0,-13
"Marion, IN",31980.0,2020-07-01,10,0,10
"Marion, IN",31980.0,2020-08-01,-61,0,-61
"Marion, IN",31980.0,2020-09-01,-14,0,-14
"Marion, IN",31980.0,2020-10-01,13,0,13
"Marion, IN",31980.0,2020-11-01,-33,-18,-15
"Marion, IN",31980.0,2020-12-01,26,0,26
"Alexandria, LA",10780.0,2019-01-01,-14,0,-14
"Alexandria, LA",10780.0,2019-02-01,-13,0,-13
"Alexandria, LA",10780.0,2019-03-01,-26,0,-26
"Alexandria, LA",10780.0,2019-04-01,-12,0,-12
"Alexandria, LA",10780.0,2019-05-01,25,0,25
"Alexandria, LA",10780.0,2019-06-01,-5,0,-5
"Alexandria, LA",10780.0,2019-07-01,-59,0,-59
"Alexandria, LA",10780.0,2019-08-01,-22,0,-22
"Alexandria, LA",10780.0,2019-09-01,-19,0,-19
"Alexandria, LA",10780.0,2019-10-01,-2,0,-2
"Alexandria, LA",10780.0,2019-11-01,-8,0,-8
"Alexandria, LA",10780.0,2019-12-01,-17,0,-17
"Alexandria, LA",10780.0,2020-01-01,-16,0,-16
"Alexandria, LA",10780.0,2020-02-01,-24,0,-24
"Alexandria, LA",10780.0,2020-03-01,17,0,17
"Alexandria, LA",10780.0,2020-04-01,-14,0,-14
"Alexandria, LA",10780.0,2020-05-01,-5,0,-5
"Alexandria, LA",10780.0,2020-06-01,6,0,6
"Alexandria, LA",10780.0,2020-07-01,-15,0,-15
"Alexandria, LA",10780.0,2020-08-01,-5,0,-5
"Alexandria, LA",10780.0,2020-09-01,-28,0,-28
"Alexandria, LA",10780.0,2020-10-01,-14,0,-14
"Alexandria, LA",10780.0,2020-11-01,14,0,14
"Alexandria, LA",10780.0,2020-12-01,-16,0,-16
"Silver City, NM",43500.0,2019-01-01,0,0,0
"Silver City, NM",43500.0,2019-02-01,0,0,0
"Silver City, NM",43500.0,2019-03-01,-13,0,-13
"Silver City, NM",43500.0,2019-04-01,-2,11,-13
"Silver City, NM",43500.0,2019-05-01,-1,11,-12
"Silver City, NM",43500.0,2019-06-01,15,0,15
"Silver City, NM",43500.0,2019-07-01,0,0,0
"Silver City, NM",43500.0,2019-08-01,-12,0,-12
"Silver City, NM",43500.0,2019-09-01,-12,0,-12
"Silver City, NM",43500.0,2019-10-01,-12,0,-12
"Silver City, NM",43500.0,2019-11-01,16,0,16
"Silver City, NM",43500.0,2019-12-01,0,0,0
"Silver City, NM",43500.0,2020-01-01,15,0,15
"Silver City, NM",43500.0,2020-02-01,0,0,0
"Silver City, NM",43500.0,2020-03-01,0,0,0
"Silver City, NM",43500.0,2020-04-01,12,0,12
"Silver City, NM",43500.0,2020-05-01,1,12,-11
"Silver City, NM",43500.0,2020-06-01,0,0,0
"Silver City, NM",43500.0,2020-07-01,-2,0,-2
"Silver City, NM",43500.0,2020-08-01,-12,0,-12
"Silver City, NM",43500.0,2020-09-01,-19,0,-19
"Silver City, NM",43500.0,2020-10-01,0,0,0
"Silver City, NM",43500.0,2020-11-01,0,0,0
"Silver City, NM",43500.0,2020-12-01,-14,0,-14
"Moses Lake, WA",34180.0,2019-01-01,22,0,22
"Moses Lake, WA",34180.0,2019-02-01,14,0,14
"Moses Lake, WA",34180.0,2019-03-01,33,0,33
"Moses Lake, WA",34180.0,2019-04-01,108,19,89
"Moses Lake, WA",34180.0,2019-05-01,79,26,53
"Moses Lake, WA",34180.0,2019-06-01,83,0,83
"Moses Lake, WA",34180.0,2019-07-01,77,0,77
"Moses Lake, WA",34180.0,2019-08-01,56,0,56
"Moses Lake, WA",34180.0,2019-09-01,27,-16,43
"Moses Lake, WA",34180.0,2019-10-01,-87,-121,34
"Moses Lake, WA",34180.0,2019-11-01,-47,-38,-9
"Moses Lake, WA",34180.0,2019-12-01,-29,-13,-16
"Moses Lake, WA",34180.0,2020-01-01,10,0,10
"Moses Lake, WA",34180.0,2020-02-01,-15,0,-15
"Moses Lake, WA",34180.0,2020-03-01,94,11,83
"Moses Lake, WA",34180.0,2020-04-01,27,0,27
"Moses Lake, WA",34180.0,2020-05-01,94,34,60
"Moses Lake, WA",34180.0,2020-06-01,28,15,13
"Moses Lake, WA",34180.0,2020-07-01,144,0,144
"Moses Lake, WA",34180.0,2020-08-01,115,0,115
"Moses Lake, WA",34180.0,2020-09-01,52,-13,65
"Moses Lake, WA",34180.0,2020-10-01,-22,-84,62
"Moses Lake, WA",34180.0,2020-11-01,10,-25,35
"Moses Lake, WA",34180.0,2020-12-01,24,0,24
"Platteville, WI",38420.0,2019-01-01,19,0,19
"Platteville, WI",38420.0,2019-02-01,65,0,65
"Platteville, WI",38420.0,2019-03-01,13,0,13
"Platteville, WI",38420.0,2019-04-01,-33,0,-33
"Platteville, WI",38420.0,2019-05-01,-48,0,-48
"Platteville, WI",38420.0,2019-06-01,-17,0,-17
"Platteville, WI",38420.0,2019-07-01,-18,0,-18
"Platteville, WI",38420.0,2019-08-01,3,0,3
"Platteville, WI",38420.0,2019-09-01,26,0,26
"Platteville, WI",38420.0,2019-10-01,-9,-14,5
"Platteville, WI",38420.0,2019-11-01,-31,0,-31
"Platteville, WI",38420.0,2019-12-01,-72,-43,-29
"Platteville, WI",38420.0,2020-01-01,-19,0,-19
"Platteville, WI",38420.0,2020-02-01,-16,0,-16
"Platteville, WI",38420.0,2020-03-01,43,0,43
"Platteville, WI",38420.0,2020-04-01,42,0,42
"Platteville, WI",38420.0,2020-05-01,10,0,10
"Platteville, WI",38420.0,2020-06-01,19,0,19
"Platteville, WI",38420.0,2020-07-01,2,0,2
"Platteville, WI",38420.0,2020-08-01,-46,0,-46
"Platteville, WI",38420.0,2020-09-01,15,0,15
"Platteville, WI",38420.0,2020-10-01,-10,0,-10
"Platteville, WI",38420.0,2020-11-01,-8,0,-8
"Platteville, WI",38420.0,2020-12-01,3,0,3
"Alma, MI",10940.0,2019-01-01,-47,0,-47
"Alma, MI",10940.0,2019-02-01,5,0,5
"Alma, MI",10940.0,2019-03-01,-55,0,-55
"Alma, MI",10940.0,2019-04-01,38,0,38
"Alma, MI",10940.0,2019-05-01,-46,0,-46
"Alma, MI",10940.0,2019-06-01,22,0,22
"Alma, MI",10940.0,2019-07-01,27,0,27
"Alma, MI",10940.0,2019-08-01,51,0,51
"Alma, MI",10940.0,2019-09-01,-18,0,-18
"Alma, MI",10940.0,2019-10-01,-10,0,-10
"Alma, MI",10940.0,2019-11-01,-46,-27,-19
"Alma, MI",10940.0,2019-12-01,-20,-13,-7
"Alma, MI",10940.0,2020-01-01,-23,0,-23
"Alma, MI",10940.0,2020-02-01,8,0,8
"Alma, MI",10940.0,2020-03-01,14,0,14
"Alma, MI",10940.0,2020-04-01,43,0,43
"Alma, MI",10940.0,2020-05-01,25,0,25
"Alma, MI",10940.0,2020-06-01,13,0,13
"Alma, MI",10940.0,2020-07-01,2,0,2
"Alma, MI",10940.0,2020-08-01,1,0,1
"Alma, MI",10940.0,2020-09-01,31,0,31
"Alma, MI",10940.0,2020-10-01,20,0,20
"Alma, MI",10940.0,2020-11-01,11,-13,24
"Alma, MI",10940.0,2020-12-01,13,0,13
"Mayfield, KY",32460.0,2019-01-01,18,0,18
"Mayfield, KY",32460.0,2019-02-01,12,0,12
"Mayfield, KY",32460.0,2019-03-01,1,0,1
"Mayfield, KY",32460.0,2019-04-01,-3,0,-3
"Mayfield, KY",32460.0,2019-05-01,-27,0,-27
"Mayfield, KY",32460.0,2019-06-01,-11,0,-11
"Mayfield, KY",32460.0,2019-07-01,-4,0,-4
"Mayfield, KY",32460.0,2019-08-01,-19,0,-19
"Mayfield, KY",32460.0,2019-09-01,4,0,4
"Mayfield, KY",32460.0,2019-10-01,25,0,25
"Mayfield, KY",32460.0,2019-11-01,-18,0,-18
"Mayfield, KY",32460.0,2019-12-01,18,0,18
"Mayfield, KY",32460.0,2020-01-01,24,0,24
"Mayfield, KY",32460.0,2020-02-01,4,0,4
"Mayfield, KY",32460.0,2020-03-01,-11,0,-11
"Mayfield, KY",32460.0,2020-04-01,-16,0,-16
"Mayfield, KY",32460.0,2020-05-01,16,0,16
"Mayfield, KY",32460.0,2020-06-01,-31,0,-31
"Mayfield, KY",32460.0,2020-07-01,21,0,21
"Mayfield, KY",32460.0,2020-08-01,-26,0,-26
"Mayfield, KY",32460.0,2020-09-01,-18,0,-18
"Mayfield, KY",32460.0,2020-10-01,6,0,6
"Mayfield, KY",32460.0,2020-11-01,-18,0,-18
"Mayfield, KY",32460.0,2020-12-01,11,0,11
"Pampa, TX",37420.0,2019-01-01,0,0,0
"Pampa, TX",37420.0,2019-02-01,0,0,0
"Pampa, TX",37420.0,2019-03-01,0,0,0
"Pampa, TX",37420.0,2019-04-01,0,0,0
"Pampa, TX",37420.0,2019-05-01,0,0,0
"Pampa, TX",37420.0,2019-06-01,-2,0,-2
"Pampa, TX",37420.0,2019-07-01,19,0,19
"Pampa, TX",37420.0,2019-08-01,2,0,2
"Pampa, TX",37420.0,2019-09-01,0,0,0
"Pampa, TX",37420.0,2019-10-01,0,0,0
"Pampa, TX",37420.0,2019-11-01,0,0,0
"Pampa, TX",37420.0,2019-12-01,0,0,0
"Pampa, TX",37420.0,2020-01-01,0,0,0
"Pampa, TX",37420.0,2020-02-01,16,0,16
"Pampa, TX",37420.0,2020-03-01,0,0,0
"Pampa, TX",37420.0,2020-04-01,-12,0,-12
"Pampa, TX",37420.0,2020-05-01,2,0,2
"Pampa, TX",37420.0,2020-06-01,0,0,0
"Pampa, TX",37420.0,2020-07-01,-15,0,-15
"Pampa, TX",37420.0,2020-08-01,-11,0,-11
"Pampa, TX",37420.0,2020-09-01,0,0,0
"Pampa, TX",37420.0,2020-10-01,0,0,0
"Pampa, TX",37420.0,2020-11-01,0,0,0
"Pampa, TX",37420.0,2020-12-01,12,0,12
"Aberdeen, WA",10140.0,2019-01-01,57,-19,76
"Aberdeen, WA",10140.0,2019-02-01,39,0,39
"Aberdeen, WA",10140.0,2019-03-01,64,0,64
"Aberdeen, WA",10140.0,2019-04-01,17,15,2
"Aberdeen, WA",10140.0,2019-05-01,106,30,76
"Aberdeen, WA",10140.0,2019-06-01,54,0,54
"Aberdeen, WA",10140.0,2019-07-01,104,0,104
"Aberdeen, WA",10140.0,2019-08-01,32,0,32
"Aberdeen, WA",10140.0,2019-09-01,63,0,63
"Aberdeen, WA",10140.0,2019-10-01,56,-50,106
"Aberdeen, WA",10140.0,2019-11-01,16,-32,48
"Aberdeen, WA",10140.0,2019-12-01,36,0,36
"Aberdeen, WA",10140.0,2020-01-01,37,-14,51
"Aberdeen, WA",10140.0,2020-02-01,26,0,26
"Aberdeen, WA",10140.0,2020-03-01,83,13,70
"Aberdeen, WA",10140.0,2020-04-01,91,12,79
"Aberdeen, WA",10140.0,2020-05-01,82,15,67
"Aberdeen, WA",10140.0,2020-06-01,78,19,59
"Aberdeen, WA",10140.0,2020-07-01,138,0,138
"Aberdeen, WA",10140.0,2020-08-01,123,0,123
"Aberdeen, WA",10140.0,2020-09-01,107,13,94
"Aberdeen, WA",10140.0,2020-10-01,38,-53,91
"Aberdeen, WA",10140.0,2020-11-01,70,-37,107
"Aberdeen, WA",10140.0,2020-12-01,94,-12,106
"Sherman-Denison, TX",43300.0,2019-01-01,74,0,74
"Sherman-Denison, TX",43300.0,2019-02-01,58,0,58
"Sherman-Denison, TX",43300.0,2019-03-01,61,0,61
"Sherman-Denison, TX",43300.0,2019-04-01,66,0,66
"Sherman-Denison, TX",43300.0,2019-05-01,99,0,99
"Sherman-Denison, TX",43300.0,2019-06-01,109,0,109
"Sherman-Denison, TX",43300.0,2019-07-01,111,0,111
"Sherman-Denison, TX",43300.0,2019-08-01,144,0,144
"Sherman-Denison, TX",43300.0,2019-09-01,141,0,141
"Sherman-Denison, TX",43300.0,2019-10-01,81,0,81
"Sherman-Denison, TX",43300.0,2019-11-01,12,0,12
"Sherman-Denison, TX",43300.0,2019-12-01,144,0,144
"Sherman-Denison, TX",43300.0,2020-01-01,70,0,70
"Sherman-Denison, TX",43300.0,2020-02-01,80,0,80
"Sherman-Denison, TX",43300.0,2020-03-01,77,0,77
"Sherman-Denison, TX",43300.0,2020-04-01,101,0,101
"Sherman-Denison, TX",43300.0,2020-05-01,162,0,162
"Sherman-Denison, TX",43300.0,2020-06-01,147,0,147
"Sherman-Denison, TX",43300.0,2020-07-01,187,0,187
"Sherman-Denison, TX",43300.0,2020-08-01,208,0,208
"Sherman-Denison, TX",43300.0,2020-09-01,216,0,216
"Sherman-Denison, TX",43300.0,2020-10-01,129,0,129
"Sherman-Denison, TX",43300.0,2020-11-01,92,0,92
"Sherman-Denison, TX",43300.0,2020-12-01,175,0,175
"Campbellsville, KY",15820.0,2019-01-01,-11,0,-11
"Campbellsville, KY",15820.0,2019-02-01,0,0,0
"Campbellsville, KY",15820.0,2019-03-01,4,0,4
"Campbellsville, KY",15820.0,2019-04-01,12,0,12
"Campbellsville, KY",15820.0,2019-05-01,10,0,10
"Campbellsville, KY",15820.0,2019-06-01,-18,0,-18
"Campbellsville, KY",15820.0,2019-07-01,-16,0,-16
"Campbellsville, KY",15820.0,2019-08-01,15,0,15
"Campbellsville, KY",15820.0,2019-09-01,0,0,0
"Campbellsville, KY",15820.0,2019-10-01,12,0,12
"Campbellsville, KY",15820.0,2019-11-01,14,0,14
"Campbellsville, KY",15820.0,2019-12-01,0,0,0
"Campbellsville, KY",15820.0,2020-01-01,-14,0,-14
"Campbellsville, KY",15820.0,2020-02-01,-13,0,-13
"Campbellsville, KY",15820.0,2020-03-01,1,0,1
"Campbellsville, KY",15820.0,2020-04-01,0,0,0
"Campbellsville, KY",15820.0,2020-05-01,0,0,0
"Campbellsville, KY",15820.0,2020-06-01,11,0,11
"Campbellsville, KY",15820.0,2020-07-01,0,0,0
"Campbellsville, KY",15820.0,2020-08-01,-12,0,-12
"Campbellsville, KY",15820.0,2020-09-01,0,0,0
"Campbellsville, KY",15820.0,2020-10-01,13,0,13
"Campbellsville, KY",15820.0,2020-11-01,27,0,27
"Campbellsville, KY",15820.0,2020-12-01,0,0,0
"Tuscaloosa, AL",46220.0,2019-01-01,-66,-12,-54
"Tuscaloosa, AL",46220.0,2019-02-01,-34,0,-34
"Tuscaloosa, AL",46220.0,2019-03-01,-19,0,-19
"Tuscaloosa, AL",46220.0,2019-04-01,-9,0,-9
"Tuscaloosa, AL",46220.0,2019-05-01,-115,0,-115
"Tuscaloosa, AL",46220.0,2019-06-01,-111,0,-111
"Tuscaloosa, AL",46220.0,2019-07-01,-226,0,-226
"Tuscaloosa, AL",46220.0,2019-08-01,-35,0,-35
"Tuscaloosa, AL",46220.0,2019-09-01,-32,0,-32
"Tuscaloosa, AL",46220.0,2019-10-01,-74,0,-74
"Tuscaloosa, AL",46220.0,2019-11-01,-32,0,-32
"Tuscaloosa, AL",46220.0,2019-12-01,-30,0,-30
"Tuscaloosa, AL",46220.0,2020-01-01,-41,0,-41
"Tuscaloosa, AL",46220.0,2020-02-01,-44,0,-44
"Tuscaloosa, AL",46220.0,2020-03-01,-36,0,-36
"Tuscaloosa, AL",46220.0,2020-04-01,-39,0,-39
"Tuscaloosa, AL",46220.0,2020-05-01,-44,0,-44
"Tuscaloosa, AL",46220.0,2020-06-01,-128,0,-128
"Tuscaloosa, AL",46220.0,2020-07-01,-171,0,-171
"Tuscaloosa, AL",46220.0,2020-08-01,-95,0,-95
"Tuscaloosa, AL",46220.0,2020-09-01,-4,0,-4
"Tuscaloosa, AL",46220.0,2020-10-01,-44,0,-44
"Tuscaloosa, AL",46220.0,2020-11-01,-56,0,-56
"Tuscaloosa, AL",46220.0,2020-12-01,-56,0,-56
"Paragould, AR",37500.0,2019-01-01,10,0,10
"Paragould, AR",37500.0,2019-02-01,-2,0,-2
"Paragould, AR",37500.0,2019-03-01,-4,0,-4
"Paragould, AR",37500.0,2019-04-01,-4,0,-4
"Paragould, AR",37500.0,2019-05-01,-21,0,-21
"Paragould, AR",37500.0,2019-06-01,16,0,16
"Paragould, AR",37500.0,2019-07-01,1,0,1
"Paragould, AR",37500.0,2019-08-01,26,0,26
"Paragould, AR",37500.0,2019-09-01,31,0,31
"Paragould, AR",37500.0,2019-10-01,-5,0,-5
"Paragould, AR",37500.0,2019-11-01,7,0,7
"Paragould, AR",37500.0,2019-12-01,-7,0,-7
"Paragould, AR",37500.0,2020-01-01,45,0,45
"Paragould, AR",37500.0,2020-02-01,34,0,34
"Paragould, AR",37500.0,2020-03-01,26,0,26
"Paragould, AR",37500.0,2020-04-01,1,0,1
"Paragould, AR",37500.0,2020-05-01,22,0,22
"Paragould, AR",37500.0,2020-06-01,-33,0,-33
"Paragould, AR",37500.0,2020-07-01,5,0,5
"Paragould, AR",37500.0,2020-08-01,-7,0,-7
"Paragould, AR",37500.0,2020-09-01,7,0,7
"Paragould, AR",37500.0,2020-10-01,5,0,5
"Paragould, AR",37500.0,2020-11-01,40,0,40
"Paragould, AR",37500.0,2020-12-01,9,0,9
"Dayton-Kettering, OH",19430.0,2019-01-01,-289,-262,-27
"Dayton-Kettering, OH",19430.0,2019-02-01,-42,-15,-27
"Dayton-Kettering, OH",19430.0,2019-03-01,37,0,37
"Dayton-Kettering, OH",19430.0,2019-04-01,282,190,92
"Dayton-Kettering, OH",19430.0,2019-05-01,116,107,9
"Dayton-Kettering, OH",19430.0,2019-06-01,-90,4,-94
"Dayton-Kettering, OH",19430.0,2019-07-01,-84,-13,-71
"Dayton-Kettering, OH",19430.0,2019-08-01,-40,-11,-29
"Dayton-Kettering, OH",19430.0,2019-09-01,-58,0,-58
"Dayton-Kettering, OH",19430.0,2019-10-01,-280,-150,-130
"Dayton-Kettering, OH",19430.0,2019-11-01,-219,-157,-62
"Dayton-Kettering, OH",19430.0,2019-12-01,-445,-364,-81
"Dayton-Kettering, OH",19430.0,2020-01-01,-330,-306,-24
"Dayton-Kettering, OH",19430.0,2020-02-01,21,0,21
"Dayton-Kettering, OH",19430.0,2020-03-01,43,6,37
"Dayton-Kettering, OH",19430.0,2020-04-01,186,-1,187
"Dayton-Kettering, OH",19430.0,2020-05-01,293,135,158
"Dayton-Kettering, OH",19430.0,2020-06-01,12,61,-49
"Dayton-Kettering, OH",19430.0,2020-07-01,47,0,47
"Dayton-Kettering, OH",19430.0,2020-08-01,60,0,60
"Dayton-Kettering, OH",19430.0,2020-09-01,54,0,54
"Dayton-Kettering, OH",19430.0,2020-10-01,-201,-145,-56
"Dayton-Kettering, OH",19430.0,2020-11-01,-191,-136,-55
"Dayton-Kettering, OH",19430.0,2020-12-01,-293,-259,-34
"Greeneville, TN",24620.0,2019-01-01,-2,0,-2
"Greeneville, TN",24620.0,2019-02-01,6,0,6
"Greeneville, TN",24620.0,2019-03-01,-44,0,-44
"Greeneville, TN",24620.0,2019-04-01,-45,0,-45
"Greeneville, TN",24620.0,2019-05-01,-11,0,-11
"Greeneville, TN",24620.0,2019-06-01,5,0,5
"Greeneville, TN",24620.0,2019-07-01,41,0,41
"Greeneville, TN",24620.0,2019-08-01,-8,0,-8
"Greeneville, TN",24620.0,2019-09-01,-14,0,-14
"Greeneville, TN",24620.0,2019-10-01,-18,0,-18
"Greeneville, TN",24620.0,2019-11-01,-3,0,-3
"Greeneville, TN",24620.0,2019-12-01,1,0,1
"Greeneville, TN",24620.0,2020-01-01,-11,0,-11
"Greeneville, TN",24620.0,2020-02-01,-15,0,-15
"Greeneville, TN",24620.0,2020-03-01,9,0,9
"Greeneville, TN",24620.0,2020-04-01,0,0,0
"Greeneville, TN",24620.0,2020-05-01,2,0,2
"Greeneville, TN",24620.0,2020-06-01,7,0,7
"Greeneville, TN",24620.0,2020-07-01,-25,0,-25
"Greeneville, TN",24620.0,2020-08-01,-43,0,-43
"Greeneville, TN",24620.0,2020-09-01,-15,0,-15
"Greeneville, TN",24620.0,2020-10-01,3,0,3
"Greeneville, TN",24620.0,2020-11-01,0,0,0
"Greeneville, TN",24620.0,2020-12-01,-6,0,-6
"Greenwood, SC",24940.0,2019-01-01,-25,0,-25
"Greenwood, SC",24940.0,2019-02-01,2,0,2
"Greenwood, SC",24940.0,2019-03-01,-25,0,-25
"Greenwood, SC",24940.0,2019-04-01,-23,0,-23
"Greenwood, SC",24940.0,2019-05-01,5,0,5
"Greenwood, SC",24940.0,2019-06-01,30,0,30
"Greenwood, SC",24940.0,2019-07-01,-16,0,-16
"Greenwood, SC",24940.0,2019-08-01,-17,0,-17
"Greenwood, SC",24940.0,2019-09-01,-17,0,-17
"Greenwood, SC",24940.0,2019-10-01,-22,0,-22
"Greenwood, SC",24940.0,2019-11-01,-44,0,-44
"Greenwood, SC",24940.0,2019-12-01,2,0,2
"Greenwood, SC",24940.0,2020-01-01,12,0,12
"Greenwood, SC",24940.0,2020-02-01,-10,0,-10
"Greenwood, SC",24940.0,2020-03-01,-5,0,-5
"Greenwood, SC",24940.0,2020-04-01,-27,0,-27
"Greenwood, SC",24940.0,2020-05-01,-50,0,-50
"Greenwood, SC",24940.0,2020-06-01,-7,0,-7
"Greenwood, SC",24940.0,2020-07-01,-10,0,-10
"Greenwood, SC",24940.0,2020-08-01,8,0,8
"Greenwood, SC",24940.0,2020-09-01,-39,0,-39
"Greenwood, SC",24940.0,2020-10-01,30,0,30
"Greenwood, SC",24940.0,2020-11-01,15,0,15
"Greenwood, SC",24940.0,2020-12-01,19,0,19
"Longview, TX",30980.0,2019-01-01,11,0,11
"Longview, TX",30980.0,2019-02-01,12,0,12
"Longview, TX",30980.0,2019-03-01,-37,0,-37
"Longview, TX",30980.0,2019-04-01,-3,0,-3
"Longview, TX",30980.0,2019-05-01,-8,0,-8
"Longview, TX",30980.0,2019-06-01,17,0,17
"Longview, TX",30980.0,2019-07-01,-33,0,-33
"Longview, TX",30980.0,2019-08-01,-42,0,-42
"Longview, TX",30980.0,2019-09-01,9,0,9
"Longview, TX",30980.0,2019-10-01,-25,0,-25
"Longview, TX",30980.0,2019-11-01,-1,0,-1
"Longview, TX",30980.0,2019-12-01,-22,0,-22
"Longview, TX",30980.0,2020-01-01,-43,0,-43
"Longview, TX",30980.0,2020-02-01,-1,0,-1
"Longview, TX",30980.0,2020-03-01,15,0,15
"Longview, TX",30980.0,2020-04-01,-25,0,-25
"Longview, TX",30980.0,2020-05-01,3,0,3
"Longview, TX",30980.0,2020-06-01,-7,0,-7
"Longview, TX",30980.0,2020-07-01,-48,0,-48
"Longview, TX",30980.0,2020-08-01,-32,0,-32
"Longview, TX",30980.0,2020-09-01,50,0,50
"Longview, TX",30980.0,2020-10-01,12,0,12
"Longview, TX",30980.0,2020-11-01,-24,0,-24
"Longview, TX",30980.0,2020-12-01,48,0,48
"Grenada, MS",24980.0,2019-01-01,0,0,0
"Grenada, MS",24980.0,2019-02-01,0,0,0
"Grenada, MS",24980.0,2019-03-01,0,0,0
"Grenada, MS",24980.0,2019-04-01,21,0,21
"Grenada, MS",24980.0,2019-05-01,0,0,0
"Grenada, MS",24980.0,2019-06-01,0,0,0
"Grenada, MS",24980.0,2019-07-01,-15,0,-15
"Grenada, MS",24980.0,2019-08-01,0,0,0
"Grenada, MS",24980.0,2019-09-01,0,0,0
"Grenada, MS",24980.0,2019-10-01,0,0,0
"Grenada, MS",24980.0,2019-11-01,0,0,0
"Grenada, MS",24980.0,2019-12-01,0,0,0
"Grenada, MS",24980.0,2020-01-01,0,0,0
"Grenada, MS",24980.0,2020-02-01,0,0,0
"Grenada, MS",24980.0,2020-03-01,0,0,0
"Grenada, MS",24980.0,2020-04-01,0,0,0
"Grenada, MS",24980.0,2020-05-01,0,0,0
"Grenada, MS",24980.0,2020-06-01,-11,0,-11
"Grenada, MS",24980.0,2020-07-01,0,0,0
"Grenada, MS",24980.0,2020-08-01,0,0,0
"Grenada, MS",24980.0,2020-09-01,0,0,0
"Grenada, MS",24980.0,2020-10-01,-14,0,-14
"Grenada, MS",24980.0,2020-11-01,0,0,0
"Grenada, MS",24980.0,2020-12-01,0,0,0
"Cambridge, OH",15740.0,2019-01-01,6,0,6
"Cambridge, OH",15740.0,2019-02-01,-21,0,-21
"Cambridge, OH",15740.0,2019-03-01,-6,0,-6
"Cambridge, OH",15740.0,2019-04-01,-14,0,-14
"Cambridge, OH",15740.0,2019-05-01,43,0,43
"Cambridge, OH",15740.0,2019-06-01,15,0,15
"Cambridge, OH",15740.0,2019-07-01,-10,0,-10
"Cambridge, OH",15740.0,2019-08-01,8,0,8
"Cambridge, OH",15740.0,2019-09-01,3,0,3
"Cambridge, OH",15740.0,2019-10-01,-4,0,-4
"Cambridge, OH",15740.0,2019-11-01,-7,0,-7
"Cambridge, OH",15740.0,2019-12-01,5,0,5
"Cambridge, OH",15740.0,2020-01-01,7,0,7
"Cambridge, OH",15740.0,2020-02-01,14,0,14
"Cambridge, OH",15740.0,2020-03-01,14,0,14
"Cambridge, OH",15740.0,2020-04-01,-1,0,-1
"Cambridge, OH",15740.0,2020-05-01,-28,0,-28
"Cambridge, OH",15740.0,2020-06-01,32,0,32
"Cambridge, OH",15740.0,2020-07-01,-3,0,-3
"Cambridge, OH",15740.0,2020-08-01,6,0,6
"Cambridge, OH",15740.0,2020-09-01,7,0,7
"Cambridge, OH",15740.0,2020-10-01,5,0,5
"Cambridge, OH",15740.0,2020-11-01,-25,0,-25
"Cambridge, OH",15740.0,2020-12-01,-3,0,-3
"Greensboro-High Point, NC",24660.0,2019-01-01,0,0,0
"Greensboro-High Point, NC",24660.0,2019-02-01,-129,0,-129
"Greensboro-High Point, NC",24660.0,2019-03-01,-109,0,-109
"Greensboro-High Point, NC",24660.0,2019-04-01,-20,11,-31
"Greensboro-High Point, NC",24660.0,2019-05-01,-165,12,-177
"Greensboro-High Point, NC",24660.0,2019-06-01,-102,0,-102
"Greensboro-High Point, NC",24660.0,2019-07-01,14,0,14
"Greensboro-High Point, NC",24660.0,2019-08-01,-179,0,-179
"Greensboro-High Point, NC",24660.0,2019-09-01,-55,0,-55
"Greensboro-High Point, NC",24660.0,2019-10-01,-55,0,-55
"Greensboro-High Point, NC",24660.0,2019-11-01,-31,0,-31
"Greensboro-High Point, NC",24660.0,2019-12-01,-29,-11,-18
"Greensboro-High Point, NC",24660.0,2020-01-01,-7,0,-7
"Greensboro-High Point, NC",24660.0,2020-02-01,1,0,1
"Greensboro-High Point, NC",24660.0,2020-03-01,-113,-5,-108
"Greensboro-High Point, NC",24660.0,2020-04-01,-4,9,-13
"Greensboro-High Point, NC",24660.0,2020-05-01,-29,11,-40
"Greensboro-High Point, NC",24660.0,2020-06-01,-137,11,-148
"Greensboro-High Point, NC",24660.0,2020-07-01,-18,0,-18
"Greensboro-High Point, NC",24660.0,2020-08-01,-39,-22,-17
"Greensboro-High Point, NC",24660.0,2020-09-01,-53,0,-53
"Greensboro-High Point, NC",24660.0,2020-10-01,-101,0,-101
"Greensboro-High Point, NC",24660.0,2020-11-01,-85,0,-85
"Greensboro-High Point, NC",24660.0,2020-12-01,-149,-11,-138
"Cornelia, GA",18460.0,2019-01-01,31,0,31
"Cornelia, GA",18460.0,2019-02-01,-5,0,-5
"Cornelia, GA",18460.0,2019-03-01,1,0,1
"Cornelia, GA",18460.0,2019-04-01,1,0,1
"Cornelia, GA",18460.0,2019-05-01,39,0,39
"Cornelia, GA",18460.0,2019-06-01,-19,0,-19
"Cornelia, GA",18460.0,2019-07-01,9,0,9
"Cornelia, GA",18460.0,2019-08-01,46,0,46
"Cornelia, GA",18460.0,2019-09-01,-17,0,-17
"Cornelia, GA",18460.0,2019-10-01,31,0,31
"Cornelia, GA",18460.0,2019-11-01,11,0,11
"Cornelia, GA",18460.0,2019-12-01,38,0,38
"Cornelia, GA",18460.0,2020-01-01,37,0,37
"Cornelia, GA",18460.0,2020-02-01,-3,0,-3
"Cornelia, GA",18460.0,2020-03-01,4,0,4
"Cornelia, GA",18460.0,2020-04-01,13,-21,34
"Cornelia, GA",18460.0,2020-05-01,55,0,55
"Cornelia, GA",18460.0,2020-06-01,25,0,25
"Cornelia, GA",18460.0,2020-07-01,11,0,11
"Cornelia, GA",18460.0,2020-08-01,29,0,29
"Cornelia, GA",18460.0,2020-09-01,23,0,23
"Cornelia, GA",18460.0,2020-10-01,39,0,39
"Cornelia, GA",18460.0,2020-11-01,31,0,31
"Cornelia, GA",18460.0,2020-12-01,-2,0,-2
"Plainview, TX",38380.0,2019-01-01,4,0,4
"Plainview, TX",38380.0,2019-02-01,-17,0,-17
"Plainview, TX",38380.0,2019-03-01,-8,0,-8
"Plainview, TX",38380.0,2019-04-01,4,0,4
"Plainview, TX",38380.0,2019-05-01,15,0,15
"Plainview, TX",38380.0,2019-06-01,-15,0,-15
"Plainview, TX",38380.0,2019-07-01,-20,0,-20
"Plainview, TX",38380.0,2019-08-01,-14,0,-14
"Plainview, TX",38380.0,2019-09-01,-10,0,-10
"Plainview, TX",38380.0,2019-10-01,-14,0,-14
"Plainview, TX",38380.0,2019-11-01,3,0,3
"Plainview, TX",38380.0,2019-12-01,7,0,7
"Plainview, TX",38380.0,2020-01-01,13,0,13
"Plainview, TX",38380.0,2020-02-01,-6,0,-6
"Plainview, TX",38380.0,2020-03-01,-10,0,-10
"Plainview, TX",38380.0,2020-04-01,-3,0,-3
"Plainview, TX",38380.0,2020-05-01,-1,0,-1
"Plainview, TX",38380.0,2020-06-01,13,0,13
"Plainview, TX",38380.0,2020-07-01,-10,0,-10
"Plainview, TX",38380.0,2020-08-01,6,0,6
"Plainview, TX",38380.0,2020-09-01,-4,0,-4
"Plainview, TX",38380.0,2020-10-01,8,0,8
"Plainview, TX",38380.0,2020-11-01,-5,0,-5
"Plainview, TX",38380.0,2020-12-01,3,0,3
"Roanoke Rapids, NC",40260.0,2019-01-01,1,0,1
"Roanoke Rapids, NC",40260.0,2019-02-01,-19,0,-19
"Roanoke Rapids, NC",40260.0,2019-03-01,0,0,0
"Roanoke Rapids, NC",40260.0,2019-04-01,-14,0,-14
"Roanoke Rapids, NC",40260.0,2019-05-01,-11,0,-11
"Roanoke Rapids, NC",40260.0,2019-06-01,22,0,22
"Roanoke Rapids, NC",40260.0,2019-07-01,15,0,15
"Roanoke Rapids, NC",40260.0,2019-08-01,-12,0,-12
"Roanoke Rapids, NC",40260.0,2019-09-01,0,0,0
"Roanoke Rapids, NC",40260.0,2019-10-01,0,0,0
"Roanoke Rapids, NC",40260.0,2019-11-01,-15,0,-15
"Roanoke Rapids, NC",40260.0,2019-12-01,-1,0,-1
"Roanoke Rapids, NC",40260.0,2020-01-01,15,0,15
"Roanoke Rapids, NC",40260.0,2020-02-01,12,0,12
"Roanoke Rapids, NC",40260.0,2020-03-01,0,0,0
"Roanoke Rapids, NC",40260.0,2020-04-01,11,0,11
"Roanoke Rapids, NC",40260.0,2020-05-01,-31,0,-31
"Roanoke Rapids, NC",40260.0,2020-06-01,5,0,5
"Roanoke Rapids, NC",40260.0,2020-07-01,-7,0,-7
"Roanoke Rapids, NC",40260.0,2020-08-01,-15,0,-15
"Roanoke Rapids, NC",40260.0,2020-09-01,11,0,11
"Roanoke Rapids, NC",40260.0,2020-10-01,-13,0,-13
"Roanoke Rapids, NC",40260.0,2020-11-01,14,0,14
"Roanoke Rapids, NC",40260.0,2020-12-01,-12,0,-12
"Gainesville, GA",23580.0,2019-01-01,96,0,96
"Gainesville, GA",23580.0,2019-02-01,77,0,77
"Gainesville, GA",23580.0,2019-03-01,5,0,5
"Gainesville, GA",23580.0,2019-04-01,14,0,14
"Gainesville, GA",23580.0,2019-05-01,39,0,39
"Gainesville, GA",23580.0,2019-06-01,58,0,58
"Gainesville, GA",23580.0,2019-07-01,31,0,31
"Gainesville, GA",23580.0,2019-08-01,79,0,79
"Gainesville, GA",23580.0,2019-09-01,54,0,54
"Gainesville, GA",23580.0,2019-10-01,54,13,41
"Gainesville, GA",23580.0,2019-11-01,78,0,78
"Gainesville, GA",23580.0,2019-12-01,66,0,66
"Gainesville, GA",23580.0,2020-01-01,10,-12,22
"Gainesville, GA",23580.0,2020-02-01,9,0,9
"Gainesville, GA",23580.0,2020-03-01,81,11,70
"Gainesville, GA",23580.0,2020-04-01,107,13,94
"Gainesville, GA",23580.0,2020-05-01,134,0,134
"Gainesville, GA",23580.0,2020-06-01,83,0,83
"Gainesville, GA",23580.0,2020-07-01,126,-11,137
"Gainesville, GA",23580.0,2020-08-01,128,0,128
"Gainesville, GA",23580.0,2020-09-01,201,0,201
"Gainesville, GA",23580.0,2020-10-01,133,0,133
"Gainesville, GA",23580.0,2020-11-01,172,0,172
"Gainesville, GA",23580.0,2020-12-01,141,0,141
"Grand Island, NE",24260.0,2019-01-01,-113,0,-113
"Grand Island, NE",24260.0,2019-02-01,31,0,31
"Grand Island, NE",24260.0,2019-03-01,-2,0,-2
"Grand Island, NE",24260.0,2019-04-01,-1,0,-1
"Grand Island, NE",24260.0,2019-05-01,-53,0,-53
"Grand Island, NE",24260.0,2019-06-01,-15,0,-15
"Grand Island, NE",24260.0,2019-07-01,11,0,11
"Grand Island, NE",24260.0,2019-08-01,21,0,21
"Grand Island, NE",24260.0,2019-09-01,-21,0,-21
"Grand Island, NE",24260.0,2019-10-01,-20,0,-20
"Grand Island, NE",24260.0,2019-11-01,-8,0,-8
"Grand Island, NE",24260.0,2019-12-01,15,0,15
"Grand Island, NE",24260.0,2020-01-01,-4,0,-4
"Grand Island, NE",24260.0,2020-02-01,-52,0,-52
"Grand Island, NE",24260.0,2020-03-01,-16,0,-16
"Grand Island, NE",24260.0,2020-04-01,-32,0,-32
"Grand Island, NE",24260.0,2020-05-01,-25,0,-25
"Grand Island, NE",24260.0,2020-06-01,-57,0,-57
"Grand Island, NE",24260.0,2020-07-01,13,0,13
"Grand Island, NE",24260.0,2020-08-01,-74,0,-74
"Grand Island, NE",24260.0,2020-09-01,-28,0,-28
"Grand Island, NE",24260.0,2020-10-01,-15,0,-15
"Grand Island, NE",24260.0,2020-11-01,-10,0,-10
"Grand Island, NE",24260.0,2020-12-01,-8,0,-8
"Gulfport-Biloxi, MS",25060.0,2019-01-01,-6,0,-6
"Gulfport-Biloxi, MS",25060.0,2019-02-01,-21,0,-21
"Gulfport-Biloxi, MS",25060.0,2019-03-01,30,0,30
"Gulfport-Biloxi, MS",25060.0,2019-04-01,-28,0,-28
"Gulfport-Biloxi, MS",25060.0,2019-05-01,44,0,44
"Gulfport-Biloxi, MS",25060.0,2019-06-01,12,0,12
"Gulfport-Biloxi, MS",25060.0,2019-07-01,70,0,70
"Gulfport-Biloxi, MS",25060.0,2019-08-01,42,0,42
"Gulfport-Biloxi, MS",25060.0,2019-09-01,40,0,40
"Gulfport-Biloxi, MS",25060.0,2019-10-01,-10,12,-22
"Gulfport-Biloxi, MS",25060.0,2019-11-01,19,0,19
"Gulfport-Biloxi, MS",25060.0,2019-12-01,107,0,107
"Gulfport-Biloxi, MS",25060.0,2020-01-01,-24,0,-24
"Gulfport-Biloxi, MS",25060.0,2020-02-01,44,0,44
"Gulfport-Biloxi, MS",25060.0,2020-03-01,61,14,47
"Gulfport-Biloxi, MS",25060.0,2020-04-01,68,0,68
"Gulfport-Biloxi, MS",25060.0,2020-05-01,43,0,43
"Gulfport-Biloxi, MS",25060.0,2020-06-01,-54,0,-54
"Gulfport-Biloxi, MS",25060.0,2020-07-01,-21,0,-21
"Gulfport-Biloxi, MS",25060.0,2020-08-01,-26,0,-26
"Gulfport-Biloxi, MS",25060.0,2020-09-01,80,0,80
"Gulfport-Biloxi, MS",25060.0,2020-10-01,30,12,18
"Gulfport-Biloxi, MS",25060.0,2020-11-01,47,0,47
"Gulfport-Biloxi, MS",25060.0,2020-12-01,25,0,25
"Findlay, OH",22300.0,2019-01-01,-42,-17,-25
"Findlay, OH",22300.0,2019-02-01,-10,0,-10
"Findlay, OH",22300.0,2019-03-01,-10,0,-10
"Findlay, OH",22300.0,2019-04-01,17,13,4
"Findlay, OH",22300.0,2019-05-01,27,14,13
"Findlay, OH",22300.0,2019-06-01,-30,0,-30
"Findlay, OH",22300.0,2019-07-01,16,0,16
"Findlay, OH",22300.0,2019-08-01,1,0,1
"Findlay, OH",22300.0,2019-09-01,-16,0,-16
"Findlay, OH",22300.0,2019-10-01,0,-16,16
"Findlay, OH",22300.0,2019-11-01,-16,-18,2
"Findlay, OH",22300.0,2019-12-01,-71,-32,-39
"Findlay, OH",22300.0,2020-01-01,-25,-11,-14
"Findlay, OH",22300.0,2020-02-01,7,0,7
"Findlay, OH",22300.0,2020-03-01,-34,0,-34
"Findlay, OH",22300.0,2020-04-01,-1,0,-1
"Findlay, OH",22300.0,2020-05-01,39,14,25
"Findlay, OH",22300.0,2020-06-01,12,0,12
"Findlay, OH",22300.0,2020-07-01,-2,0,-2
"Findlay, OH",22300.0,2020-08-01,0,0,0
"Findlay, OH",22300.0,2020-09-01,-18,0,-18
"Findlay, OH",22300.0,2020-10-01,0,-13,13
"Findlay, OH",22300.0,2020-11-01,1,0,1
"Findlay, OH",22300.0,2020-12-01,-7,-17,10
"Wauchula, FL",48100.0,2019-01-01,-34,0,-34
"Wauchula, FL",48100.0,2019-02-01,-8,0,-8
"Wauchula, FL",48100.0,2019-03-01,-27,0,-27
"Wauchula, FL",48100.0,2019-04-01,-2,0,-2
"Wauchula, FL",48100.0,2019-05-01,-15,0,-15
"Wauchula, FL",48100.0,2019-06-01,3,0,3
"Wauchula, FL",48100.0,2019-07-01,-1,0,-1
"Wauchula, FL",48100.0,2019-08-01,13,0,13
"Wauchula, FL",48100.0,2019-09-01,-14,0,-14
"Wauchula, FL",48100.0,2019-10-01,28,0,28
"Wauchula, FL",48100.0,2019-11-01,4,0,4
"Wauchula, FL",48100.0,2019-12-01,-18,0,-18
"Wauchula, FL",48100.0,2020-01-01,-24,0,-24
"Wauchula, FL",48100.0,2020-02-01,0,0,0
"Wauchula, FL",48100.0,2020-03-01,6,0,6
"Wauchula, FL",48100.0,2020-04-01,-13,0,-13
"Wauchula, FL",48100.0,2020-05-01,-6,0,-6
"Wauchula, FL",48100.0,2020-06-01,-30,0,-30
"Wauchula, FL",48100.0,2020-07-01,-28,0,-28
"Wauchula, FL",48100.0,2020-08-01,-15,0,-15
"Wauchula, FL",48100.0,2020-09-01,-35,0,-35
"Wauchula, FL",48100.0,2020-10-01,-23,0,-23
"Wauchula, FL",48100.0,2020-11-01,-24,0,-24
"Wauchula, FL",48100.0,2020-12-01,-14,0,-14
"Elizabethtown-Fort Knox, KY",21060.0,2019-01-01,26,0,26
"Elizabethtown-Fort Knox, KY",21060.0,2019-02-01,-27,0,-27
"Elizabethtown-Fort Knox, KY",21060.0,2019-03-01,66,0,66
"Elizabethtown-Fort Knox, KY",21060.0,2019-04-01,26,0,26
"Elizabethtown-Fort Knox, KY",21060.0,2019-05-01,12,0,12
"Elizabethtown-Fort Knox, KY",21060.0,2019-06-01,44,0,44
"Elizabethtown-Fort Knox, KY",21060.0,2019-07-01,25,0,25
"Elizabethtown-Fort Knox, KY",21060.0,2019-08-01,42,0,42
"Elizabethtown-Fort Knox, KY",21060.0,2019-09-01,23,0,23
"Elizabethtown-Fort Knox, KY",21060.0,2019-10-01,39,0,39
"Elizabethtown-Fort Knox, KY",21060.0,2019-11-01,61,0,61
"Elizabethtown-Fort Knox, KY",21060.0,2019-12-01,14,0,14
"Elizabethtown-Fort Knox, KY",21060.0,2020-01-01,-24,0,-24
"Elizabethtown-Fort Knox, KY",21060.0,2020-02-01,-12,0,-12
"Elizabethtown-Fort Knox, KY",21060.0,2020-03-01,77,0,77
"Elizabethtown-Fort Knox, KY",21060.0,2020-04-01,-1,0,-1
"Elizabethtown-Fort Knox, KY",21060.0,2020-05-01,6,0,6
"Elizabethtown-Fort Knox, KY",21060.0,2020-06-01,72,0,72
"Elizabethtown-Fort Knox, KY",21060.0,2020-07-01,60,0,60
"Elizabethtown-Fort Knox, KY",21060.0,2020-08-01,6,0,6
"Elizabethtown-Fort Knox, KY",21060.0,2020-09-01,40,0,40
"Elizabethtown-Fort Knox, KY",21060.0,2020-10-01,57,0,57
"Elizabethtown-Fort Knox, KY",21060.0,2020-11-01,6,0,6
"Elizabethtown-Fort Knox, KY",21060.0,2020-12-01,7,0,7
"Beaumont-Port Arthur, TX",13140.0,2019-01-01,-64,12,-76
"Beaumont-Port Arthur, TX",13140.0,2019-02-01,-66,-12,-54
"Beaumont-Port Arthur, TX",13140.0,2019-03-01,-113,0,-113
"Beaumont-Port Arthur, TX",13140.0,2019-04-01,-3,0,-3
"Beaumont-Port Arthur, TX",13140.0,2019-05-01,-61,0,-61
"Beaumont-Port Arthur, TX",13140.0,2019-06-01,-36,0,-36
"Beaumont-Port Arthur, TX",13140.0,2019-07-01,-46,0,-46
"Beaumont-Port Arthur, TX",13140.0,2019-08-01,-113,-12,-101
"Beaumont-Port Arthur, TX",13140.0,2019-09-01,-94,0,-94
"Beaumont-Port Arthur, TX",13140.0,2019-10-01,-139,0,-139
"Beaumont-Port Arthur, TX",13140.0,2019-11-01,-49,0,-49
"Beaumont-Port Arthur, TX",13140.0,2019-12-01,-70,0,-70
"Beaumont-Port Arthur, TX",13140.0,2020-01-01,-22,-15,-7
"Beaumont-Port Arthur, TX",13140.0,2020-02-01,-72,0,-72
"Beaumont-Port Arthur, TX",13140.0,2020-03-01,-104,-11,-93
"Beaumont-Port Arthur, TX",13140.0,2020-04-01,-84,0,-84
"Beaumont-Port Arthur, TX",13140.0,2020-05-01,-51,0,-51
"Beaumont-Port Arthur, TX",13140.0,2020-06-01,-60,0,-60
"Beaumont-Port Arthur, TX",13140.0,2020-07-01,-110,0,-110
"Beaumont-Port Arthur, TX",13140.0,2020-08-01,-28,0,-28
"Beaumont-Port Arthur, TX",13140.0,2020-09-01,31,47,-16
"Beaumont-Port Arthur, TX",13140.0,2020-10-01,-48,11,-59
"Beaumont-Port Arthur, TX",13140.0,2020-11-01,-22,11,-33
"Beaumont-Port Arthur, TX",13140.0,2020-12-01,-44,0,-44
"Harrisonburg, VA",25500.0,2019-01-01,-2,0,-2
"Harrisonburg, VA",25500.0,2019-02-01,9,0,9
"Harrisonburg, VA",25500.0,2019-03-01,-3,0,-3
"Harrisonburg, VA",25500.0,2019-04-01,-3,0,-3
"Harrisonburg, VA",25500.0,2019-05-01,-50,0,-50
"Harrisonburg, VA",25500.0,2019-06-01,-48,0,-48
"Harrisonburg, VA",25500.0,2019-07-01,-81,0,-81
"Harrisonburg, VA",25500.0,2019-08-01,-31,0,-31
"Harrisonburg, VA",25500.0,2019-09-01,-3,0,-3
"Harrisonburg, VA",25500.0,2019-10-01,-8,0,-8
"Harrisonburg, VA",25500.0,2019-11-01,-54,0,-54
"Harrisonburg, VA",25500.0,2019-12-01,-30,0,-30
"Harrisonburg, VA",25500.0,2020-01-01,10,0,10
"Harrisonburg, VA",25500.0,2020-02-01,-15,0,-15
"Harrisonburg, VA",25500.0,2020-03-01,-24,0,-24
"Harrisonburg, VA",25500.0,2020-04-01,-29,0,-29
"Harrisonburg, VA",25500.0,2020-05-01,-4,0,-4
"Harrisonburg, VA",25500.0,2020-06-01,-84,0,-84
"Harrisonburg, VA",25500.0,2020-07-01,-101,0,-101
"Harrisonburg, VA",25500.0,2020-08-01,-8,0,-8
"Harrisonburg, VA",25500.0,2020-09-01,-28,0,-28
"Harrisonburg, VA",25500.0,2020-10-01,-25,0,-25
"Harrisonburg, VA",25500.0,2020-11-01,-28,0,-28
"Harrisonburg, VA",25500.0,2020-12-01,-3,0,-3
"Hartford-East Hartford-Middletown, CT",25540.0,2019-01-01,-1013,-1110,97
"Hartford-East Hartford-Middletown, CT",25540.0,2019-02-01,72,-68,140
"Hartford-East Hartford-Middletown, CT",25540.0,2019-03-01,245,83,162
"Hartford-East Hartford-Middletown, CT",25540.0,2019-04-01,1307,999,308
"Hartford-East Hartford-Middletown, CT",25540.0,2019-05-01,1767,1552,215
"Hartford-East Hartford-Middletown, CT",25540.0,2019-06-01,214,268,-54
"Hartford-East Hartford-Middletown, CT",25540.0,2019-07-01,269,60,209
"Hartford-East Hartford-Middletown, CT",25540.0,2019-08-01,-41,52,-93
"Hartford-East Hartford-Middletown, CT",25540.0,2019-09-01,-103,-70,-33
"Hartford-East Hartford-Middletown, CT",25540.0,2019-10-01,-971,-826,-145
"Hartford-East Hartford-Middletown, CT",25540.0,2019-11-01,-80,-199,119
"Hartford-East Hartford-Middletown, CT",25540.0,2019-12-01,-998,-926,-72
"Hartford-East Hartford-Middletown, CT",25540.0,2020-01-01,-849,-942,93
"Hartford-East Hartford-Middletown, CT",25540.0,2020-02-01,125,-68,193
"Hartford-East Hartford-Middletown, CT",25540.0,2020-03-01,881,473,408
"Hartford-East Hartford-Middletown, CT",25540.0,2020-04-01,765,397,368
"Hartford-East Hartford-Middletown, CT",25540.0,2020-05-01,1249,951,298
"Hartford-East Hartford-Middletown, CT",25540.0,2020-06-01,1192,913,279
"Hartford-East Hartford-Middletown, CT",25540.0,2020-07-01,667,254,413
"Hartford-East Hartford-Middletown, CT",25540.0,2020-08-01,625,81,544
"Hartford-East Hartford-Middletown, CT",25540.0,2020-09-01,377,49,328
"Hartford-East Hartford-Middletown, CT",25540.0,2020-10-01,-384,-549,165
"Hartford-East Hartford-Middletown, CT",25540.0,2020-11-01,20,-300,320
"Hartford-East Hartford-Middletown, CT",25540.0,2020-12-01,-179,-625,446
"Hilo, HI",25900.0,2019-01-01,119,92,27
"Hilo, HI",25900.0,2019-02-01,59,16,43
"Hilo, HI",25900.0,2019-03-01,45,0,45
"Hilo, HI",25900.0,2019-04-01,-10,-49,39
"Hilo, HI",25900.0,2019-05-01,17,-41,58
"Hilo, HI",25900.0,2019-06-01,69,-32,101
"Hilo, HI",25900.0,2019-07-01,15,0,15
"Hilo, HI",25900.0,2019-08-01,101,2,99
"Hilo, HI",25900.0,2019-09-01,82,0,82
"Hilo, HI",25900.0,2019-10-01,172,53,119
"Hilo, HI",25900.0,2019-11-01,115,69,46
"Hilo, HI",25900.0,2019-12-01,69,31,38
"Hilo, HI",25900.0,2020-01-01,126,80,46
"Hilo, HI",25900.0,2020-02-01,53,13,40
"Hilo, HI",25900.0,2020-03-01,106,9,97
"Hilo, HI",25900.0,2020-04-01,174,33,141
"Hilo, HI",25900.0,2020-05-01,43,-16,59
"Hilo, HI",25900.0,2020-06-01,72,34,38
"Hilo, HI",25900.0,2020-07-01,144,35,109
"Hilo, HI",25900.0,2020-08-01,211,5,206
"Hilo, HI",25900.0,2020-09-01,157,31,126
"Hilo, HI",25900.0,2020-10-01,238,98,140
"Hilo, HI",25900.0,2020-11-01,175,78,97
"Hilo, HI",25900.0,2020-12-01,151,88,63
"Brownsville, TN",15140.0,2019-01-01,17,0,17
"Brownsville, TN",15140.0,2019-02-01,19,0,19
"Brownsville, TN",15140.0,2019-03-01,-1,0,-1
"Brownsville, TN",15140.0,2019-04-01,0,0,0
"Brownsville, TN",15140.0,2019-05-01,0,0,0
"Brownsville, TN",15140.0,2019-06-01,3,0,3
"Brownsville, TN",15140.0,2019-07-01,0,0,0
"Brownsville, TN",15140.0,2019-08-01,0,0,0
"Brownsville, TN",15140.0,2019-09-01,-11,0,-11
"Brownsville, TN",15140.0,2019-10-01,-30,0,-30
"Brownsville, TN",15140.0,2019-11-01,0,0,0
"Brownsville, TN",15140.0,2019-12-01,5,0,5
"Brownsville, TN",15140.0,2020-01-01,0,0,0
"Brownsville, TN",15140.0,2020-02-01,0,0,0
"Brownsville, TN",15140.0,2020-03-01,-13,0,-13
"Brownsville, TN",15140.0,2020-04-01,-11,0,-11
"Brownsville, TN",15140.0,2020-05-01,0,0,0
"Brownsville, TN",15140.0,2020-06-01,0,0,0
"Brownsville, TN",15140.0,2020-07-01,0,0,0
"Brownsville, TN",15140.0,2020-08-01,22,0,22
"Brownsville, TN",15140.0,2020-09-01,-2,0,-2
"Brownsville, TN",15140.0,2020-10-01,0,0,0
"Brownsville, TN",15140.0,2020-11-01,12,0,12
"Brownsville, TN",15140.0,2020-12-01,0,0,0
"Hope, AR",26260.0,2019-01-01,21,0,21
"Hope, AR",26260.0,2019-02-01,0,0,0
"Hope, AR",26260.0,2019-03-01,0,0,0
"Hope, AR",26260.0,2019-04-01,0,0,0
"Hope, AR",26260.0,2019-05-01,0,0,0
"Hope, AR",26260.0,2019-06-01,0,0,0
"Hope, AR",26260.0,2019-07-01,0,0,0
"Hope, AR",26260.0,2019-08-01,0,0,0
"Hope, AR",26260.0,2019-09-01,0,0,0
"Hope, AR",26260.0,2019-10-01,0,0,0
"Hope, AR",26260.0,2019-11-01,0,0,0
"Hope, AR",26260.0,2019-12-01,0,0,0
"Hope, AR",26260.0,2020-01-01,11,0,11
"Hope, AR",26260.0,2020-02-01,0,0,0
"Hope, AR",26260.0,2020-03-01,0,0,0
"Hope, AR",26260.0,2020-04-01,0,0,0
"Hope, AR",26260.0,2020-05-01,0,0,0
"Hope, AR",26260.0,2020-06-01,0,0,0
"Hope, AR",26260.0,2020-07-01,0,0,0
"Hope, AR",26260.0,2020-08-01,0,0,0
"Hope, AR",26260.0,2020-09-01,0,0,0
"Hope, AR",26260.0,2020-10-01,0,0,0
"Hope, AR",26260.0,2020-11-01,0,0,0
"Hope, AR",26260.0,2020-12-01,0,0,0
"Evansville, IN-KY",21780.0,2019-01-01,-44,-16,-28
"Evansville, IN-KY",21780.0,2019-02-01,54,0,54
"Evansville, IN-KY",21780.0,2019-03-01,-7,0,-7
"Evansville, IN-KY",21780.0,2019-04-01,-24,0,-24
"Evansville, IN-KY",21780.0,2019-05-01,-18,0,-18
"Evansville, IN-KY",21780.0,2019-06-01,26,0,26
"Evansville, IN-KY",21780.0,2019-07-01,75,0,75
"Evansville, IN-KY",21780.0,2019-08-01,70,0,70
"Evansville, IN-KY",21780.0,2019-09-01,7,0,7
"Evansville, IN-KY",21780.0,2019-10-01,-8,0,-8
"Evansville, IN-KY",21780.0,2019-11-01,-38,0,-38
"Evansville, IN-KY",21780.0,2019-12-01,-58,-28,-30
"Evansville, IN-KY",21780.0,2020-01-01,18,0,18
"Evansville, IN-KY",21780.0,2020-02-01,10,0,10
"Evansville, IN-KY",21780.0,2020-03-01,6,0,6
"Evansville, IN-KY",21780.0,2020-04-01,21,0,21
"Evansville, IN-KY",21780.0,2020-05-01,-2,0,-2
"Evansville, IN-KY",21780.0,2020-06-01,-19,0,-19
"Evansville, IN-KY",21780.0,2020-07-01,-46,0,-46
"Evansville, IN-KY",21780.0,2020-08-01,20,0,20
"Evansville, IN-KY",21780.0,2020-09-01,-41,0,-41
"Evansville, IN-KY",21780.0,2020-10-01,74,0,74
"Evansville, IN-KY",21780.0,2020-11-01,-4,0,-4
"Evansville, IN-KY",21780.0,2020-12-01,-24,-22,-2
"Athens, TX",11980.0,2019-01-01,31,0,31
"Athens, TX",11980.0,2019-02-01,43,0,43
"Athens, TX",11980.0,2019-03-01,77,0,77
"Athens, TX",11980.0,2019-04-01,46,0,46
"Athens, TX",11980.0,2019-05-01,82,0,82
"Athens, TX",11980.0,2019-06-01,63,0,63
"Athens, TX",11980.0,2019-07-01,61,0,61
"Athens, TX",11980.0,2019-08-01,91,0,91
"Athens, TX",11980.0,2019-09-01,63,0,63
"Athens, TX",11980.0,2019-10-01,40,0,40
"Athens, TX",11980.0,2019-11-01,18,0,18
"Athens, TX",11980.0,2019-12-01,31,0,31
"Athens, TX",11980.0,2020-01-01,18,0,18
"Athens, TX",11980.0,2020-02-01,6,0,6
"Athens, TX",11980.0,2020-03-01,63,37,26
"Athens, TX",11980.0,2020-04-01,38,13,25
"Athens, TX",11980.0,2020-05-01,35,0,35
"Athens, TX",11980.0,2020-06-01,50,0,50
"Athens, TX",11980.0,2020-07-01,62,0,62
"Athens, TX",11980.0,2020-08-01,99,0,99
"Athens, TX",11980.0,2020-09-01,66,0,66
"Athens, TX",11980.0,2020-10-01,29,0,29
"Athens, TX",11980.0,2020-11-01,47,0,47
"Athens, TX",11980.0,2020-12-01,13,0,13
"Clewiston, FL",17500.0,2019-01-01,26,0,26
"Clewiston, FL",17500.0,2019-02-01,40,0,40
"Clewiston, FL",17500.0,2019-03-01,10,0,10
"Clewiston, FL",17500.0,2019-04-01,13,0,13
"Clewiston, FL",17500.0,2019-05-01,65,0,65
"Clewiston, FL",17500.0,2019-06-01,16,0,16
"Clewiston, FL",17500.0,2019-07-01,-7,0,-7
"Clewiston, FL",17500.0,2019-08-01,18,0,18
"Clewiston, FL",17500.0,2019-09-01,6,0,6
"Clewiston, FL",17500.0,2019-10-01,44,0,44
"Clewiston, FL",17500.0,2019-11-01,24,0,24
"Clewiston, FL",17500.0,2019-12-01,-19,0,-19
"Clewiston, FL",17500.0,2020-01-01,26,0,26
"Clewiston, FL",17500.0,2020-02-01,-3,0,-3
"Clewiston, FL",17500.0,2020-03-01,21,0,21
"Clewiston, FL",17500.0,2020-04-01,46,0,46
"Clewiston, FL",17500.0,2020-05-01,19,0,19
"Clewiston, FL",17500.0,2020-06-01,37,0,37
"Clewiston, FL",17500.0,2020-07-01,45,0,45
"Clewiston, FL",17500.0,2020-08-01,17,0,17
"Clewiston, FL",17500.0,2020-09-01,55,0,55
"Clewiston, FL",17500.0,2020-10-01,23,0,23
"Clewiston, FL",17500.0,2020-11-01,32,0,32
"Clewiston, FL",17500.0,2020-12-01,17,0,17
"Davenport-Moline-Rock Island, IA-IL",19340.0,2019-01-01,-127,-169,42
"Davenport-Moline-Rock Island, IA-IL",19340.0,2019-02-01,-11,0,-11
"Davenport-Moline-Rock Island, IA-IL",19340.0,2019-03-01,5,0,5
"Davenport-Moline-Rock Island, IA-IL",19340.0,2019-04-01,167,128,39
"Davenport-Moline-Rock Island, IA-IL",19340.0,2019-05-01,168,108,60
"Davenport-Moline-Rock Island, IA-IL",19340.0,2019-06-01,-36,11,-47
"Davenport-Moline-Rock Island, IA-IL",19340.0,2019-07-01,32,0,32
"Davenport-Moline-Rock Island, IA-IL",19340.0,2019-08-01,-36,0,-36
"Davenport-Moline-Rock Island, IA-IL",19340.0,2019-09-01,-83,0,-83
"Davenport-Moline-Rock Island, IA-IL",19340.0,2019-10-01,-242,-237,-5
"Davenport-Moline-Rock Island, IA-IL",19340.0,2019-11-01,-144,-145,1
"Davenport-Moline-Rock Island, IA-IL",19340.0,2019-12-01,-361,-345,-16
"Davenport-Moline-Rock Island, IA-IL",19340.0,2020-01-01,-171,-176,5
"Davenport-Moline-Rock Island, IA-IL",19340.0,2020-02-01,31,0,31
"Davenport-Moline-Rock Island, IA-IL",19340.0,2020-03-01,68,0,68
"Davenport-Moline-Rock Island, IA-IL",19340.0,2020-04-01,112,38,74
"Davenport-Moline-Rock Island, IA-IL",19340.0,2020-05-01,109,97,12
"Davenport-Moline-Rock Island, IA-IL",19340.0,2020-06-01,48,12,36
"Davenport-Moline-Rock Island, IA-IL",19340.0,2020-07-01,4,0,4
"Davenport-Moline-Rock Island, IA-IL",19340.0,2020-08-01,-12,0,-12
"Davenport-Moline-Rock Island, IA-IL",19340.0,2020-09-01,14,-12,26
"Davenport-Moline-Rock Island, IA-IL",19340.0,2020-10-01,-204,-181,-23
"Davenport-Moline-Rock Island, IA-IL",19340.0,2020-11-01,-148,-149,1
"Davenport-Moline-Rock Island, IA-IL",19340.0,2020-12-01,-190,-221,31
"New Castle, IN",35220.0,2019-01-01,-12,0,-12
"New Castle, IN",35220.0,2019-02-01,-10,0,-10
"New Castle, IN",35220.0,2019-03-01,-16,0,-16
"New Castle, IN",35220.0,2019-04-01,0,0,0
"New Castle, IN",35220.0,2019-05-01,48,0,48
"New Castle, IN",35220.0,2019-06-01,28,0,28
"New Castle, IN",35220.0,2019-07-01,4,0,4
"New Castle, IN",35220.0,2019-08-01,-18,0,-18
"New Castle, IN",35220.0,2019-09-01,-2,0,-2
"New Castle, IN",35220.0,2019-10-01,20,0,20
"New Castle, IN",35220.0,2019-11-01,20,0,20
"New Castle, IN",35220.0,2019-12-01,21,0,21
"New Castle, IN",35220.0,2020-01-01,56,0,56
"New Castle, IN",35220.0,2020-02-01,46,0,46
"New Castle, IN",35220.0,2020-03-01,55,0,55
"New Castle, IN",35220.0,2020-04-01,23,0,23
"New Castle, IN",35220.0,2020-05-01,7,0,7
"New Castle, IN",35220.0,2020-06-01,21,0,21
"New Castle, IN",35220.0,2020-07-01,22,0,22
"New Castle, IN",35220.0,2020-08-01,-12,0,-12
"New Castle, IN",35220.0,2020-09-01,-8,0,-8
"New Castle, IN",35220.0,2020-10-01,16,0,16
"New Castle, IN",35220.0,2020-11-01,28,0,28
"New Castle, IN",35220.0,2020-12-01,9,-11,20
"Paris, TN",37540.0,2019-01-01,18,0,18
"Paris, TN",37540.0,2019-02-01,0,0,0
"Paris, TN",37540.0,2019-03-01,-30,0,-30
"Paris, TN",37540.0,2019-04-01,-13,0,-13
"Paris, TN",37540.0,2019-05-01,-28,0,-28
"Paris, TN",37540.0,2019-06-01,12,0,12
"Paris, TN",37540.0,2019-07-01,-1,0,-1
"Paris, TN",37540.0,2019-08-01,-11,0,-11
"Paris, TN",37540.0,2019-09-01,-35,0,-35
"Paris, TN",37540.0,2019-10-01,-34,0,-34
"Paris, TN",37540.0,2019-11-01,-1,0,-1
"Paris, TN",37540.0,2019-12-01,11,0,11
"Paris, TN",37540.0,2020-01-01,-26,0,-26
"Paris, TN",37540.0,2020-02-01,11,0,11
"Paris, TN",37540.0,2020-03-01,1,0,1
"Paris, TN",37540.0,2020-04-01,-32,0,-32
"Paris, TN",37540.0,2020-05-01,1,0,1
"Paris, TN",37540.0,2020-06-01,17,0,17
"Paris, TN",37540.0,2020-07-01,29,0,29
"Paris, TN",37540.0,2020-08-01,23,0,23
"Paris, TN",37540.0,2020-09-01,-26,0,-26
"Paris, TN",37540.0,2020-10-01,0,0,0
"Paris, TN",37540.0,2020-11-01,11,0,11
"Paris, TN",37540.0,2020-12-01,26,0,26
"Martinsville, VA",32300.0,2019-01-01,13,0,13
"Martinsville, VA",32300.0,2019-02-01,-11,0,-11
"Martinsville, VA",32300.0,2019-03-01,0,0,0
"Martinsville, VA",32300.0,2019-04-01,25,0,25
"Martinsville, VA",32300.0,2019-05-01,26,0,26
"Martinsville, VA",32300.0,2019-06-01,-15,0,-15
"Martinsville, VA",32300.0,2019-07-01,-1,0,-1
"Martinsville, VA",32300.0,2019-08-01,20,0,20
"Martinsville, VA",32300.0,2019-09-01,-27,0,-27
"Martinsville, VA",32300.0,2019-10-01,-6,0,-6
"Martinsville, VA",32300.0,2019-11-01,0,0,0
"Martinsville, VA",32300.0,2019-12-01,0,0,0
"Martinsville, VA",32300.0,2020-01-01,11,0,11
"Martinsville, VA",32300.0,2020-02-01,0,0,0
"Martinsville, VA",32300.0,2020-03-01,-47,0,-47
"Martinsville, VA",32300.0,2020-04-01,0,0,0
"Martinsville, VA",32300.0,2020-05-01,24,0,24
"Martinsville, VA",32300.0,2020-06-01,13,0,13
"Martinsville, VA",32300.0,2020-07-01,-1,0,-1
"Martinsville, VA",32300.0,2020-08-01,0,0,0
"Martinsville, VA",32300.0,2020-09-01,13,0,13
"Martinsville, VA",32300.0,2020-10-01,0,0,0
"Martinsville, VA",32300.0,2020-11-01,0,0,0
"Martinsville, VA",32300.0,2020-12-01,0,0,0
"Utica-Rome, NY",46540.0,2019-01-01,-321,-307,-14
"Utica-Rome, NY",46540.0,2019-02-01,-5,0,-5
"Utica-Rome, NY",46540.0,2019-03-01,38,0,38
"Utica-Rome, NY",46540.0,2019-04-01,334,234,100
"Utica-Rome, NY",46540.0,2019-05-01,398,351,47
"Utica-Rome, NY",46540.0,2019-06-01,35,59,-24
"Utica-Rome, NY",46540.0,2019-07-01,-58,0,-58
"Utica-Rome, NY",46540.0,2019-08-01,5,0,5
"Utica-Rome, NY",46540.0,2019-09-01,18,-16,34
"Utica-Rome, NY",46540.0,2019-10-01,-292,-288,-4
"Utica-Rome, NY",46540.0,2019-11-01,-205,-230,25
"Utica-Rome, NY",46540.0,2019-12-01,-271,-288,17
"Utica-Rome, NY",46540.0,2020-01-01,-351,-305,-46
"Utica-Rome, NY",46540.0,2020-02-01,-15,-12,-3
"Utica-Rome, NY",46540.0,2020-03-01,89,25,64
"Utica-Rome, NY",46540.0,2020-04-01,41,11,30
"Utica-Rome, NY",46540.0,2020-05-01,209,217,-8
"Utica-Rome, NY",46540.0,2020-06-01,116,160,-44
"Utica-Rome, NY",46540.0,2020-07-01,36,0,36
"Utica-Rome, NY",46540.0,2020-08-01,-36,0,-36
"Utica-Rome, NY",46540.0,2020-09-01,-17,-11,-6
"Utica-Rome, NY",46540.0,2020-10-01,-193,-166,-27
"Utica-Rome, NY",46540.0,2020-11-01,-166,-122,-44
"Utica-Rome, NY",46540.0,2020-12-01,-159,-180,21
"Tampa-St. Petersburg-Clearwater, FL",45300.0,2019-01-01,6970,6088,882
"Tampa-St. Petersburg-Clearwater, FL",45300.0,2019-02-01,2192,608,1584
"Tampa-St. Petersburg-Clearwater, FL",45300.0,2019-03-01,49,-109,158
"Tampa-St. Petersburg-Clearwater, FL",45300.0,2019-04-01,-7095,-5048,-2047
"Tampa-St. Petersburg-Clearwater, FL",45300.0,2019-05-01,-7091,-7589,498
"Tampa-St. Petersburg-Clearwater, FL",45300.0,2019-06-01,-280,-1713,1433
"Tampa-St. Petersburg-Clearwater, FL",45300.0,2019-07-01,1666,-286,1952
"Tampa-St. Petersburg-Clearwater, FL",45300.0,2019-08-01,1709,-14,1723
"Tampa-St. Petersburg-Clearwater, FL",45300.0,2019-09-01,1803,396,1407
"Tampa-St. Petersburg-Clearwater, FL",45300.0,2019-10-01,8125,6503,1622
"Tampa-St. Petersburg-Clearwater, FL",45300.0,2019-11-01,5873,4965,908
"Tampa-St. Petersburg-Clearwater, FL",45300.0,2019-12-01,7925,6812,1113
"Tampa-St. Petersburg-Clearwater, FL",45300.0,2020-01-01,6802,5845,957
"Tampa-St. Petersburg-Clearwater, FL",45300.0,2020-02-01,966,543,423
"Tampa-St. Petersburg-Clearwater, FL",45300.0,2020-03-01,-999,-127,-872
"Tampa-St. Petersburg-Clearwater, FL",45300.0,2020-04-01,-549,-515,-34
"Tampa-St. Petersburg-Clearwater, FL",45300.0,2020-05-01,-2834,-3425,591
"Tampa-St. Petersburg-Clearwater, FL",45300.0,2020-06-01,-1413,-2960,1547
"Tampa-St. Petersburg-Clearwater, FL",45300.0,2020-07-01,1704,-642,2346
"Tampa-St. Petersburg-Clearwater, FL",45300.0,2020-08-01,1900,-28,1928
"Tampa-St. Petersburg-Clearwater, FL",45300.0,2020-09-01,2122,158,1964
"Tampa-St. Petersburg-Clearwater, FL",45300.0,2020-10-01,7337,5211,2126
"Tampa-St. Petersburg-Clearwater, FL",45300.0,2020-11-01,5829,4522,1307
"Tampa-St. Petersburg-Clearwater, FL",45300.0,2020-12-01,6285,5092,1193
"McAllen-Edinburg-Mission, TX",32580.0,2019-01-01,145,177,-32
"McAllen-Edinburg-Mission, TX",32580.0,2019-02-01,12,0,12
"McAllen-Edinburg-Mission, TX",32580.0,2019-03-01,-109,0,-109
"McAllen-Edinburg-Mission, TX",32580.0,2019-04-01,-564,-374,-190
"McAllen-Edinburg-Mission, TX",32580.0,2019-05-01,-13,-80,67
"McAllen-Edinburg-Mission, TX",32580.0,2019-06-01,54,-11,65
"McAllen-Edinburg-Mission, TX",32580.0,2019-07-01,35,0,35
"McAllen-Edinburg-Mission, TX",32580.0,2019-08-01,114,0,114
"McAllen-Edinburg-Mission, TX",32580.0,2019-09-01,14,21,-7
"McAllen-Edinburg-Mission, TX",32580.0,2019-10-01,927,879,48
"McAllen-Edinburg-Mission, TX",32580.0,2019-11-01,1271,1253,18
"McAllen-Edinburg-Mission, TX",32580.0,2019-12-01,1270,1202,68
"McAllen-Edinburg-Mission, TX",32580.0,2020-01-01,187,112,75
"McAllen-Edinburg-Mission, TX",32580.0,2020-02-01,52,0,52
"McAllen-Edinburg-Mission, TX",32580.0,2020-03-01,-347,-26,-321
"McAllen-Edinburg-Mission, TX",32580.0,2020-04-01,-37,-94,57
"McAllen-Edinburg-Mission, TX",32580.0,2020-05-01,-33,-71,38
"McAllen-Edinburg-Mission, TX",32580.0,2020-06-01,111,-12,123
"McAllen-Edinburg-Mission, TX",32580.0,2020-07-01,40,0,40
"McAllen-Edinburg-Mission, TX",32580.0,2020-08-01,37,0,37
"McAllen-Edinburg-Mission, TX",32580.0,2020-09-01,48,16,32
"McAllen-Edinburg-Mission, TX",32580.0,2020-10-01,543,563,-20
"McAllen-Edinburg-Mission, TX",32580.0,2020-11-01,611,598,13
"McAllen-Edinburg-Mission, TX",32580.0,2020-12-01,468,434,34
"Sebring-Avon Park, FL",42700.0,2019-01-01,148,69,79
"Sebring-Avon Park, FL",42700.0,2019-02-01,4,0,4
"Sebring-Avon Park, FL",42700.0,2019-03-01,45,0,45
"Sebring-Avon Park, FL",42700.0,2019-04-01,-713,-553,-160
"Sebring-Avon Park, FL",42700.0,2019-05-01,2,-102,104
"Sebring-Avon Park, FL",42700.0,2019-06-01,12,-11,23
"Sebring-Avon Park, FL",42700.0,2019-07-01,22,0,22
"Sebring-Avon Park, FL",42700.0,2019-08-01,46,0,46
"Sebring-Avon Park, FL",42700.0,2019-09-01,79,0,79
"Sebring-Avon Park, FL",42700.0,2019-10-01,552,492,60
"Sebring-Avon Park, FL",42700.0,2019-11-01,429,426,3
"Sebring-Avon Park, FL",42700.0,2019-12-01,493,413,80
"Sebring-Avon Park, FL",42700.0,2020-01-01,128,104,24
"Sebring-Avon Park, FL",42700.0,2020-02-01,31,0,31
"Sebring-Avon Park, FL",42700.0,2020-03-01,10,-14,24
"Sebring-Avon Park, FL",42700.0,2020-04-01,3,-70,73
"Sebring-Avon Park, FL",42700.0,2020-05-01,-47,-97,50
"Sebring-Avon Park, FL",42700.0,2020-06-01,99,-11,110
"Sebring-Avon Park, FL",42700.0,2020-07-01,152,0,152
"Sebring-Avon Park, FL",42700.0,2020-08-01,99,0,99
"Sebring-Avon Park, FL",42700.0,2020-09-01,79,0,79
"Sebring-Avon Park, FL",42700.0,2020-10-01,450,326,124
"Sebring-Avon Park, FL",42700.0,2020-11-01,543,386,157
"Sebring-Avon Park, FL",42700.0,2020-12-01,416,311,105
"Manchester-Nashua, NH",31700.0,2019-01-01,-217,-377,160
"Manchester-Nashua, NH",31700.0,2019-02-01,53,-41,94
"Manchester-Nashua, NH",31700.0,2019-03-01,32,11,21
"Manchester-Nashua, NH",31700.0,2019-04-01,503,293,210
"Manchester-Nashua, NH",31700.0,2019-05-01,501,410,91
"Manchester-Nashua, NH",31700.0,2019-06-01,123,31,92
"Manchester-Nashua, NH",31700.0,2019-07-01,102,13,89
"Manchester-Nashua, NH",31700.0,2019-08-01,-13,-18,5
"Manchester-Nashua, NH",31700.0,2019-09-01,45,-32,77
"Manchester-Nashua, NH",31700.0,2019-10-01,-368,-368,0
"Manchester-Nashua, NH",31700.0,2019-11-01,-255,-248,-7
"Manchester-Nashua, NH",31700.0,2019-12-01,-335,-423,88
"Manchester-Nashua, NH",31700.0,2020-01-01,-337,-382,45
"Manchester-Nashua, NH",31700.0,2020-02-01,24,-33,57
"Manchester-Nashua, NH",31700.0,2020-03-01,307,94,213
"Manchester-Nashua, NH",31700.0,2020-04-01,293,118,175
"Manchester-Nashua, NH",31700.0,2020-05-01,311,244,67
"Manchester-Nashua, NH",31700.0,2020-06-01,260,138,122
"Manchester-Nashua, NH",31700.0,2020-07-01,107,8,99
"Manchester-Nashua, NH",31700.0,2020-08-01,256,15,241
"Manchester-Nashua, NH",31700.0,2020-09-01,-32,-27,-5
"Manchester-Nashua, NH",31700.0,2020-10-01,-38,-196,158
"Manchester-Nashua, NH",31700.0,2020-11-01,-97,-197,100
"Manchester-Nashua, NH",31700.0,2020-12-01,-100,-264,164
"Hillsdale, MI",25880.0,2019-01-01,-24,0,-24
"Hillsdale, MI",25880.0,2019-02-01,-1,0,-1
"Hillsdale, MI",25880.0,2019-03-01,-5,0,-5
"Hillsdale, MI",25880.0,2019-04-01,28,12,16
"Hillsdale, MI",25880.0,2019-05-01,-26,11,-37
"Hillsdale, MI",25880.0,2019-06-01,17,0,17
"Hillsdale, MI",25880.0,2019-07-01,-16,0,-16
"Hillsdale, MI",25880.0,2019-08-01,-4,0,-4
"Hillsdale, MI",25880.0,2019-09-01,-1,0,-1
"Hillsdale, MI",25880.0,2019-10-01,-20,-11,-9
"Hillsdale, MI",25880.0,2019-11-01,-30,-36,6
"Hillsdale, MI",25880.0,2019-12-01,-5,-23,18
"Hillsdale, MI",25880.0,2020-01-01,16,0,16
"Hillsdale, MI",25880.0,2020-02-01,24,0,24
"Hillsdale, MI",25880.0,2020-03-01,-37,0,-37
"Hillsdale, MI",25880.0,2020-04-01,-15,0,-15
"Hillsdale, MI",25880.0,2020-05-01,-24,0,-24
"Hillsdale, MI",25880.0,2020-06-01,-5,0,-5
"Hillsdale, MI",25880.0,2020-07-01,-3,0,-3
"Hillsdale, MI",25880.0,2020-08-01,13,0,13
"Hillsdale, MI",25880.0,2020-09-01,2,0,2
"Hillsdale, MI",25880.0,2020-10-01,-30,-11,-19
"Hillsdale, MI",25880.0,2020-11-01,0,-26,26
"Hillsdale, MI",25880.0,2020-12-01,-26,-28,2
"Levelland, TX",30220.0,2019-01-01,5,0,5
"Levelland, TX",30220.0,2019-02-01,-5,0,-5
"Levelland, TX",30220.0,2019-03-01,2,0,2
"Levelland, TX",30220.0,2019-04-01,-10,0,-10
"Levelland, TX",30220.0,2019-05-01,8,0,8
"Levelland, TX",30220.0,2019-06-01,-11,0,-11
"Levelland, TX",30220.0,2019-07-01,-7,0,-7
"Levelland, TX",30220.0,2019-08-01,12,0,12
"Levelland, TX",30220.0,2019-09-01,0,0,0
"Levelland, TX",30220.0,2019-10-01,13,0,13
"Levelland, TX",30220.0,2019-11-01,-8,0,-8
"Levelland, TX",30220.0,2019-12-01,-7,0,-7
"Levelland, TX",30220.0,2020-01-01,-10,0,-10
"Levelland, TX",30220.0,2020-02-01,-13,0,-13
"Levelland, TX",30220.0,2020-03-01,12,0,12
"Levelland, TX",30220.0,2020-04-01,5,0,5
"Levelland, TX",30220.0,2020-05-01,-9,0,-9
"Levelland, TX",30220.0,2020-06-01,12,0,12
"Levelland, TX",30220.0,2020-07-01,9,0,9
"Levelland, TX",30220.0,2020-08-01,13,0,13
"Levelland, TX",30220.0,2020-09-01,2,0,2
"Levelland, TX",30220.0,2020-10-01,7,0,7
"Levelland, TX",30220.0,2020-11-01,34,0,34
"Levelland, TX",30220.0,2020-12-01,23,0,23
"Urban Honolulu, HI",46520.0,2019-01-01,-192,77,-269
"Urban Honolulu, HI",46520.0,2019-02-01,-360,-12,-348
"Urban Honolulu, HI",46520.0,2019-03-01,-464,-46,-418
"Urban Honolulu, HI",46520.0,2019-04-01,-243,20,-263
"Urban Honolulu, HI",46520.0,2019-05-01,-594,-80,-514
"Urban Honolulu, HI",46520.0,2019-06-01,-740,-21,-719
"Urban Honolulu, HI",46520.0,2019-07-01,-637,8,-645
"Urban Honolulu, HI",46520.0,2019-08-01,-511,-50,-461
"Urban Honolulu, HI",46520.0,2019-09-01,-320,-26,-294
"Urban Honolulu, HI",46520.0,2019-10-01,-440,-23,-417
"Urban Honolulu, HI",46520.0,2019-11-01,-330,62,-392
"Urban Honolulu, HI",46520.0,2019-12-01,-447,59,-506
"Urban Honolulu, HI",46520.0,2020-01-01,-161,37,-198
"Urban Honolulu, HI",46520.0,2020-02-01,-491,-14,-477
"Urban Honolulu, HI",46520.0,2020-03-01,-394,29,-423
"Urban Honolulu, HI",46520.0,2020-04-01,-385,16,-401
"Urban Honolulu, HI",46520.0,2020-05-01,-347,64,-411
"Urban Honolulu, HI",46520.0,2020-06-01,-473,35,-508
"Urban Honolulu, HI",46520.0,2020-07-01,-280,34,-314
"Urban Honolulu, HI",46520.0,2020-08-01,-176,-10,-166
"Urban Honolulu, HI",46520.0,2020-09-01,-250,66,-316
"Urban Honolulu, HI",46520.0,2020-10-01,-237,135,-372
"Urban Honolulu, HI",46520.0,2020-11-01,-86,205,-291
"Urban Honolulu, HI",46520.0,2020-12-01,-98,270,-368
"Granbury, TX",24180.0,2019-01-01,93,0,93
"Granbury, TX",24180.0,2019-02-01,20,0,20
"Granbury, TX",24180.0,2019-03-01,66,0,66
"Granbury, TX",24180.0,2019-04-01,78,0,78
"Granbury, TX",24180.0,2019-05-01,86,0,86
"Granbury, TX",24180.0,2019-06-01,94,0,94
"Granbury, TX",24180.0,2019-07-01,151,0,151
"Granbury, TX",24180.0,2019-08-01,67,0,67
"Granbury, TX",24180.0,2019-09-01,53,0,53
"Granbury, TX",24180.0,2019-10-01,19,0,19
"Granbury, TX",24180.0,2019-11-01,50,0,50
"Granbury, TX",24180.0,2019-12-01,23,0,23
"Granbury, TX",24180.0,2020-01-01,26,0,26
"Granbury, TX",24180.0,2020-02-01,48,0,48
"Granbury, TX",24180.0,2020-03-01,104,0,104
"Granbury, TX",24180.0,2020-04-01,120,0,120
"Granbury, TX",24180.0,2020-05-01,58,0,58
"Granbury, TX",24180.0,2020-06-01,92,0,92
"Granbury, TX",24180.0,2020-07-01,127,0,127
"Granbury, TX",24180.0,2020-08-01,61,0,61
"Granbury, TX",24180.0,2020-09-01,75,0,75
"Granbury, TX",24180.0,2020-10-01,68,0,68
"Granbury, TX",24180.0,2020-11-01,32,0,32
"Granbury, TX",24180.0,2020-12-01,11,0,11
"Hood River, OR",26220.0,2019-01-01,16,0,16
"Hood River, OR",26220.0,2019-02-01,3,0,3
"Hood River, OR",26220.0,2019-03-01,-35,0,-35
"Hood River, OR",26220.0,2019-04-01,-9,0,-9
"Hood River, OR",26220.0,2019-05-01,4,0,4
"Hood River, OR",26220.0,2019-06-01,-17,0,-17
"Hood River, OR",26220.0,2019-07-01,-4,0,-4
"Hood River, OR",26220.0,2019-08-01,-21,0,-21
"Hood River, OR",26220.0,2019-09-01,-7,0,-7
"Hood River, OR",26220.0,2019-10-01,2,0,2
"Hood River, OR",26220.0,2019-11-01,-7,0,-7
"Hood River, OR",26220.0,2019-12-01,13,0,13
"Hood River, OR",26220.0,2020-01-01,31,0,31
"Hood River, OR",26220.0,2020-02-01,11,0,11
"Hood River, OR",26220.0,2020-03-01,-15,0,-15
"Hood River, OR",26220.0,2020-04-01,3,0,3
"Hood River, OR",26220.0,2020-05-01,27,0,27
"Hood River, OR",26220.0,2020-06-01,5,0,5
"Hood River, OR",26220.0,2020-07-01,-4,12,-16
"Hood River, OR",26220.0,2020-08-01,25,0,25
"Hood River, OR",26220.0,2020-09-01,16,0,16
"Hood River, OR",26220.0,2020-10-01,29,0,29
"Hood River, OR",26220.0,2020-11-01,2,0,2
"Hood River, OR",26220.0,2020-12-01,7,0,7
"Madisonville, KY",31580.0,2019-01-01,9,0,9
"Madisonville, KY",31580.0,2019-02-01,-24,0,-24
"Madisonville, KY",31580.0,2019-03-01,11,0,11
"Madisonville, KY",31580.0,2019-04-01,43,0,43
"Madisonville, KY",31580.0,2019-05-01,-14,0,-14
"Madisonville, KY",31580.0,2019-06-01,-8,0,-8
"Madisonville, KY",31580.0,2019-07-01,1,0,1
"Madisonville, KY",31580.0,2019-08-01,18,0,18
"Madisonville, KY",31580.0,2019-09-01,14,0,14
"Madisonville, KY",31580.0,2019-10-01,22,0,22
"Madisonville, KY",31580.0,2019-11-01,16,0,16
"Madisonville, KY",31580.0,2019-12-01,-1,0,-1
"Madisonville, KY",31580.0,2020-01-01,-4,0,-4
"Madisonville, KY",31580.0,2020-02-01,15,0,15
"Madisonville, KY",31580.0,2020-03-01,13,0,13
"Madisonville, KY",31580.0,2020-04-01,13,0,13
"Madisonville, KY",31580.0,2020-05-01,-3,0,-3
"Madisonville, KY",31580.0,2020-06-01,18,0,18
"Madisonville, KY",31580.0,2020-07-01,-28,0,-28
"Madisonville, KY",31580.0,2020-08-01,19,0,19
"Madisonville, KY",31580.0,2020-09-01,1,0,1
"Madisonville, KY",31580.0,2020-10-01,8,0,8
"Madisonville, KY",31580.0,2020-11-01,3,0,3
"Madisonville, KY",31580.0,2020-12-01,3,0,3
"Sulphur Springs, TX",44860.0,2019-01-01,28,0,28
"Sulphur Springs, TX",44860.0,2019-02-01,24,0,24
"Sulphur Springs, TX",44860.0,2019-03-01,14,0,14
"Sulphur Springs, TX",44860.0,2019-04-01,-9,0,-9
"Sulphur Springs, TX",44860.0,2019-05-01,0,0,0
"Sulphur Springs, TX",44860.0,2019-06-01,-6,0,-6
"Sulphur Springs, TX",44860.0,2019-07-01,23,0,23
"Sulphur Springs, TX",44860.0,2019-08-01,31,0,31
"Sulphur Springs, TX",44860.0,2019-09-01,-9,0,-9
"Sulphur Springs, TX",44860.0,2019-10-01,-14,0,-14
"Sulphur Springs, TX",44860.0,2019-11-01,13,0,13
"Sulphur Springs, TX",44860.0,2019-12-01,18,0,18
"Sulphur Springs, TX",44860.0,2020-01-01,33,0,33
"Sulphur Springs, TX",44860.0,2020-02-01,14,0,14
"Sulphur Springs, TX",44860.0,2020-03-01,-7,0,-7
"Sulphur Springs, TX",44860.0,2020-04-01,5,0,5
"Sulphur Springs, TX",44860.0,2020-05-01,8,0,8
"Sulphur Springs, TX",44860.0,2020-06-01,-15,0,-15
"Sulphur Springs, TX",44860.0,2020-07-01,-8,0,-8
"Sulphur Springs, TX",44860.0,2020-08-01,-18,0,-18
"Sulphur Springs, TX",44860.0,2020-09-01,21,0,21
"Sulphur Springs, TX",44860.0,2020-10-01,10,0,10
"Sulphur Springs, TX",44860.0,2020-11-01,1,0,1
"Sulphur Springs, TX",44860.0,2020-12-01,-14,0,-14
"Malvern, AR",31680.0,2019-01-01,-24,0,-24
"Malvern, AR",31680.0,2019-02-01,10,0,10
"Malvern, AR",31680.0,2019-03-01,-15,0,-15
"Malvern, AR",31680.0,2019-04-01,20,0,20
"Malvern, AR",31680.0,2019-05-01,28,0,28
"Malvern, AR",31680.0,2019-06-01,21,0,21
"Malvern, AR",31680.0,2019-07-01,-8,0,-8
"Malvern, AR",31680.0,2019-08-01,-10,0,-10
"Malvern, AR",31680.0,2019-09-01,11,0,11
"Malvern, AR",31680.0,2019-10-01,14,0,14
"Malvern, AR",31680.0,2019-11-01,27,0,27
"Malvern, AR",31680.0,2019-12-01,19,0,19
"Malvern, AR",31680.0,2020-01-01,27,0,27
"Malvern, AR",31680.0,2020-02-01,17,0,17
"Malvern, AR",31680.0,2020-03-01,-2,0,-2
"Malvern, AR",31680.0,2020-04-01,16,0,16
"Malvern, AR",31680.0,2020-05-01,-24,0,-24
"Malvern, AR",31680.0,2020-06-01,14,0,14
"Malvern, AR",31680.0,2020-07-01,-18,0,-18
"Malvern, AR",31680.0,2020-08-01,-21,0,-21
"Malvern, AR",31680.0,2020-09-01,-5,0,-5
"Malvern, AR",31680.0,2020-10-01,20,0,20
"Malvern, AR",31680.0,2020-11-01,-26,0,-26
"Malvern, AR",31680.0,2020-12-01,31,0,31
"Houghton, MI",26340.0,2019-01-01,-11,-11,0
"Houghton, MI",26340.0,2019-02-01,0,0,0
"Houghton, MI",26340.0,2019-03-01,0,0,0
"Houghton, MI",26340.0,2019-04-01,0,0,0
"Houghton, MI",26340.0,2019-05-01,17,31,-14
"Houghton, MI",26340.0,2019-06-01,-11,0,-11
"Houghton, MI",26340.0,2019-07-01,2,0,2
"Houghton, MI",26340.0,2019-08-01,13,0,13
"Houghton, MI",26340.0,2019-09-01,0,0,0
"Houghton, MI",26340.0,2019-10-01,-47,-47,0
"Houghton, MI",26340.0,2019-11-01,-26,-13,-13
"Houghton, MI",26340.0,2019-12-01,0,0,0
"Houghton, MI",26340.0,2020-01-01,0,0,0
"Houghton, MI",26340.0,2020-02-01,0,0,0
"Houghton, MI",26340.0,2020-03-01,0,0,0
"Houghton, MI",26340.0,2020-04-01,0,0,0
"Houghton, MI",26340.0,2020-05-01,-10,13,-23
"Houghton, MI",26340.0,2020-06-01,1,12,-11
"Houghton, MI",26340.0,2020-07-01,16,0,16
"Houghton, MI",26340.0,2020-08-01,-11,0,-11
"Houghton, MI",26340.0,2020-09-01,11,0,11
"Houghton, MI",26340.0,2020-10-01,-43,-32,-11
"Houghton, MI",26340.0,2020-11-01,-11,0,-11
"Houghton, MI",26340.0,2020-12-01,0,0,0
"Warner Robins, GA",47580.0,2019-01-01,17,0,17
"Warner Robins, GA",47580.0,2019-02-01,3,0,3
"Warner Robins, GA",47580.0,2019-03-01,13,0,13
"Warner Robins, GA",47580.0,2019-04-01,20,0,20
"Warner Robins, GA",47580.0,2019-05-01,-12,0,-12
"Warner Robins, GA",47580.0,2019-06-01,72,0,72
"Warner Robins, GA",47580.0,2019-07-01,76,0,76
"Warner Robins, GA",47580.0,2019-08-01,60,0,60
"Warner Robins, GA",47580.0,2019-09-01,46,0,46
"Warner Robins, GA",47580.0,2019-10-01,-23,0,-23
"Warner Robins, GA",47580.0,2019-11-01,52,0,52
"Warner Robins, GA",47580.0,2019-12-01,-14,0,-14
"Warner Robins, GA",47580.0,2020-01-01,24,0,24
"Warner Robins, GA",47580.0,2020-02-01,0,0,0
"Warner Robins, GA",47580.0,2020-03-01,9,0,9
"Warner Robins, GA",47580.0,2020-04-01,34,0,34
"Warner Robins, GA",47580.0,2020-05-01,10,0,10
"Warner Robins, GA",47580.0,2020-06-01,87,0,87
"Warner Robins, GA",47580.0,2020-07-01,71,0,71
"Warner Robins, GA",47580.0,2020-08-01,73,0,73
"Warner Robins, GA",47580.0,2020-09-01,48,0,48
"Warner Robins, GA",47580.0,2020-10-01,41,0,41
"Warner Robins, GA",47580.0,2020-11-01,28,0,28
"Warner Robins, GA",47580.0,2020-12-01,6,0,6
"La Crosse-Onalaska, WI-MN",29100.0,2019-01-01,-47,-31,-16
"La Crosse-Onalaska, WI-MN",29100.0,2019-02-01,-19,0,-19
"La Crosse-Onalaska, WI-MN",29100.0,2019-03-01,-9,0,-9
"La Crosse-Onalaska, WI-MN",29100.0,2019-04-01,14,23,-9
"La Crosse-Onalaska, WI-MN",29100.0,2019-05-01,-131,34,-165
"La Crosse-Onalaska, WI-MN",29100.0,2019-06-01,-78,0,-78
"La Crosse-Onalaska, WI-MN",29100.0,2019-07-01,-22,0,-22
"La Crosse-Onalaska, WI-MN",29100.0,2019-08-01,-19,0,-19
"La Crosse-Onalaska, WI-MN",29100.0,2019-09-01,27,0,27
"La Crosse-Onalaska, WI-MN",29100.0,2019-10-01,-61,-59,-2
"La Crosse-Onalaska, WI-MN",29100.0,2019-11-01,-33,-42,9
"La Crosse-Onalaska, WI-MN",29100.0,2019-12-01,-51,-100,49
"La Crosse-Onalaska, WI-MN",29100.0,2020-01-01,-60,-62,2
"La Crosse-Onalaska, WI-MN",29100.0,2020-02-01,-3,0,-3
"La Crosse-Onalaska, WI-MN",29100.0,2020-03-01,11,0,11
"La Crosse-Onalaska, WI-MN",29100.0,2020-04-01,-38,0,-38
"La Crosse-Onalaska, WI-MN",29100.0,2020-05-01,-23,37,-60
"La Crosse-Onalaska, WI-MN",29100.0,2020-06-01,-30,0,-30
"La Crosse-Onalaska, WI-MN",29100.0,2020-07-01,-11,0,-11
"La Crosse-Onalaska, WI-MN",29100.0,2020-08-01,-42,0,-42
"La Crosse-Onalaska, WI-MN",29100.0,2020-09-01,-45,0,-45
"La Crosse-Onalaska, WI-MN",29100.0,2020-10-01,-103,-70,-33
"La Crosse-Onalaska, WI-MN",29100.0,2020-11-01,-45,-44,-1
"La Crosse-Onalaska, WI-MN",29100.0,2020-12-01,-56,-45,-11
"Kokomo, IN",29020.0,2019-01-01,-18,-35,17
"Kokomo, IN",29020.0,2019-02-01,-16,0,-16
"Kokomo, IN",29020.0,2019-03-01,36,0,36
"Kokomo, IN",29020.0,2019-04-01,159,82,77
"Kokomo, IN",29020.0,2019-05-01,15,17,-2
"Kokomo, IN",29020.0,2019-06-01,15,0,15
"Kokomo, IN",29020.0,2019-07-01,23,0,23
"Kokomo, IN",29020.0,2019-08-01,13,0,13
"Kokomo, IN",29020.0,2019-09-01,-19,0,-19
"Kokomo, IN",29020.0,2019-10-01,-19,-45,26
"Kokomo, IN",29020.0,2019-11-01,6,-28,34
"Kokomo, IN",29020.0,2019-12-01,-138,-110,-28
"Kokomo, IN",29020.0,2020-01-01,25,-12,37
"Kokomo, IN",29020.0,2020-02-01,-11,0,-11
"Kokomo, IN",29020.0,2020-03-01,-3,0,-3
"Kokomo, IN",29020.0,2020-04-01,43,11,32
"Kokomo, IN",29020.0,2020-05-01,28,19,9
"Kokomo, IN",29020.0,2020-06-01,0,0,0
"Kokomo, IN",29020.0,2020-07-01,-24,0,-24
"Kokomo, IN",29020.0,2020-08-01,-13,0,-13
"Kokomo, IN",29020.0,2020-09-01,39,0,39
"Kokomo, IN",29020.0,2020-10-01,8,-22,30
"Kokomo, IN",29020.0,2020-11-01,-35,-41,6
"Kokomo, IN",29020.0,2020-12-01,-83,-70,-13
"Big Spring, TX",13700.0,2019-01-01,0,0,0
"Big Spring, TX",13700.0,2019-02-01,0,0,0
"Big Spring, TX",13700.0,2019-03-01,12,0,12
"Big Spring, TX",13700.0,2019-04-01,0,0,0
"Big Spring, TX",13700.0,2019-05-01,-5,0,-5
"Big Spring, TX",13700.0,2019-06-01,0,0,0
"Big Spring, TX",13700.0,2019-07-01,-15,0,-15
"Big Spring, TX",13700.0,2019-08-01,0,0,0
"Big Spring, TX",13700.0,2019-09-01,-12,0,-12
"Big Spring, TX",13700.0,2019-10-01,0,0,0
"Big Spring, TX",13700.0,2019-11-01,-11,0,-11
"Big Spring, TX",13700.0,2019-12-01,0,0,0
"Big Spring, TX",13700.0,2020-01-01,13,0,13
"Big Spring, TX",13700.0,2020-02-01,0,0,0
"Big Spring, TX",13700.0,2020-03-01,-7,0,-7
"Big Spring, TX",13700.0,2020-04-01,1,0,1
"Big Spring, TX",13700.0,2020-05-01,-20,0,-20
"Big Spring, TX",13700.0,2020-06-01,-1,0,-1
"Big Spring, TX",13700.0,2020-07-01,0,0,0
"Big Spring, TX",13700.0,2020-08-01,0,0,0
"Big Spring, TX",13700.0,2020-09-01,0,0,0
"Big Spring, TX",13700.0,2020-10-01,-13,0,-13
"Big Spring, TX",13700.0,2020-11-01,-12,0,-12
"Big Spring, TX",13700.0,2020-12-01,0,0,0
"West Plains, MO",48460.0,2019-01-01,6,0,6
"West Plains, MO",48460.0,2019-02-01,0,0,0
"West Plains, MO",48460.0,2019-03-01,-17,0,-17
"West Plains, MO",48460.0,2019-04-01,-11,0,-11
"West Plains, MO",48460.0,2019-05-01,-11,0,-11
"West Plains, MO",48460.0,2019-06-01,36,0,36
"West Plains, MO",48460.0,2019-07-01,9,0,9
"West Plains, MO",48460.0,2019-08-01,24,0,24
"West Plains, MO",48460.0,2019-09-01,16,0,16
"West Plains, MO",48460.0,2019-10-01,-10,0,-10
"West Plains, MO",48460.0,2019-11-01,0,0,0
"West Plains, MO",48460.0,2019-12-01,-25,0,-25
"West Plains, MO",48460.0,2020-01-01,-26,0,-26
"West Plains, MO",48460.0,2020-02-01,13,0,13
"West Plains, MO",48460.0,2020-03-01,-12,0,-12
"West Plains, MO",48460.0,2020-04-01,-2,0,-2
"West Plains, MO",48460.0,2020-05-01,11,0,11
"West Plains, MO",48460.0,2020-06-01,-1,0,-1
"West Plains, MO",48460.0,2020-07-01,-16,0,-16
"West Plains, MO",48460.0,2020-08-01,-26,0,-26
"West Plains, MO",48460.0,2020-09-01,-24,0,-24
"West Plains, MO",48460.0,2020-10-01,19,0,19
"West Plains, MO",48460.0,2020-11-01,-11,0,-11
"West Plains, MO",48460.0,2020-12-01,-30,0,-30
"Pierre, SD",38180.0,2019-01-01,0,0,0
"Pierre, SD",38180.0,2019-02-01,0,0,0
"Pierre, SD",38180.0,2019-03-01,0,0,0
"Pierre, SD",38180.0,2019-04-01,0,0,0
"Pierre, SD",38180.0,2019-05-01,0,0,0
"Pierre, SD",38180.0,2019-06-01,0,0,0
"Pierre, SD",38180.0,2019-07-01,-11,0,-11
"Pierre, SD",38180.0,2019-08-01,0,0,0
"Pierre, SD",38180.0,2019-09-01,0,0,0
"Pierre, SD",38180.0,2019-10-01,0,0,0
"Pierre, SD",38180.0,2019-11-01,0,0,0
"Pierre, SD",38180.0,2019-12-01,-15,-15,0
"Pierre, SD",38180.0,2020-01-01,0,0,0
"Pierre, SD",38180.0,2020-02-01,0,0,0
"Pierre, SD",38180.0,2020-03-01,0,0,0
"Pierre, SD",38180.0,2020-04-01,0,0,0
"Pierre, SD",38180.0,2020-05-01,0,0,0
"Pierre, SD",38180.0,2020-06-01,0,0,0
"Pierre, SD",38180.0,2020-07-01,0,0,0
"Pierre, SD",38180.0,2020-08-01,0,0,0
"Pierre, SD",38180.0,2020-09-01,0,0,0
"Pierre, SD",38180.0,2020-10-01,0,0,0
"Pierre, SD",38180.0,2020-11-01,-12,-12,0
"Pierre, SD",38180.0,2020-12-01,0,0,0
"Eureka-Arcata, CA",21700.0,2019-01-01,20,0,20
"Eureka-Arcata, CA",21700.0,2019-02-01,-27,0,-27
"Eureka-Arcata, CA",21700.0,2019-03-01,20,0,20
"Eureka-Arcata, CA",21700.0,2019-04-01,5,0,5
"Eureka-Arcata, CA",21700.0,2019-05-01,-53,0,-53
"Eureka-Arcata, CA",21700.0,2019-06-01,-42,0,-42
"Eureka-Arcata, CA",21700.0,2019-07-01,-67,0,-67
"Eureka-Arcata, CA",21700.0,2019-08-01,76,0,76
"Eureka-Arcata, CA",21700.0,2019-09-01,11,0,11
"Eureka-Arcata, CA",21700.0,2019-10-01,32,0,32
"Eureka-Arcata, CA",21700.0,2019-11-01,32,0,32
"Eureka-Arcata, CA",21700.0,2019-12-01,-17,0,-17
"Eureka-Arcata, CA",21700.0,2020-01-01,15,0,15
"Eureka-Arcata, CA",21700.0,2020-02-01,-58,0,-58
"Eureka-Arcata, CA",21700.0,2020-03-01,-46,0,-46
"Eureka-Arcata, CA",21700.0,2020-04-01,23,0,23
"Eureka-Arcata, CA",21700.0,2020-05-01,-41,0,-41
"Eureka-Arcata, CA",21700.0,2020-06-01,-16,0,-16
"Eureka-Arcata, CA",21700.0,2020-07-01,-23,0,-23
"Eureka-Arcata, CA",21700.0,2020-08-01,47,0,47
"Eureka-Arcata, CA",21700.0,2020-09-01,84,0,84
"Eureka-Arcata, CA",21700.0,2020-10-01,14,0,14
"Eureka-Arcata, CA",21700.0,2020-11-01,8,0,8
"Eureka-Arcata, CA",21700.0,2020-12-01,-6,0,-6
"Winnemucca, NV",49080.0,2019-01-01,0,0,0
"Winnemucca, NV",49080.0,2019-02-01,11,0,11
"Winnemucca, NV",49080.0,2019-03-01,0,0,0
"Winnemucca, NV",49080.0,2019-04-01,22,0,22
"Winnemucca, NV",49080.0,2019-05-01,15,0,15
"Winnemucca, NV",49080.0,2019-06-01,-27,0,-27
"Winnemucca, NV",49080.0,2019-07-01,2,0,2
"Winnemucca, NV",49080.0,2019-08-01,18,0,18
"Winnemucca, NV",49080.0,2019-09-01,13,0,13
"Winnemucca, NV",49080.0,2019-10-01,0,0,0
"Winnemucca, NV",49080.0,2019-11-01,0,0,0
"Winnemucca, NV",49080.0,2019-12-01,0,0,0
"Winnemucca, NV",49080.0,2020-01-01,0,0,0
"Winnemucca, NV",49080.0,2020-02-01,0,0,0
"Winnemucca, NV",49080.0,2020-03-01,15,0,15
"Winnemucca, NV",49080.0,2020-04-01,0,0,0
"Winnemucca, NV",49080.0,2020-05-01,0,0,0
"Winnemucca, NV",49080.0,2020-06-01,0,0,0
"Winnemucca, NV",49080.0,2020-07-01,14,0,14
"Winnemucca, NV",49080.0,2020-08-01,12,0,12
"Winnemucca, NV",49080.0,2020-09-01,0,0,0
"Winnemucca, NV",49080.0,2020-10-01,0,0,0
"Winnemucca, NV",49080.0,2020-11-01,0,0,0
"Winnemucca, NV",49080.0,2020-12-01,0,0,0
"Huntingdon, PA",26500.0,2019-01-01,-14,0,-14
"Huntingdon, PA",26500.0,2019-02-01,-2,0,-2
"Huntingdon, PA",26500.0,2019-03-01,-1,0,-1
"Huntingdon, PA",26500.0,2019-04-01,-14,0,-14
"Huntingdon, PA",26500.0,2019-05-01,-4,0,-4
"Huntingdon, PA",26500.0,2019-06-01,-27,0,-27
"Huntingdon, PA",26500.0,2019-07-01,12,0,12
"Huntingdon, PA",26500.0,2019-08-01,-45,0,-45
"Huntingdon, PA",26500.0,2019-09-01,-24,0,-24
"Huntingdon, PA",26500.0,2019-10-01,-25,0,-25
"Huntingdon, PA",26500.0,2019-11-01,16,0,16
"Huntingdon, PA",26500.0,2019-12-01,13,0,13
"Huntingdon, PA",26500.0,2020-01-01,11,0,11
"Huntingdon, PA",26500.0,2020-02-01,0,0,0
"Huntingdon, PA",26500.0,2020-03-01,3,0,3
"Huntingdon, PA",26500.0,2020-04-01,-32,0,-32
"Huntingdon, PA",26500.0,2020-05-01,-11,0,-11
"Huntingdon, PA",26500.0,2020-06-01,17,0,17
"Huntingdon, PA",26500.0,2020-07-01,10,0,10
"Huntingdon, PA",26500.0,2020-08-01,-26,0,-26
"Huntingdon, PA",26500.0,2020-09-01,12,0,12
"Huntingdon, PA",26500.0,2020-10-01,9,0,9
"Huntingdon, PA",26500.0,2020-11-01,0,0,0
"Huntingdon, PA",26500.0,2020-12-01,-18,0,-18
"Huntington, IN",26540.0,2019-01-01,26,0,26
"Huntington, IN",26540.0,2019-02-01,20,0,20
"Huntington, IN",26540.0,2019-03-01,25,0,25
"Huntington, IN",26540.0,2019-04-01,-1,0,-1
"Huntington, IN",26540.0,2019-05-01,-22,0,-22
"Huntington, IN",26540.0,2019-06-01,14,0,14
"Huntington, IN",26540.0,2019-07-01,34,0,34
"Huntington, IN",26540.0,2019-08-01,-16,0,-16
"Huntington, IN",26540.0,2019-09-01,16,0,16
"Huntington, IN",26540.0,2019-10-01,35,0,35
"Huntington, IN",26540.0,2019-11-01,29,0,29
"Huntington, IN",26540.0,2019-12-01,1,0,1
"Huntington, IN",26540.0,2020-01-01,-1,0,-1
"Huntington, IN",26540.0,2020-02-01,6,0,6
"Huntington, IN",26540.0,2020-03-01,5,0,5
"Huntington, IN",26540.0,2020-04-01,9,0,9
"Huntington, IN",26540.0,2020-05-01,-34,0,-34
"Huntington, IN",26540.0,2020-06-01,18,0,18
"Huntington, IN",26540.0,2020-07-01,11,0,11
"Huntington, IN",26540.0,2020-08-01,28,0,28
"Huntington, IN",26540.0,2020-09-01,10,0,10
"Huntington, IN",26540.0,2020-10-01,0,0,0
"Huntington, IN",26540.0,2020-11-01,-7,-12,5
"Huntington, IN",26540.0,2020-12-01,13,0,13
"Norwalk, OH",35940.0,2019-01-01,-14,0,-14
"Norwalk, OH",35940.0,2019-02-01,-11,0,-11
"Norwalk, OH",35940.0,2019-03-01,-21,0,-21
"Norwalk, OH",35940.0,2019-04-01,33,11,22
"Norwalk, OH",35940.0,2019-05-01,5,0,5
"Norwalk, OH",35940.0,2019-06-01,29,0,29
"Norwalk, OH",35940.0,2019-07-01,30,0,30
"Norwalk, OH",35940.0,2019-08-01,8,0,8
"Norwalk, OH",35940.0,2019-09-01,20,0,20
"Norwalk, OH",35940.0,2019-10-01,-37,0,-37
"Norwalk, OH",35940.0,2019-11-01,-14,-22,8
"Norwalk, OH",35940.0,2019-12-01,-34,0,-34
"Norwalk, OH",35940.0,2020-01-01,-41,-11,-30
"Norwalk, OH",35940.0,2020-02-01,-3,0,-3
"Norwalk, OH",35940.0,2020-03-01,14,0,14
"Norwalk, OH",35940.0,2020-04-01,1,0,1
"Norwalk, OH",35940.0,2020-05-01,20,11,9
"Norwalk, OH",35940.0,2020-06-01,35,0,35
"Norwalk, OH",35940.0,2020-07-01,23,0,23
"Norwalk, OH",35940.0,2020-08-01,-4,0,-4
"Norwalk, OH",35940.0,2020-09-01,65,0,65
"Norwalk, OH",35940.0,2020-10-01,16,0,16
"Norwalk, OH",35940.0,2020-11-01,-11,-11,0
"Norwalk, OH",35940.0,2020-12-01,1,-22,23
"Borger, TX",14420.0,2019-01-01,15,0,15
"Borger, TX",14420.0,2019-02-01,0,0,0
"Borger, TX",14420.0,2019-03-01,0,0,0
"Borger, TX",14420.0,2019-04-01,16,0,16
"Borger, TX",14420.0,2019-05-01,-17,0,-17
"Borger, TX",14420.0,2019-06-01,0,0,0
"Borger, TX",14420.0,2019-07-01,-15,0,-15
"Borger, TX",14420.0,2019-08-01,-39,0,-39
"Borger, TX",14420.0,2019-09-01,0,0,0
"Borger, TX",14420.0,2019-10-01,0,0,0
"Borger, TX",14420.0,2019-11-01,-11,0,-11
"Borger, TX",14420.0,2019-12-01,-14,0,-14
"Borger, TX",14420.0,2020-01-01,-30,0,-30
"Borger, TX",14420.0,2020-02-01,13,0,13
"Borger, TX",14420.0,2020-03-01,-13,0,-13
"Borger, TX",14420.0,2020-04-01,11,0,11
"Borger, TX",14420.0,2020-05-01,6,0,6
"Borger, TX",14420.0,2020-06-01,-3,0,-3
"Borger, TX",14420.0,2020-07-01,0,0,0
"Borger, TX",14420.0,2020-08-01,0,0,0
"Borger, TX",14420.0,2020-09-01,1,0,1
"Borger, TX",14420.0,2020-10-01,13,0,13
"Borger, TX",14420.0,2020-11-01,0,0,0
"Borger, TX",14420.0,2020-12-01,0,0,0
"El Centro, CA",20940.0,2019-01-01,45,0,45
"El Centro, CA",20940.0,2019-02-01,9,0,9
"El Centro, CA",20940.0,2019-03-01,-4,0,-4
"El Centro, CA",20940.0,2019-04-01,21,0,21
"El Centro, CA",20940.0,2019-05-01,-22,-22,0
"El Centro, CA",20940.0,2019-06-01,-18,-12,-6
"El Centro, CA",20940.0,2019-07-01,16,0,16
"El Centro, CA",20940.0,2019-08-01,24,0,24
"El Centro, CA",20940.0,2019-09-01,-51,0,-51
"El Centro, CA",20940.0,2019-10-01,-18,0,-18
"El Centro, CA",20940.0,2019-11-01,-6,0,-6
"El Centro, CA",20940.0,2019-12-01,-18,0,-18
"El Centro, CA",20940.0,2020-01-01,51,12,39
"El Centro, CA",20940.0,2020-02-01,6,0,6
"El Centro, CA",20940.0,2020-03-01,-10,-13,3
"El Centro, CA",20940.0,2020-04-01,103,14,89
"El Centro, CA",20940.0,2020-05-01,17,-13,30
"El Centro, CA",20940.0,2020-06-01,-12,0,-12
"El Centro, CA",20940.0,2020-07-01,-7,0,-7
"El Centro, CA",20940.0,2020-08-01,12,0,12
"El Centro, CA",20940.0,2020-09-01,-27,-11,-16
"El Centro, CA",20940.0,2020-10-01,-27,0,-27
"El Centro, CA",20940.0,2020-11-01,48,11,37
"El Centro, CA",20940.0,2020-12-01,10,-16,26
"Batesville, AR",12900.0,2019-01-01,-22,0,-22
"Batesville, AR",12900.0,2019-02-01,11,0,11
"Batesville, AR",12900.0,2019-03-01,27,0,27
"Batesville, AR",12900.0,2019-04-01,22,0,22
"Batesville, AR",12900.0,2019-05-01,-29,0,-29
"Batesville, AR",12900.0,2019-06-01,-9,0,-9
"Batesville, AR",12900.0,2019-07-01,-17,0,-17
"Batesville, AR",12900.0,2019-08-01,-33,0,-33
"Batesville, AR",12900.0,2019-09-01,0,0,0
"Batesville, AR",12900.0,2019-10-01,0,0,0
"Batesville, AR",12900.0,2019-11-01,-11,0,-11
"Batesville, AR",12900.0,2019-12-01,-23,0,-23
"Batesville, AR",12900.0,2020-01-01,0,0,0
"Batesville, AR",12900.0,2020-02-01,0,0,0
"Batesville, AR",12900.0,2020-03-01,6,0,6
"Batesville, AR",12900.0,2020-04-01,-1,0,-1
"Batesville, AR",12900.0,2020-05-01,1,0,1
"Batesville, AR",12900.0,2020-06-01,-12,0,-12
"Batesville, AR",12900.0,2020-07-01,-23,0,-23
"Batesville, AR",12900.0,2020-08-01,14,0,14
"Batesville, AR",12900.0,2020-09-01,23,0,23
"Batesville, AR",12900.0,2020-10-01,0,0,0
"Batesville, AR",12900.0,2020-11-01,0,0,0
"Batesville, AR",12900.0,2020-12-01,14,0,14
"Sebastian-Vero Beach, FL",42680.0,2019-01-01,999,963,36
"Sebastian-Vero Beach, FL",42680.0,2019-02-01,135,86,49
"Sebastian-Vero Beach, FL",42680.0,2019-03-01,25,-20,45
"Sebastian-Vero Beach, FL",42680.0,2019-04-01,-721,-581,-140
"Sebastian-Vero Beach, FL",42680.0,2019-05-01,-1823,-1917,94
"Sebastian-Vero Beach, FL",42680.0,2019-06-01,-182,-356,174
"Sebastian-Vero Beach, FL",42680.0,2019-07-01,24,-52,76
"Sebastian-Vero Beach, FL",42680.0,2019-08-01,91,-11,102
"Sebastian-Vero Beach, FL",42680.0,2019-09-01,160,28,132
"Sebastian-Vero Beach, FL",42680.0,2019-10-01,1168,975,193
"Sebastian-Vero Beach, FL",42680.0,2019-11-01,436,296,140
"Sebastian-Vero Beach, FL",42680.0,2019-12-01,956,869,87
"Sebastian-Vero Beach, FL",42680.0,2020-01-01,1039,944,95
"Sebastian-Vero Beach, FL",42680.0,2020-02-01,55,47,8
"Sebastian-Vero Beach, FL",42680.0,2020-03-01,93,57,36
"Sebastian-Vero Beach, FL",42680.0,2020-04-01,155,91,64
"Sebastian-Vero Beach, FL",42680.0,2020-05-01,-720,-744,24
"Sebastian-Vero Beach, FL",42680.0,2020-06-01,-1048,-1086,38
"Sebastian-Vero Beach, FL",42680.0,2020-07-01,-72,-197,125
"Sebastian-Vero Beach, FL",42680.0,2020-08-01,120,-12,132
"Sebastian-Vero Beach, FL",42680.0,2020-09-01,223,18,205
"Sebastian-Vero Beach, FL",42680.0,2020-10-01,1224,913,311
"Sebastian-Vero Beach, FL",42680.0,2020-11-01,598,454,144
"Sebastian-Vero Beach, FL",42680.0,2020-12-01,1175,910,265
"Indiana, PA",26860.0,2019-01-01,-12,0,-12
"Indiana, PA",26860.0,2019-02-01,-12,0,-12
"Indiana, PA",26860.0,2019-03-01,17,0,17
"Indiana, PA",26860.0,2019-04-01,10,0,10
"Indiana, PA",26860.0,2019-05-01,-3,0,-3
"Indiana, PA",26860.0,2019-06-01,0,0,0
"Indiana, PA",26860.0,2019-07-01,-35,0,-35
"Indiana, PA",26860.0,2019-08-01,-5,0,-5
"Indiana, PA",26860.0,2019-09-01,24,0,24
"Indiana, PA",26860.0,2019-10-01,-14,0,-14
"Indiana, PA",26860.0,2019-11-01,10,0,10
"Indiana, PA",26860.0,2019-12-01,-14,-13,-1
"Indiana, PA",26860.0,2020-01-01,20,0,20
"Indiana, PA",26860.0,2020-02-01,-4,0,-4
"Indiana, PA",26860.0,2020-03-01,-21,0,-21
"Indiana, PA",26860.0,2020-04-01,-26,0,-26
"Indiana, PA",26860.0,2020-05-01,27,0,27
"Indiana, PA",26860.0,2020-06-01,19,0,19
"Indiana, PA",26860.0,2020-07-01,46,0,46
"Indiana, PA",26860.0,2020-08-01,33,0,33
"Indiana, PA",26860.0,2020-09-01,50,0,50
"Indiana, PA",26860.0,2020-10-01,37,0,37
"Indiana, PA",26860.0,2020-11-01,2,0,2
"Indiana, PA",26860.0,2020-12-01,0,-23,23
"Grand Rapids-Kentwood, MI",24340.0,2019-01-01,-1212,-1095,-117
"Grand Rapids-Kentwood, MI",24340.0,2019-02-01,-283,-123,-160
"Grand Rapids-Kentwood, MI",24340.0,2019-03-01,141,41,100
"Grand Rapids-Kentwood, MI",24340.0,2019-04-01,1654,1083,571
"Grand Rapids-Kentwood, MI",24340.0,2019-05-01,806,785,21
"Grand Rapids-Kentwood, MI",24340.0,2019-06-01,47,17,30
"Grand Rapids-Kentwood, MI",24340.0,2019-07-01,-168,0,-168
"Grand Rapids-Kentwood, MI",24340.0,2019-08-01,14,0,14
"Grand Rapids-Kentwood, MI",24340.0,2019-09-01,-201,-40,-161
"Grand Rapids-Kentwood, MI",24340.0,2019-10-01,-1393,-1279,-114
"Grand Rapids-Kentwood, MI",24340.0,2019-11-01,-1439,-1218,-221
"Grand Rapids-Kentwood, MI",24340.0,2019-12-01,-1974,-2010,36
"Grand Rapids-Kentwood, MI",24340.0,2020-01-01,-1270,-1116,-154
"Grand Rapids-Kentwood, MI",24340.0,2020-02-01,-209,-99,-110
"Grand Rapids-Kentwood, MI",24340.0,2020-03-01,580,152,428
"Grand Rapids-Kentwood, MI",24340.0,2020-04-01,693,380,313
"Grand Rapids-Kentwood, MI",24340.0,2020-05-01,773,699,74
"Grand Rapids-Kentwood, MI",24340.0,2020-06-01,252,285,-33
"Grand Rapids-Kentwood, MI",24340.0,2020-07-01,-181,-2,-179
"Grand Rapids-Kentwood, MI",24340.0,2020-08-01,-72,29,-101
"Grand Rapids-Kentwood, MI",24340.0,2020-09-01,-182,-27,-155
"Grand Rapids-Kentwood, MI",24340.0,2020-10-01,-1316,-1161,-155
"Grand Rapids-Kentwood, MI",24340.0,2020-11-01,-1171,-1113,-58
"Grand Rapids-Kentwood, MI",24340.0,2020-12-01,-1681,-1510,-171
"Cedar City, UT",16260.0,2019-01-01,-27,0,-27
"Cedar City, UT",16260.0,2019-02-01,2,0,2
"Cedar City, UT",16260.0,2019-03-01,27,0,27
"Cedar City, UT",16260.0,2019-04-01,18,0,18
"Cedar City, UT",16260.0,2019-05-01,-3,0,-3
"Cedar City, UT",16260.0,2019-06-01,23,28,-5
"Cedar City, UT",16260.0,2019-07-01,-5,0,-5
"Cedar City, UT",16260.0,2019-08-01,14,0,14
"Cedar City, UT",16260.0,2019-09-01,5,0,5
"Cedar City, UT",16260.0,2019-10-01,53,0,53
"Cedar City, UT",16260.0,2019-11-01,-20,0,-20
"Cedar City, UT",16260.0,2019-12-01,-28,0,-28
"Cedar City, UT",16260.0,2020-01-01,-7,0,-7
"Cedar City, UT",16260.0,2020-02-01,-12,0,-12
"Cedar City, UT",16260.0,2020-03-01,15,0,15
"Cedar City, UT",16260.0,2020-04-01,-4,15,-19
"Cedar City, UT",16260.0,2020-05-01,-19,17,-36
"Cedar City, UT",16260.0,2020-06-01,54,12,42
"Cedar City, UT",16260.0,2020-07-01,55,0,55
"Cedar City, UT",16260.0,2020-08-01,86,0,86
"Cedar City, UT",16260.0,2020-09-01,89,0,89
"Cedar City, UT",16260.0,2020-10-01,58,0,58
"Cedar City, UT",16260.0,2020-11-01,32,-14,46
"Cedar City, UT",16260.0,2020-12-01,14,0,14
"Mount Pleasant, MI",34380.0,2019-01-01,17,0,17
"Mount Pleasant, MI",34380.0,2019-02-01,4,0,4
"Mount Pleasant, MI",34380.0,2019-03-01,-37,0,-37
"Mount Pleasant, MI",34380.0,2019-04-01,67,11,56
"Mount Pleasant, MI",34380.0,2019-05-01,-96,0,-96
"Mount Pleasant, MI",34380.0,2019-06-01,-108,0,-108
"Mount Pleasant, MI",34380.0,2019-07-01,-58,0,-58
"Mount Pleasant, MI",34380.0,2019-08-01,-11,0,-11
"Mount Pleasant, MI",34380.0,2019-09-01,52,0,52
"Mount Pleasant, MI",34380.0,2019-10-01,-8,-34,26
"Mount Pleasant, MI",34380.0,2019-11-01,15,-12,27
"Mount Pleasant, MI",34380.0,2019-12-01,-23,-11,-12
"Mount Pleasant, MI",34380.0,2020-01-01,-14,-12,-2
"Mount Pleasant, MI",34380.0,2020-02-01,9,0,9
"Mount Pleasant, MI",34380.0,2020-03-01,-37,0,-37
"Mount Pleasant, MI",34380.0,2020-04-01,-38,0,-38
"Mount Pleasant, MI",34380.0,2020-05-01,-100,0,-100
"Mount Pleasant, MI",34380.0,2020-06-01,-92,0,-92
"Mount Pleasant, MI",34380.0,2020-07-01,-41,0,-41
"Mount Pleasant, MI",34380.0,2020-08-01,46,0,46
"Mount Pleasant, MI",34380.0,2020-09-01,47,0,47
"Mount Pleasant, MI",34380.0,2020-10-01,-34,-12,-22
"Mount Pleasant, MI",34380.0,2020-11-01,3,0,3
"Mount Pleasant, MI",34380.0,2020-12-01,-13,0,-13
"Oak Harbor, WA",36020.0,2019-01-01,-46,-69,23
"Oak Harbor, WA",36020.0,2019-02-01,6,-11,17
"Oak Harbor, WA",36020.0,2019-03-01,14,-12,26
"Oak Harbor, WA",36020.0,2019-04-01,156,94,62
"Oak Harbor, WA",36020.0,2019-05-01,174,110,64
"Oak Harbor, WA",36020.0,2019-06-01,144,58,86
"Oak Harbor, WA",36020.0,2019-07-01,45,0,45
"Oak Harbor, WA",36020.0,2019-08-01,102,0,102
"Oak Harbor, WA",36020.0,2019-09-01,70,-29,99
"Oak Harbor, WA",36020.0,2019-10-01,-180,-209,29
"Oak Harbor, WA",36020.0,2019-11-01,-72,-92,20
"Oak Harbor, WA",36020.0,2019-12-01,-17,-59,42
"Oak Harbor, WA",36020.0,2020-01-01,-44,-46,2
"Oak Harbor, WA",36020.0,2020-02-01,28,-16,44
"Oak Harbor, WA",36020.0,2020-03-01,176,43,133
"Oak Harbor, WA",36020.0,2020-04-01,183,38,145
"Oak Harbor, WA",36020.0,2020-05-01,241,135,106
"Oak Harbor, WA",36020.0,2020-06-01,240,88,152
"Oak Harbor, WA",36020.0,2020-07-01,138,43,95
"Oak Harbor, WA",36020.0,2020-08-01,172,23,149
"Oak Harbor, WA",36020.0,2020-09-01,173,-18,191
"Oak Harbor, WA",36020.0,2020-10-01,-158,-229,71
"Oak Harbor, WA",36020.0,2020-11-01,-51,-78,27
"Oak Harbor, WA",36020.0,2020-12-01,24,-32,56
"Grand Rapids, MN",24330.0,2019-01-01,-38,-31,-7
"Grand Rapids, MN",24330.0,2019-02-01,5,0,5
"Grand Rapids, MN",24330.0,2019-03-01,3,0,3
"Grand Rapids, MN",24330.0,2019-04-01,62,31,31
"Grand Rapids, MN",24330.0,2019-05-01,49,62,-13
"Grand Rapids, MN",24330.0,2019-06-01,2,0,2
"Grand Rapids, MN",24330.0,2019-07-01,1,0,1
"Grand Rapids, MN",24330.0,2019-08-01,30,0,30
"Grand Rapids, MN",24330.0,2019-09-01,-10,0,-10
"Grand Rapids, MN",24330.0,2019-10-01,-101,-89,-12
"Grand Rapids, MN",24330.0,2019-11-01,-31,-38,7
"Grand Rapids, MN",24330.0,2019-12-01,-47,-50,3
"Grand Rapids, MN",24330.0,2020-01-01,7,0,7
"Grand Rapids, MN",24330.0,2020-02-01,-4,0,-4
"Grand Rapids, MN",24330.0,2020-03-01,18,0,18
"Grand Rapids, MN",24330.0,2020-04-01,55,25,30
"Grand Rapids, MN",24330.0,2020-05-01,85,49,36
"Grand Rapids, MN",24330.0,2020-06-01,32,0,32
"Grand Rapids, MN",24330.0,2020-07-01,17,0,17
"Grand Rapids, MN",24330.0,2020-08-01,26,0,26
"Grand Rapids, MN",24330.0,2020-09-01,13,0,13
"Grand Rapids, MN",24330.0,2020-10-01,-60,-59,-1
"Grand Rapids, MN",24330.0,2020-11-01,-48,-54,6
"Grand Rapids, MN",24330.0,2020-12-01,-23,-30,7
"Tupelo, MS",46180.0,2019-01-01,11,0,11
"Tupelo, MS",46180.0,2019-02-01,-12,0,-12
"Tupelo, MS",46180.0,2019-03-01,-18,0,-18
"Tupelo, MS",46180.0,2019-04-01,-29,0,-29
"Tupelo, MS",46180.0,2019-05-01,-31,0,-31
"Tupelo, MS",46180.0,2019-06-01,-9,0,-9
"Tupelo, MS",46180.0,2019-07-01,-4,0,-4
"Tupelo, MS",46180.0,2019-08-01,-12,0,-12
"Tupelo, MS",46180.0,2019-09-01,1,0,1
"Tupelo, MS",46180.0,2019-10-01,2,0,2
"Tupelo, MS",46180.0,2019-11-01,-23,0,-23
"Tupelo, MS",46180.0,2019-12-01,44,0,44
"Tupelo, MS",46180.0,2020-01-01,47,0,47
"Tupelo, MS",46180.0,2020-02-01,-23,0,-23
"Tupelo, MS",46180.0,2020-03-01,-17,0,-17
"Tupelo, MS",46180.0,2020-04-01,18,0,18
"Tupelo, MS",46180.0,2020-05-01,-16,0,-16
"Tupelo, MS",46180.0,2020-06-01,26,0,26
"Tupelo, MS",46180.0,2020-07-01,33,0,33
"Tupelo, MS",46180.0,2020-08-01,-2,0,-2
"Tupelo, MS",46180.0,2020-09-01,0,0,0
"Tupelo, MS",46180.0,2020-10-01,-3,0,-3
"Tupelo, MS",46180.0,2020-11-01,-27,0,-27
"Tupelo, MS",46180.0,2020-12-01,34,0,34
"Scottsboro, AL",42460.0,2019-01-01,7,0,7
"Scottsboro, AL",42460.0,2019-02-01,2,0,2
"Scottsboro, AL",42460.0,2019-03-01,36,0,36
"Scottsboro, AL",42460.0,2019-04-01,-14,0,-14
"Scottsboro, AL",42460.0,2019-05-01,-10,0,-10
"Scottsboro, AL",42460.0,2019-06-01,3,0,3
"Scottsboro, AL",42460.0,2019-07-01,42,0,42
"Scottsboro, AL",42460.0,2019-08-01,0,0,0
"Scottsboro, AL",42460.0,2019-09-01,26,0,26
"Scottsboro, AL",42460.0,2019-10-01,-1,0,-1
"Scottsboro, AL",42460.0,2019-11-01,-12,0,-12
"Scottsboro, AL",42460.0,2019-12-01,42,0,42
"Scottsboro, AL",42460.0,2020-01-01,8,0,8
"Scottsboro, AL",42460.0,2020-02-01,0,0,0
"Scottsboro, AL",42460.0,2020-03-01,7,0,7
"Scottsboro, AL",42460.0,2020-04-01,3,0,3
"Scottsboro, AL",42460.0,2020-05-01,26,0,26
"Scottsboro, AL",42460.0,2020-06-01,-10,0,-10
"Scottsboro, AL",42460.0,2020-07-01,15,0,15
"Scottsboro, AL",42460.0,2020-08-01,5,0,5
"Scottsboro, AL",42460.0,2020-09-01,-12,0,-12
"Scottsboro, AL",42460.0,2020-10-01,23,0,23
"Scottsboro, AL",42460.0,2020-11-01,26,0,26
"Scottsboro, AL",42460.0,2020-12-01,33,0,33
"Jefferson, GA",27600.0,2019-01-01,69,0,69
"Jefferson, GA",27600.0,2019-02-01,79,0,79
"Jefferson, GA",27600.0,2019-03-01,131,0,131
"Jefferson, GA",27600.0,2019-04-01,126,0,126
"Jefferson, GA",27600.0,2019-05-01,176,-11,187
"Jefferson, GA",27600.0,2019-06-01,150,0,150
"Jefferson, GA",27600.0,2019-07-01,136,0,136
"Jefferson, GA",27600.0,2019-08-01,188,0,188
"Jefferson, GA",27600.0,2019-09-01,185,0,185
"Jefferson, GA",27600.0,2019-10-01,81,0,81
"Jefferson, GA",27600.0,2019-11-01,85,0,85
"Jefferson, GA",27600.0,2019-12-01,48,0,48
"Jefferson, GA",27600.0,2020-01-01,124,0,124
"Jefferson, GA",27600.0,2020-02-01,125,0,125
"Jefferson, GA",27600.0,2020-03-01,127,0,127
"Jefferson, GA",27600.0,2020-04-01,183,0,183
"Jefferson, GA",27600.0,2020-05-01,36,0,36
"Jefferson, GA",27600.0,2020-06-01,60,0,60
"Jefferson, GA",27600.0,2020-07-01,262,0,262
"Jefferson, GA",27600.0,2020-08-01,145,0,145
"Jefferson, GA",27600.0,2020-09-01,99,0,99
"Jefferson, GA",27600.0,2020-10-01,99,0,99
"Jefferson, GA",27600.0,2020-11-01,-97,0,-97
"Jefferson, GA",27600.0,2020-12-01,139,0,139
"Carbondale-Marion, IL",16060.0,2019-01-01,-30,0,-30
"Carbondale-Marion, IL",16060.0,2019-02-01,0,0,0
"Carbondale-Marion, IL",16060.0,2019-03-01,0,0,0
"Carbondale-Marion, IL",16060.0,2019-04-01,-32,0,-32
"Carbondale-Marion, IL",16060.0,2019-05-01,25,0,25
"Carbondale-Marion, IL",16060.0,2019-06-01,-30,0,-30
"Carbondale-Marion, IL",16060.0,2019-07-01,-68,0,-68
"Carbondale-Marion, IL",16060.0,2019-08-01,48,0,48
"Carbondale-Marion, IL",16060.0,2019-09-01,5,0,5
"Carbondale-Marion, IL",16060.0,2019-10-01,88,0,88
"Carbondale-Marion, IL",16060.0,2019-11-01,-19,0,-19
"Carbondale-Marion, IL",16060.0,2019-12-01,-14,0,-14
"Carbondale-Marion, IL",16060.0,2020-01-01,-12,0,-12
"Carbondale-Marion, IL",16060.0,2020-02-01,0,0,0
"Carbondale-Marion, IL",16060.0,2020-03-01,-25,0,-25
"Carbondale-Marion, IL",16060.0,2020-04-01,-13,0,-13
"Carbondale-Marion, IL",16060.0,2020-05-01,34,0,34
"Carbondale-Marion, IL",16060.0,2020-06-01,38,0,38
"Carbondale-Marion, IL",16060.0,2020-07-01,-19,0,-19
"Carbondale-Marion, IL",16060.0,2020-08-01,38,0,38
"Carbondale-Marion, IL",16060.0,2020-09-01,10,0,10
"Carbondale-Marion, IL",16060.0,2020-10-01,24,0,24
"Carbondale-Marion, IL",16060.0,2020-11-01,-38,0,-38
"Carbondale-Marion, IL",16060.0,2020-12-01,-23,0,-23
"Seymour, IN",42980.0,2019-01-01,13,0,13
"Seymour, IN",42980.0,2019-02-01,28,0,28
"Seymour, IN",42980.0,2019-03-01,3,0,3
"Seymour, IN",42980.0,2019-04-01,39,0,39
"Seymour, IN",42980.0,2019-05-01,-3,0,-3
"Seymour, IN",42980.0,2019-06-01,18,0,18
"Seymour, IN",42980.0,2019-07-01,1,0,1
"Seymour, IN",42980.0,2019-08-01,-4,0,-4
"Seymour, IN",42980.0,2019-09-01,11,0,11
"Seymour, IN",42980.0,2019-10-01,-9,0,-9
"Seymour, IN",42980.0,2019-11-01,13,0,13
"Seymour, IN",42980.0,2019-12-01,-10,0,-10
"Seymour, IN",42980.0,2020-01-01,-29,0,-29
"Seymour, IN",42980.0,2020-02-01,12,0,12
"Seymour, IN",42980.0,2020-03-01,-70,0,-70
"Seymour, IN",42980.0,2020-04-01,-10,0,-10
"Seymour, IN",42980.0,2020-05-01,-46,0,-46
"Seymour, IN",42980.0,2020-06-01,-21,0,-21
"Seymour, IN",42980.0,2020-07-01,-28,0,-28
"Seymour, IN",42980.0,2020-08-01,-11,0,-11
"Seymour, IN",42980.0,2020-09-01,-9,0,-9
"Seymour, IN",42980.0,2020-10-01,8,0,8
"Seymour, IN",42980.0,2020-11-01,-22,0,-22
"Seymour, IN",42980.0,2020-12-01,7,0,7
"Topeka, KS",45820.0,2019-01-01,13,0,13
"Topeka, KS",45820.0,2019-02-01,0,0,0
"Topeka, KS",45820.0,2019-03-01,-2,0,-2
"Topeka, KS",45820.0,2019-04-01,-8,0,-8
"Topeka, KS",45820.0,2019-05-01,20,0,20
"Topeka, KS",45820.0,2019-06-01,-31,0,-31
"Topeka, KS",45820.0,2019-07-01,63,0,63
"Topeka, KS",45820.0,2019-08-01,-57,0,-57
"Topeka, KS",45820.0,2019-09-01,-30,0,-30
"Topeka, KS",45820.0,2019-10-01,4,-11,15
"Topeka, KS",45820.0,2019-11-01,-59,-27,-32
"Topeka, KS",45820.0,2019-12-01,-67,-44,-23
"Topeka, KS",45820.0,2020-01-01,-30,0,-30
"Topeka, KS",45820.0,2020-02-01,-31,0,-31
"Topeka, KS",45820.0,2020-03-01,-26,-13,-13
"Topeka, KS",45820.0,2020-04-01,-27,0,-27
"Topeka, KS",45820.0,2020-05-01,51,0,51
"Topeka, KS",45820.0,2020-06-01,-1,0,-1
"Topeka, KS",45820.0,2020-07-01,45,0,45
"Topeka, KS",45820.0,2020-08-01,-58,0,-58
"Topeka, KS",45820.0,2020-09-01,-3,0,-3
"Topeka, KS",45820.0,2020-10-01,-22,-11,-11
"Topeka, KS",45820.0,2020-11-01,19,-11,30
"Topeka, KS",45820.0,2020-12-01,-70,0,-70
"Jackson, MI",27100.0,2019-01-01,-79,-98,19
"Jackson, MI",27100.0,2019-02-01,-30,0,-30
"Jackson, MI",27100.0,2019-03-01,33,0,33
"Jackson, MI",27100.0,2019-04-01,334,170,164
"Jackson, MI",27100.0,2019-05-01,92,64,28
"Jackson, MI",27100.0,2019-06-01,61,0,61
"Jackson, MI",27100.0,2019-07-01,34,0,34
"Jackson, MI",27100.0,2019-08-01,76,0,76
"Jackson, MI",27100.0,2019-09-01,-44,-13,-31
"Jackson, MI",27100.0,2019-10-01,-226,-202,-24
"Jackson, MI",27100.0,2019-11-01,-198,-197,-1
"Jackson, MI",27100.0,2019-12-01,-205,-190,-15
"Jackson, MI",27100.0,2020-01-01,-153,-117,-36
"Jackson, MI",27100.0,2020-02-01,23,0,23
"Jackson, MI",27100.0,2020-03-01,110,0,110
"Jackson, MI",27100.0,2020-04-01,34,25,9
"Jackson, MI",27100.0,2020-05-01,63,51,12
"Jackson, MI",27100.0,2020-06-01,54,25,29
"Jackson, MI",27100.0,2020-07-01,61,0,61
"Jackson, MI",27100.0,2020-08-01,47,0,47
"Jackson, MI",27100.0,2020-09-01,39,-12,51
"Jackson, MI",27100.0,2020-10-01,-105,-169,64
"Jackson, MI",27100.0,2020-11-01,-153,-187,34
"Jackson, MI",27100.0,2020-12-01,-49,-128,79
"Cullowhee, NC",19000.0,2019-01-01,-13,0,-13
"Cullowhee, NC",19000.0,2019-02-01,-4,0,-4
"Cullowhee, NC",19000.0,2019-03-01,-19,0,-19
"Cullowhee, NC",19000.0,2019-04-01,20,11,9
"Cullowhee, NC",19000.0,2019-05-01,180,222,-42
"Cullowhee, NC",19000.0,2019-06-01,26,60,-34
"Cullowhee, NC",19000.0,2019-07-01,-27,0,-27
"Cullowhee, NC",19000.0,2019-08-01,-25,0,-25
"Cullowhee, NC",19000.0,2019-09-01,2,0,2
"Cullowhee, NC",19000.0,2019-10-01,-119,-111,-8
"Cullowhee, NC",19000.0,2019-11-01,-41,-41,0
"Cullowhee, NC",19000.0,2019-12-01,-17,0,-17
"Cullowhee, NC",19000.0,2020-01-01,-39,-11,-28
"Cullowhee, NC",19000.0,2020-02-01,1,0,1
"Cullowhee, NC",19000.0,2020-03-01,7,0,7
"Cullowhee, NC",19000.0,2020-04-01,31,11,20
"Cullowhee, NC",19000.0,2020-05-01,89,86,3
"Cullowhee, NC",19000.0,2020-06-01,146,140,6
"Cullowhee, NC",19000.0,2020-07-01,-4,13,-17
"Cullowhee, NC",19000.0,2020-08-01,-19,0,-19
"Cullowhee, NC",19000.0,2020-09-01,18,0,18
"Cullowhee, NC",19000.0,2020-10-01,-95,-59,-36
"Cullowhee, NC",19000.0,2020-11-01,-58,-27,-31
"Cullowhee, NC",19000.0,2020-12-01,-15,-12,-3
"Jackson, OH",27160.0,2019-01-01,-22,0,-22
"Jackson, OH",27160.0,2019-02-01,0,0,0
"Jackson, OH",27160.0,2019-03-01,-17,0,-17
"Jackson, OH",27160.0,2019-04-01,-2,0,-2
"Jackson, OH",27160.0,2019-05-01,-3,0,-3
"Jackson, OH",27160.0,2019-06-01,0,0,0
"Jackson, OH",27160.0,2019-07-01,-11,0,-11
"Jackson, OH",27160.0,2019-08-01,4,0,4
"Jackson, OH",27160.0,2019-09-01,-12,0,-12
"Jackson, OH",27160.0,2019-10-01,41,0,41
"Jackson, OH",27160.0,2019-11-01,0,0,0
"Jackson, OH",27160.0,2019-12-01,11,0,11
"Jackson, OH",27160.0,2020-01-01,24,0,24
"Jackson, OH",27160.0,2020-02-01,12,0,12
"Jackson, OH",27160.0,2020-03-01,11,0,11
"Jackson, OH",27160.0,2020-04-01,-32,0,-32
"Jackson, OH",27160.0,2020-05-01,13,0,13
"Jackson, OH",27160.0,2020-06-01,13,0,13
"Jackson, OH",27160.0,2020-07-01,-7,0,-7
"Jackson, OH",27160.0,2020-08-01,40,0,40
"Jackson, OH",27160.0,2020-09-01,0,0,0
"Jackson, OH",27160.0,2020-10-01,11,0,11
"Jackson, OH",27160.0,2020-11-01,15,0,15
"Jackson, OH",27160.0,2020-12-01,22,0,22
"Altus, OK",11060.0,2019-01-01,0,0,0
"Altus, OK",11060.0,2019-02-01,0,0,0
"Altus, OK",11060.0,2019-03-01,0,0,0
"Altus, OK",11060.0,2019-04-01,0,0,0
"Altus, OK",11060.0,2019-05-01,0,0,0
"Altus, OK",11060.0,2019-06-01,0,0,0
"Altus, OK",11060.0,2019-07-01,-17,0,-17
"Altus, OK",11060.0,2019-08-01,-18,0,-18
"Altus, OK",11060.0,2019-09-01,0,0,0
"Altus, OK",11060.0,2019-10-01,0,0,0
"Altus, OK",11060.0,2019-11-01,0,0,0
"Altus, OK",11060.0,2019-12-01,0,0,0
"Altus, OK",11060.0,2020-01-01,0,0,0
"Altus, OK",11060.0,2020-02-01,-12,0,-12
"Altus, OK",11060.0,2020-03-01,0,0,0
"Altus, OK",11060.0,2020-04-01,-12,0,-12
"Altus, OK",11060.0,2020-05-01,0,0,0
"Altus, OK",11060.0,2020-06-01,13,0,13
"Altus, OK",11060.0,2020-07-01,0,0,0
"Altus, OK",11060.0,2020-08-01,-23,0,-23
"Altus, OK",11060.0,2020-09-01,0,0,0
"Altus, OK",11060.0,2020-10-01,0,0,0
"Altus, OK",11060.0,2020-11-01,0,0,0
"Altus, OK",11060.0,2020-12-01,0,0,0
"Medford, OR",32780.0,2019-01-01,124,-12,136
"Medford, OR",32780.0,2019-02-01,53,0,53
"Medford, OR",32780.0,2019-03-01,62,0,62
"Medford, OR",32780.0,2019-04-01,117,30,87
"Medford, OR",32780.0,2019-05-01,261,28,233
"Medford, OR",32780.0,2019-06-01,111,0,111
"Medford, OR",32780.0,2019-07-01,-13,0,-13
"Medford, OR",32780.0,2019-08-01,137,0,137
"Medford, OR",32780.0,2019-09-01,-28,-11,-17
"Medford, OR",32780.0,2019-10-01,-43,-103,60
"Medford, OR",32780.0,2019-11-01,-28,-37,9
"Medford, OR",32780.0,2019-12-01,0,-31,31
"Medford, OR",32780.0,2020-01-01,-28,-11,-17
"Medford, OR",32780.0,2020-02-01,-19,0,-19
"Medford, OR",32780.0,2020-03-01,204,11,193
"Medford, OR",32780.0,2020-04-01,55,0,55
"Medford, OR",32780.0,2020-05-01,143,12,131
"Medford, OR",32780.0,2020-06-01,135,0,135
"Medford, OR",32780.0,2020-07-01,188,0,188
"Medford, OR",32780.0,2020-08-01,262,0,262
"Medford, OR",32780.0,2020-09-01,-51,-19,-32
"Medford, OR",32780.0,2020-10-01,-5,-49,44
"Medford, OR",32780.0,2020-11-01,-211,-50,-161
"Medford, OR",32780.0,2020-12-01,-13,-13,0
"Cookeville, TN",18260.0,2019-01-01,-12,0,-12
"Cookeville, TN",18260.0,2019-02-01,33,0,33
"Cookeville, TN",18260.0,2019-03-01,18,0,18
"Cookeville, TN",18260.0,2019-04-01,30,0,30
"Cookeville, TN",18260.0,2019-05-01,-28,0,-28
"Cookeville, TN",18260.0,2019-06-01,20,0,20
"Cookeville, TN",18260.0,2019-07-01,10,0,10
"Cookeville, TN",18260.0,2019-08-01,37,0,37
"Cookeville, TN",18260.0,2019-09-01,-6,0,-6
"Cookeville, TN",18260.0,2019-10-01,3,0,3
"Cookeville, TN",18260.0,2019-11-01,39,0,39
"Cookeville, TN",18260.0,2019-12-01,6,0,6
"Cookeville, TN",18260.0,2020-01-01,2,0,2
"Cookeville, TN",18260.0,2020-02-01,-1,0,-1
"Cookeville, TN",18260.0,2020-03-01,17,0,17
"Cookeville, TN",18260.0,2020-04-01,-29,0,-29
"Cookeville, TN",18260.0,2020-05-01,30,0,30
"Cookeville, TN",18260.0,2020-06-01,-13,0,-13
"Cookeville, TN",18260.0,2020-07-01,-10,0,-10
"Cookeville, TN",18260.0,2020-08-01,53,0,53
"Cookeville, TN",18260.0,2020-09-01,14,0,14
"Cookeville, TN",18260.0,2020-10-01,-17,0,-17
"Cookeville, TN",18260.0,2020-11-01,13,0,13
"Cookeville, TN",18260.0,2020-12-01,42,0,42
"Joplin, MO",27900.0,2019-01-01,34,0,34
"Joplin, MO",27900.0,2019-02-01,11,0,11
"Joplin, MO",27900.0,2019-03-01,41,0,41
"Joplin, MO",27900.0,2019-04-01,39,0,39
"Joplin, MO",27900.0,2019-05-01,-78,0,-78
"Joplin, MO",27900.0,2019-06-01,-25,0,-25
"Joplin, MO",27900.0,2019-07-01,36,0,36
"Joplin, MO",27900.0,2019-08-01,-2,0,-2
"Joplin, MO",27900.0,2019-09-01,29,0,29
"Joplin, MO",27900.0,2019-10-01,23,0,23
"Joplin, MO",27900.0,2019-11-01,32,0,32
"Joplin, MO",27900.0,2019-12-01,-6,0,-6
"Joplin, MO",27900.0,2020-01-01,-19,0,-19
"Joplin, MO",27900.0,2020-02-01,13,0,13
"Joplin, MO",27900.0,2020-03-01,-40,0,-40
"Joplin, MO",27900.0,2020-04-01,-27,0,-27
"Joplin, MO",27900.0,2020-05-01,20,0,20
"Joplin, MO",27900.0,2020-06-01,-43,0,-43
"Joplin, MO",27900.0,2020-07-01,-4,0,-4
"Joplin, MO",27900.0,2020-08-01,-21,0,-21
"Joplin, MO",27900.0,2020-09-01,19,0,19
"Joplin, MO",27900.0,2020-10-01,26,0,26
"Joplin, MO",27900.0,2020-11-01,-12,0,-12
"Joplin, MO",27900.0,2020-12-01,5,0,5
"Laurel, MS",29860.0,2019-01-01,3,0,3
"Laurel, MS",29860.0,2019-02-01,12,0,12
"Laurel, MS",29860.0,2019-03-01,-22,0,-22
"Laurel, MS",29860.0,2019-04-01,0,0,0
"Laurel, MS",29860.0,2019-05-01,8,0,8
"Laurel, MS",29860.0,2019-06-01,20,0,20
"Laurel, MS",29860.0,2019-07-01,9,0,9
"Laurel, MS",29860.0,2019-08-01,14,0,14
"Laurel, MS",29860.0,2019-09-01,-30,0,-30
"Laurel, MS",29860.0,2019-10-01,-3,0,-3
"Laurel, MS",29860.0,2019-11-01,-7,0,-7
"Laurel, MS",29860.0,2019-12-01,-15,0,-15
"Laurel, MS",29860.0,2020-01-01,3,0,3
"Laurel, MS",29860.0,2020-02-01,15,0,15
"Laurel, MS",29860.0,2020-03-01,-6,0,-6
"Laurel, MS",29860.0,2020-04-01,13,0,13
"Laurel, MS",29860.0,2020-05-01,-10,0,-10
"Laurel, MS",29860.0,2020-06-01,-21,0,-21
"Laurel, MS",29860.0,2020-07-01,-2,0,-2
"Laurel, MS",29860.0,2020-08-01,-3,0,-3
"Laurel, MS",29860.0,2020-09-01,-20,0,-20
"Laurel, MS",29860.0,2020-10-01,-38,0,-38
"Laurel, MS",29860.0,2020-11-01,-35,0,-35
"Laurel, MS",29860.0,2020-12-01,-14,0,-14
"Fairfield, IA",21840.0,2019-01-01,-15,0,-15
"Fairfield, IA",21840.0,2019-02-01,11,0,11
"Fairfield, IA",21840.0,2019-03-01,11,0,11
"Fairfield, IA",21840.0,2019-04-01,0,0,0
"Fairfield, IA",21840.0,2019-05-01,0,0,0
"Fairfield, IA",21840.0,2019-06-01,14,0,14
"Fairfield, IA",21840.0,2019-07-01,0,0,0
"Fairfield, IA",21840.0,2019-08-01,0,0,0
"Fairfield, IA",21840.0,2019-09-01,0,0,0
"Fairfield, IA",21840.0,2019-10-01,0,0,0
"Fairfield, IA",21840.0,2019-11-01,0,0,0
"Fairfield, IA",21840.0,2019-12-01,0,0,0
"Fairfield, IA",21840.0,2020-01-01,0,0,0
"Fairfield, IA",21840.0,2020-02-01,0,0,0
"Fairfield, IA",21840.0,2020-03-01,0,0,0
"Fairfield, IA",21840.0,2020-04-01,0,0,0
"Fairfield, IA",21840.0,2020-05-01,0,0,0
"Fairfield, IA",21840.0,2020-06-01,11,0,11
"Fairfield, IA",21840.0,2020-07-01,0,0,0
"Fairfield, IA",21840.0,2020-08-01,0,0,0
"Fairfield, IA",21840.0,2020-09-01,12,0,12
"Fairfield, IA",21840.0,2020-10-01,0,0,0
"Fairfield, IA",21840.0,2020-11-01,0,0,0
"Fairfield, IA",21840.0,2020-12-01,0,0,0
"Mount Vernon, IL",34500.0,2019-01-01,-7,0,-7
"Mount Vernon, IL",34500.0,2019-02-01,12,0,12
"Mount Vernon, IL",34500.0,2019-03-01,17,0,17
"Mount Vernon, IL",34500.0,2019-04-01,-5,0,-5
"Mount Vernon, IL",34500.0,2019-05-01,5,0,5
"Mount Vernon, IL",34500.0,2019-06-01,-12,0,-12
"Mount Vernon, IL",34500.0,2019-07-01,5,0,5
"Mount Vernon, IL",34500.0,2019-08-01,-25,0,-25
"Mount Vernon, IL",34500.0,2019-09-01,-9,0,-9
"Mount Vernon, IL",34500.0,2019-10-01,5,0,5
"Mount Vernon, IL",34500.0,2019-11-01,20,0,20
"Mount Vernon, IL",34500.0,2019-12-01,-25,0,-25
"Mount Vernon, IL",34500.0,2020-01-01,31,0,31
"Mount Vernon, IL",34500.0,2020-02-01,0,0,0
"Mount Vernon, IL",34500.0,2020-03-01,18,0,18
"Mount Vernon, IL",34500.0,2020-04-01,-12,0,-12
"Mount Vernon, IL",34500.0,2020-05-01,-6,0,-6
"Mount Vernon, IL",34500.0,2020-06-01,6,0,6
"Mount Vernon, IL",34500.0,2020-07-01,-12,0,-12
"Mount Vernon, IL",34500.0,2020-08-01,10,0,10
"Mount Vernon, IL",34500.0,2020-09-01,-5,0,-5
"Mount Vernon, IL",34500.0,2020-10-01,-9,0,-9
"Mount Vernon, IL",34500.0,2020-11-01,7,0,7
"Mount Vernon, IL",34500.0,2020-12-01,3,0,3
"Madison, IN",31500.0,2019-01-01,1,0,1
"Madison, IN",31500.0,2019-02-01,-19,0,-19
"Madison, IN",31500.0,2019-03-01,-6,0,-6
"Madison, IN",31500.0,2019-04-01,-30,0,-30
"Madison, IN",31500.0,2019-05-01,4,0,4
"Madison, IN",31500.0,2019-06-01,-30,0,-30
"Madison, IN",31500.0,2019-07-01,11,0,11
"Madison, IN",31500.0,2019-08-01,15,0,15
"Madison, IN",31500.0,2019-09-01,12,0,12
"Madison, IN",31500.0,2019-10-01,-23,0,-23
"Madison, IN",31500.0,2019-11-01,6,0,6
"Madison, IN",31500.0,2019-12-01,-16,0,-16
"Madison, IN",31500.0,2020-01-01,0,0,0
"Madison, IN",31500.0,2020-02-01,0,0,0
"Madison, IN",31500.0,2020-03-01,-3,0,-3
"Madison, IN",31500.0,2020-04-01,0,0,0
"Madison, IN",31500.0,2020-05-01,-19,0,-19
"Madison, IN",31500.0,2020-06-01,-13,0,-13
"Madison, IN",31500.0,2020-07-01,-17,0,-17
"Madison, IN",31500.0,2020-08-01,-19,0,-19
"Madison, IN",31500.0,2020-09-01,0,0,0
"Madison, IN",31500.0,2020-10-01,8,0,8
"Madison, IN",31500.0,2020-11-01,-12,0,-12
"Madison, IN",31500.0,2020-12-01,26,0,26
"New Orleans-Metairie, LA",35380.0,2019-01-01,-31,0,-31
"New Orleans-Metairie, LA",35380.0,2019-02-01,68,0,68
"New Orleans-Metairie, LA",35380.0,2019-03-01,-96,0,-96
"New Orleans-Metairie, LA",35380.0,2019-04-01,-20,0,-20
"New Orleans-Metairie, LA",35380.0,2019-05-01,-249,0,-249
"New Orleans-Metairie, LA",35380.0,2019-06-01,-247,0,-247
"New Orleans-Metairie, LA",35380.0,2019-07-01,-43,0,-43
"New Orleans-Metairie, LA",35380.0,2019-08-01,-162,0,-162
"New Orleans-Metairie, LA",35380.0,2019-09-01,-69,0,-69
"New Orleans-Metairie, LA",35380.0,2019-10-01,-51,0,-51
"New Orleans-Metairie, LA",35380.0,2019-11-01,-50,12,-62
"New Orleans-Metairie, LA",35380.0,2019-12-01,-140,0,-140
"New Orleans-Metairie, LA",35380.0,2020-01-01,-70,0,-70
"New Orleans-Metairie, LA",35380.0,2020-02-01,-31,0,-31
"New Orleans-Metairie, LA",35380.0,2020-03-01,-217,-14,-203
"New Orleans-Metairie, LA",35380.0,2020-04-01,-245,0,-245
"New Orleans-Metairie, LA",35380.0,2020-05-01,-227,11,-238
"New Orleans-Metairie, LA",35380.0,2020-06-01,-190,11,-201
"New Orleans-Metairie, LA",35380.0,2020-07-01,-177,-11,-166
"New Orleans-Metairie, LA",35380.0,2020-08-01,45,38,7
"New Orleans-Metairie, LA",35380.0,2020-09-01,-4,55,-59
"New Orleans-Metairie, LA",35380.0,2020-10-01,53,13,40
"New Orleans-Metairie, LA",35380.0,2020-11-01,27,39,-12
"New Orleans-Metairie, LA",35380.0,2020-12-01,-39,33,-72
"Helena, MT",25740.0,2019-01-01,-3,-31,28
"Helena, MT",25740.0,2019-02-01,10,0,10
"Helena, MT",25740.0,2019-03-01,-1,0,-1
"Helena, MT",25740.0,2019-04-01,90,58,32
"Helena, MT",25740.0,2019-05-01,61,54,7
"Helena, MT",25740.0,2019-06-01,69,16,53
"Helena, MT",25740.0,2019-07-01,46,0,46
"Helena, MT",25740.0,2019-08-01,11,0,11
"Helena, MT",25740.0,2019-09-01,-30,-20,-10
"Helena, MT",25740.0,2019-10-01,-137,-142,5
"Helena, MT",25740.0,2019-11-01,-39,-71,32
"Helena, MT",25740.0,2019-12-01,-59,-63,4
"Helena, MT",25740.0,2020-01-01,-9,-17,8
"Helena, MT",25740.0,2020-02-01,11,0,11
"Helena, MT",25740.0,2020-03-01,65,0,65
"Helena, MT",25740.0,2020-04-01,105,29,76
"Helena, MT",25740.0,2020-05-01,113,66,47
"Helena, MT",25740.0,2020-06-01,76,14,62
"Helena, MT",25740.0,2020-07-01,23,-17,40
"Helena, MT",25740.0,2020-08-01,7,0,7
"Helena, MT",25740.0,2020-09-01,45,-15,60
"Helena, MT",25740.0,2020-10-01,-72,-108,36
"Helena, MT",25740.0,2020-11-01,-31,-74,43
"Helena, MT",25740.0,2020-12-01,-1,-35,34
"Watertown-Fort Drum, NY",48060.0,2019-01-01,-109,-75,-34
"Watertown-Fort Drum, NY",48060.0,2019-02-01,12,0,12
"Watertown-Fort Drum, NY",48060.0,2019-03-01,-22,0,-22
"Watertown-Fort Drum, NY",48060.0,2019-04-01,308,232,76
"Watertown-Fort Drum, NY",48060.0,2019-05-01,666,646,20
"Watertown-Fort Drum, NY",48060.0,2019-06-01,61,134,-73
"Watertown-Fort Drum, NY",48060.0,2019-07-01,11,15,-4
"Watertown-Fort Drum, NY",48060.0,2019-08-01,-59,0,-59
"Watertown-Fort Drum, NY",48060.0,2019-09-01,-193,-82,-111
"Watertown-Fort Drum, NY",48060.0,2019-10-01,-686,-588,-98
"Watertown-Fort Drum, NY",48060.0,2019-11-01,-223,-217,-6
"Watertown-Fort Drum, NY",48060.0,2019-12-01,-271,-242,-29
"Watertown-Fort Drum, NY",48060.0,2020-01-01,-95,-97,2
"Watertown-Fort Drum, NY",48060.0,2020-02-01,-19,0,-19
"Watertown-Fort Drum, NY",48060.0,2020-03-01,48,12,36
"Watertown-Fort Drum, NY",48060.0,2020-04-01,38,29,9
"Watertown-Fort Drum, NY",48060.0,2020-05-01,519,451,68
"Watertown-Fort Drum, NY",48060.0,2020-06-01,286,288,-2
"Watertown-Fort Drum, NY",48060.0,2020-07-01,6,11,-5
"Watertown-Fort Drum, NY",48060.0,2020-08-01,27,0,27
"Watertown-Fort Drum, NY",48060.0,2020-09-01,-53,-64,11
"Watertown-Fort Drum, NY",48060.0,2020-10-01,-595,-519,-76
"Watertown-Fort Drum, NY",48060.0,2020-11-01,-168,-189,21
"Watertown-Fort Drum, NY",48060.0,2020-12-01,-150,-126,-24
"Watertown-Fort Atkinson, WI",48020.0,2019-01-01,-40,0,-40
"Watertown-Fort Atkinson, WI",48020.0,2019-02-01,32,0,32
"Watertown-Fort Atkinson, WI",48020.0,2019-03-01,-20,0,-20
"Watertown-Fort Atkinson, WI",48020.0,2019-04-01,37,18,19
"Watertown-Fort Atkinson, WI",48020.0,2019-05-01,82,18,64
"Watertown-Fort Atkinson, WI",48020.0,2019-06-01,-21,0,-21
"Watertown-Fort Atkinson, WI",48020.0,2019-07-01,35,0,35
"Watertown-Fort Atkinson, WI",48020.0,2019-08-01,81,0,81
"Watertown-Fort Atkinson, WI",48020.0,2019-09-01,-27,0,-27
"Watertown-Fort Atkinson, WI",48020.0,2019-10-01,-6,-13,7
"Watertown-Fort Atkinson, WI",48020.0,2019-11-01,0,-12,12
"Watertown-Fort Atkinson, WI",48020.0,2019-12-01,-29,-34,5
"Watertown-Fort Atkinson, WI",48020.0,2020-01-01,-56,-33,-23
"Watertown-Fort Atkinson, WI",48020.0,2020-02-01,19,0,19
"Watertown-Fort Atkinson, WI",48020.0,2020-03-01,43,16,27
"Watertown-Fort Atkinson, WI",48020.0,2020-04-01,21,0,21
"Watertown-Fort Atkinson, WI",48020.0,2020-05-01,91,18,73
"Watertown-Fort Atkinson, WI",48020.0,2020-06-01,61,0,61
"Watertown-Fort Atkinson, WI",48020.0,2020-07-01,52,0,52
"Watertown-Fort Atkinson, WI",48020.0,2020-08-01,76,0,76
"Watertown-Fort Atkinson, WI",48020.0,2020-09-01,62,0,62
"Watertown-Fort Atkinson, WI",48020.0,2020-10-01,30,-23,53
"Watertown-Fort Atkinson, WI",48020.0,2020-11-01,22,-11,33
"Watertown-Fort Atkinson, WI",48020.0,2020-12-01,-33,-37,4
"Jennings, LA",27660.0,2019-01-01,-24,0,-24
"Jennings, LA",27660.0,2019-02-01,10,0,10
"Jennings, LA",27660.0,2019-03-01,-1,0,-1
"Jennings, LA",27660.0,2019-04-01,1,0,1
"Jennings, LA",27660.0,2019-05-01,-5,0,-5
"Jennings, LA",27660.0,2019-06-01,0,0,0
"Jennings, LA",27660.0,2019-07-01,18,0,18
"Jennings, LA",27660.0,2019-08-01,12,0,12
"Jennings, LA",27660.0,2019-09-01,16,0,16
"Jennings, LA",27660.0,2019-10-01,3,0,3
"Jennings, LA",27660.0,2019-11-01,11,0,11
"Jennings, LA",27660.0,2019-12-01,-4,0,-4
"Jennings, LA",27660.0,2020-01-01,-16,0,-16
"Jennings, LA",27660.0,2020-02-01,18,0,18
"Jennings, LA",27660.0,2020-03-01,13,0,13
"Jennings, LA",27660.0,2020-04-01,-4,0,-4
"Jennings, LA",27660.0,2020-05-01,6,0,6
"Jennings, LA",27660.0,2020-06-01,2,0,2
"Jennings, LA",27660.0,2020-07-01,3,0,3
"Jennings, LA",27660.0,2020-08-01,14,0,14
"Jennings, LA",27660.0,2020-09-01,88,49,39
"Jennings, LA",27660.0,2020-10-01,49,0,49
"Jennings, LA",27660.0,2020-11-01,27,0,27
"Jennings, LA",27660.0,2020-12-01,11,0,11
"North Vernon, IN",35860.0,2019-01-01,0,0,0
"North Vernon, IN",35860.0,2019-02-01,-2,0,-2
"North Vernon, IN",35860.0,2019-03-01,-3,0,-3
"North Vernon, IN",35860.0,2019-04-01,4,0,4
"North Vernon, IN",35860.0,2019-05-01,2,0,2
"North Vernon, IN",35860.0,2019-06-01,3,0,3
"North Vernon, IN",35860.0,2019-07-01,-12,0,-12
"North Vernon, IN",35860.0,2019-08-01,17,0,17
"North Vernon, IN",35860.0,2019-09-01,-6,0,-6
"North Vernon, IN",35860.0,2019-10-01,19,0,19
"North Vernon, IN",35860.0,2019-11-01,6,0,6
"North Vernon, IN",35860.0,2019-12-01,-13,0,-13
"North Vernon, IN",35860.0,2020-01-01,38,0,38
"North Vernon, IN",35860.0,2020-02-01,-21,0,-21
"North Vernon, IN",35860.0,2020-03-01,23,0,23
"North Vernon, IN",35860.0,2020-04-01,0,0,0
"North Vernon, IN",35860.0,2020-05-01,13,0,13
"North Vernon, IN",35860.0,2020-06-01,-4,0,-4
"North Vernon, IN",35860.0,2020-07-01,-39,0,-39
"North Vernon, IN",35860.0,2020-08-01,-4,0,-4
"North Vernon, IN",35860.0,2020-09-01,18,0,18
"North Vernon, IN",35860.0,2020-10-01,21,0,21
"North Vernon, IN",35860.0,2020-11-01,19,0,19
"North Vernon, IN",35860.0,2020-12-01,-23,0,-23
"Twin Falls, ID",46300.0,2019-01-01,-23,0,-23
"Twin Falls, ID",46300.0,2019-02-01,13,0,13
"Twin Falls, ID",46300.0,2019-03-01,20,0,20
"Twin Falls, ID",46300.0,2019-04-01,31,0,31
"Twin Falls, ID",46300.0,2019-05-01,-37,0,-37
"Twin Falls, ID",46300.0,2019-06-01,55,0,55
"Twin Falls, ID",46300.0,2019-07-01,58,0,58
"Twin Falls, ID",46300.0,2019-08-01,30,0,30
"Twin Falls, ID",46300.0,2019-09-01,-10,0,-10
"Twin Falls, ID",46300.0,2019-10-01,-69,-64,-5
"Twin Falls, ID",46300.0,2019-11-01,-43,-29,-14
"Twin Falls, ID",46300.0,2019-12-01,-21,-11,-10
"Twin Falls, ID",46300.0,2020-01-01,-21,0,-21
"Twin Falls, ID",46300.0,2020-02-01,24,0,24
"Twin Falls, ID",46300.0,2020-03-01,17,0,17
"Twin Falls, ID",46300.0,2020-04-01,43,0,43
"Twin Falls, ID",46300.0,2020-05-01,11,0,11
"Twin Falls, ID",46300.0,2020-06-01,-27,0,-27
"Twin Falls, ID",46300.0,2020-07-01,27,0,27
"Twin Falls, ID",46300.0,2020-08-01,-6,0,-6
"Twin Falls, ID",46300.0,2020-09-01,0,0,0
"Twin Falls, ID",46300.0,2020-10-01,46,-37,83
"Twin Falls, ID",46300.0,2020-11-01,7,-16,23
"Twin Falls, ID",46300.0,2020-12-01,26,0,26
"Dublin, GA",20140.0,2019-01-01,-11,0,-11
"Dublin, GA",20140.0,2019-02-01,0,0,0
"Dublin, GA",20140.0,2019-03-01,0,0,0
"Dublin, GA",20140.0,2019-04-01,11,0,11
"Dublin, GA",20140.0,2019-05-01,11,0,11
"Dublin, GA",20140.0,2019-06-01,0,0,0
"Dublin, GA",20140.0,2019-07-01,0,0,0
"Dublin, GA",20140.0,2019-08-01,-16,0,-16
"Dublin, GA",20140.0,2019-09-01,0,0,0
"Dublin, GA",20140.0,2019-10-01,0,0,0
"Dublin, GA",20140.0,2019-11-01,0,0,0
"Dublin, GA",20140.0,2019-12-01,11,0,11
"Dublin, GA",20140.0,2020-01-01,11,0,11
"Dublin, GA",20140.0,2020-02-01,0,0,0
"Dublin, GA",20140.0,2020-03-01,0,0,0
"Dublin, GA",20140.0,2020-04-01,0,0,0
"Dublin, GA",20140.0,2020-05-01,0,0,0
"Dublin, GA",20140.0,2020-06-01,0,0,0
"Dublin, GA",20140.0,2020-07-01,0,0,0
"Dublin, GA",20140.0,2020-08-01,12,0,12
"Dublin, GA",20140.0,2020-09-01,0,0,0
"Dublin, GA",20140.0,2020-10-01,0,0,0
"Dublin, GA",20140.0,2020-11-01,15,0,15
"Dublin, GA",20140.0,2020-12-01,0,0,0
"Iowa City, IA",26980.0,2019-01-01,-126,-27,-99
"Iowa City, IA",26980.0,2019-02-01,-33,0,-33
"Iowa City, IA",26980.0,2019-03-01,-49,0,-49
"Iowa City, IA",26980.0,2019-04-01,91,36,55
"Iowa City, IA",26980.0,2019-05-01,-91,-1,-90
"Iowa City, IA",26980.0,2019-06-01,-217,0,-217
"Iowa City, IA",26980.0,2019-07-01,-418,0,-418
"Iowa City, IA",26980.0,2019-08-01,-9,0,-9
"Iowa City, IA",26980.0,2019-09-01,5,0,5
"Iowa City, IA",26980.0,2019-10-01,-36,-55,19
"Iowa City, IA",26980.0,2019-11-01,-32,-37,5
"Iowa City, IA",26980.0,2019-12-01,-93,-88,-5
"Iowa City, IA",26980.0,2020-01-01,-50,-35,-15
"Iowa City, IA",26980.0,2020-02-01,-16,0,-16
"Iowa City, IA",26980.0,2020-03-01,-15,-3,-12
"Iowa City, IA",26980.0,2020-04-01,-33,12,-45
"Iowa City, IA",26980.0,2020-05-01,-46,11,-57
"Iowa City, IA",26980.0,2020-06-01,-234,0,-234
"Iowa City, IA",26980.0,2020-07-01,-480,0,-480
"Iowa City, IA",26980.0,2020-08-01,95,16,79
"Iowa City, IA",26980.0,2020-09-01,63,0,63
"Iowa City, IA",26980.0,2020-10-01,8,-33,41
"Iowa City, IA",26980.0,2020-11-01,-43,-36,-7
"Iowa City, IA",26980.0,2020-12-01,-69,-80,11
"Warrensburg, MO",47660.0,2019-01-01,18,0,18
"Warrensburg, MO",47660.0,2019-02-01,36,0,36
"Warrensburg, MO",47660.0,2019-03-01,17,0,17
"Warrensburg, MO",47660.0,2019-04-01,44,0,44
"Warrensburg, MO",47660.0,2019-05-01,-65,0,-65
"Warrensburg, MO",47660.0,2019-06-01,40,0,40
"Warrensburg, MO",47660.0,2019-07-01,-17,0,-17
"Warrensburg, MO",47660.0,2019-08-01,51,0,51
"Warrensburg, MO",47660.0,2019-09-01,-26,0,-26
"Warrensburg, MO",47660.0,2019-10-01,36,0,36
"Warrensburg, MO",47660.0,2019-11-01,53,0,53
"Warrensburg, MO",47660.0,2019-12-01,19,0,19
"Warrensburg, MO",47660.0,2020-01-01,-9,0,-9
"Warrensburg, MO",47660.0,2020-02-01,36,0,36
"Warrensburg, MO",47660.0,2020-03-01,35,0,35
"Warrensburg, MO",47660.0,2020-04-01,11,0,11
"Warrensburg, MO",47660.0,2020-05-01,7,0,7
"Warrensburg, MO",47660.0,2020-06-01,19,0,19
"Warrensburg, MO",47660.0,2020-07-01,-59,0,-59
"Warrensburg, MO",47660.0,2020-08-01,22,0,22
"Warrensburg, MO",47660.0,2020-09-01,-28,0,-28
"Warrensburg, MO",47660.0,2020-10-01,55,0,55
"Warrensburg, MO",47660.0,2020-11-01,54,0,54
"Warrensburg, MO",47660.0,2020-12-01,26,0,26
"Grants Pass, OR",24420.0,2019-01-01,-14,0,-14
"Grants Pass, OR",24420.0,2019-02-01,8,0,8
"Grants Pass, OR",24420.0,2019-03-01,47,0,47
"Grants Pass, OR",24420.0,2019-04-01,34,0,34
"Grants Pass, OR",24420.0,2019-05-01,15,0,15
"Grants Pass, OR",24420.0,2019-06-01,-23,0,-23
"Grants Pass, OR",24420.0,2019-07-01,7,0,7
"Grants Pass, OR",24420.0,2019-08-01,22,0,22
"Grants Pass, OR",24420.0,2019-09-01,29,0,29
"Grants Pass, OR",24420.0,2019-10-01,-46,-41,-5
"Grants Pass, OR",24420.0,2019-11-01,-54,-14,-40
"Grants Pass, OR",24420.0,2019-12-01,-14,-15,1
"Grants Pass, OR",24420.0,2020-01-01,10,0,10
"Grants Pass, OR",24420.0,2020-02-01,16,0,16
"Grants Pass, OR",24420.0,2020-03-01,48,0,48
"Grants Pass, OR",24420.0,2020-04-01,69,0,69
"Grants Pass, OR",24420.0,2020-05-01,-3,0,-3
"Grants Pass, OR",24420.0,2020-06-01,13,0,13
"Grants Pass, OR",24420.0,2020-07-01,34,0,34
"Grants Pass, OR",24420.0,2020-08-01,23,0,23
"Grants Pass, OR",24420.0,2020-09-01,53,19,34
"Grants Pass, OR",24420.0,2020-10-01,8,0,8
"Grants Pass, OR",24420.0,2020-11-01,6,0,6
"Grants Pass, OR",24420.0,2020-12-01,10,0,10
"Provo-Orem, UT",39340.0,2019-01-01,-46,-43,-3
"Provo-Orem, UT",39340.0,2019-02-01,60,-1,61
"Provo-Orem, UT",39340.0,2019-03-01,165,3,162
"Provo-Orem, UT",39340.0,2019-04-01,122,46,76
"Provo-Orem, UT",39340.0,2019-05-01,111,59,52
"Provo-Orem, UT",39340.0,2019-06-01,80,7,73
"Provo-Orem, UT",39340.0,2019-07-01,161,-1,162
"Provo-Orem, UT",39340.0,2019-08-01,-85,-30,-55
"Provo-Orem, UT",39340.0,2019-09-01,135,-17,152
"Provo-Orem, UT",39340.0,2019-10-01,-60,-89,29
"Provo-Orem, UT",39340.0,2019-11-01,20,-53,73
"Provo-Orem, UT",39340.0,2019-12-01,98,-45,143
"Provo-Orem, UT",39340.0,2020-01-01,59,-43,102
"Provo-Orem, UT",39340.0,2020-02-01,156,12,144
"Provo-Orem, UT",39340.0,2020-03-01,126,11,115
"Provo-Orem, UT",39340.0,2020-04-01,49,-7,56
"Provo-Orem, UT",39340.0,2020-05-01,104,5,99
"Provo-Orem, UT",39340.0,2020-06-01,253,18,235
"Provo-Orem, UT",39340.0,2020-07-01,217,18,199
"Provo-Orem, UT",39340.0,2020-08-01,212,5,207
"Provo-Orem, UT",39340.0,2020-09-01,364,-2,366
"Provo-Orem, UT",39340.0,2020-10-01,154,-53,207
"Provo-Orem, UT",39340.0,2020-11-01,109,-68,177
"Provo-Orem, UT",39340.0,2020-12-01,173,-28,201
"Juneau, AK",27940.0,2019-01-01,0,0,0
"Juneau, AK",27940.0,2019-02-01,0,0,0
"Juneau, AK",27940.0,2019-03-01,0,0,0
"Juneau, AK",27940.0,2019-04-01,0,0,0
"Juneau, AK",27940.0,2019-05-01,-14,0,-14
"Juneau, AK",27940.0,2019-06-01,2,0,2
"Juneau, AK",27940.0,2019-07-01,0,0,0
"Juneau, AK",27940.0,2019-08-01,-19,0,-19
"Juneau, AK",27940.0,2019-09-01,-4,0,-4
"Juneau, AK",27940.0,2019-10-01,-24,-11,-13
"Juneau, AK",27940.0,2019-11-01,0,0,0
"Juneau, AK",27940.0,2019-12-01,0,0,0
"Juneau, AK",27940.0,2020-01-01,12,12,0
"Juneau, AK",27940.0,2020-02-01,0,0,0
"Juneau, AK",27940.0,2020-03-01,0,0,0
"Juneau, AK",27940.0,2020-04-01,0,0,0
"Juneau, AK",27940.0,2020-05-01,0,0,0
"Juneau, AK",27940.0,2020-06-01,0,0,0
"Juneau, AK",27940.0,2020-07-01,-14,0,-14
"Juneau, AK",27940.0,2020-08-01,0,0,0
"Juneau, AK",27940.0,2020-09-01,-11,0,-11
"Juneau, AK",27940.0,2020-10-01,-12,-12,0
"Juneau, AK",27940.0,2020-11-01,0,0,0
"Juneau, AK",27940.0,2020-12-01,0,0,0
"Kalamazoo-Portage, MI",28020.0,2019-01-01,-216,-118,-98
"Kalamazoo-Portage, MI",28020.0,2019-02-01,-6,-11,5
"Kalamazoo-Portage, MI",28020.0,2019-03-01,-66,0,-66
"Kalamazoo-Portage, MI",28020.0,2019-04-01,327,232,95
"Kalamazoo-Portage, MI",28020.0,2019-05-01,112,146,-34
"Kalamazoo-Portage, MI",28020.0,2019-06-01,-118,0,-118
"Kalamazoo-Portage, MI",28020.0,2019-07-01,-198,0,-198
"Kalamazoo-Portage, MI",28020.0,2019-08-01,-133,0,-133
"Kalamazoo-Portage, MI",28020.0,2019-09-01,-127,0,-127
"Kalamazoo-Portage, MI",28020.0,2019-10-01,-259,-257,-2
"Kalamazoo-Portage, MI",28020.0,2019-11-01,-341,-250,-91
"Kalamazoo-Portage, MI",28020.0,2019-12-01,-263,-294,31
"Kalamazoo-Portage, MI",28020.0,2020-01-01,-182,-159,-23
"Kalamazoo-Portage, MI",28020.0,2020-02-01,-28,-13,-15
"Kalamazoo-Portage, MI",28020.0,2020-03-01,31,3,28
"Kalamazoo-Portage, MI",28020.0,2020-04-01,18,53,-35
"Kalamazoo-Portage, MI",28020.0,2020-05-01,81,122,-41
"Kalamazoo-Portage, MI",28020.0,2020-06-01,-85,33,-118
"Kalamazoo-Portage, MI",28020.0,2020-07-01,-110,0,-110
"Kalamazoo-Portage, MI",28020.0,2020-08-01,-47,0,-47
"Kalamazoo-Portage, MI",28020.0,2020-09-01,-56,0,-56
"Kalamazoo-Portage, MI",28020.0,2020-10-01,-271,-232,-39
"Kalamazoo-Portage, MI",28020.0,2020-11-01,-360,-280,-80
"Kalamazoo-Portage, MI",28020.0,2020-12-01,-233,-191,-42
"Willmar, MN",48820.0,2019-01-01,-72,-44,-28
"Willmar, MN",48820.0,2019-02-01,3,0,3
"Willmar, MN",48820.0,2019-03-01,-4,0,-4
"Willmar, MN",48820.0,2019-04-01,63,41,22
"Willmar, MN",48820.0,2019-05-01,-4,23,-27
"Willmar, MN",48820.0,2019-06-01,-39,0,-39
"Willmar, MN",48820.0,2019-07-01,-39,0,-39
"Willmar, MN",48820.0,2019-08-01,8,0,8
"Willmar, MN",48820.0,2019-09-01,-11,0,-11
"Willmar, MN",48820.0,2019-10-01,-77,-69,-8
"Willmar, MN",48820.0,2019-11-01,-93,-86,-7
"Willmar, MN",48820.0,2019-12-01,-82,-82,0
"Willmar, MN",48820.0,2020-01-01,-58,-58,0
"Willmar, MN",48820.0,2020-02-01,1,0,1
"Willmar, MN",48820.0,2020-03-01,-11,12,-23
"Willmar, MN",48820.0,2020-04-01,-5,19,-24
"Willmar, MN",48820.0,2020-05-01,16,23,-7
"Willmar, MN",48820.0,2020-06-01,1,0,1
"Willmar, MN",48820.0,2020-07-01,15,0,15
"Willmar, MN",48820.0,2020-08-01,25,0,25
"Willmar, MN",48820.0,2020-09-01,-12,0,-12
"Willmar, MN",48820.0,2020-10-01,-92,-78,-14
"Willmar, MN",48820.0,2020-11-01,-59,-62,3
"Willmar, MN",48820.0,2020-12-01,-87,-70,-17
"Kankakee, IL",28100.0,2019-01-01,42,0,42
"Kankakee, IL",28100.0,2019-02-01,18,0,18
"Kankakee, IL",28100.0,2019-03-01,-8,0,-8
"Kankakee, IL",28100.0,2019-04-01,22,14,8
"Kankakee, IL",28100.0,2019-05-01,32,0,32
"Kankakee, IL",28100.0,2019-06-01,32,0,32
"Kankakee, IL",28100.0,2019-07-01,-8,0,-8
"Kankakee, IL",28100.0,2019-08-01,-2,0,-2
"Kankakee, IL",28100.0,2019-09-01,10,0,10
"Kankakee, IL",28100.0,2019-10-01,-40,-11,-29
"Kankakee, IL",28100.0,2019-11-01,21,0,21
"Kankakee, IL",28100.0,2019-12-01,-12,-23,11
"Kankakee, IL",28100.0,2020-01-01,-30,0,-30
"Kankakee, IL",28100.0,2020-02-01,2,0,2
"Kankakee, IL",28100.0,2020-03-01,20,0,20
"Kankakee, IL",28100.0,2020-04-01,51,14,37
"Kankakee, IL",28100.0,2020-05-01,-6,0,-6
"Kankakee, IL",28100.0,2020-06-01,19,0,19
"Kankakee, IL",28100.0,2020-07-01,63,0,63
"Kankakee, IL",28100.0,2020-08-01,63,0,63
"Kankakee, IL",28100.0,2020-09-01,44,0,44
"Kankakee, IL",28100.0,2020-10-01,27,0,27
"Kankakee, IL",28100.0,2020-11-01,12,0,12
"Kankakee, IL",28100.0,2020-12-01,43,-12,55
"Kapaa, HI",28180.0,2019-01-01,-11,0,-11
"Kapaa, HI",28180.0,2019-02-01,1,0,1
"Kapaa, HI",28180.0,2019-03-01,5,0,5
"Kapaa, HI",28180.0,2019-04-01,-19,0,-19
"Kapaa, HI",28180.0,2019-05-01,-9,0,-9
"Kapaa, HI",28180.0,2019-06-01,3,0,3
"Kapaa, HI",28180.0,2019-07-01,9,0,9
"Kapaa, HI",28180.0,2019-08-01,-3,0,-3
"Kapaa, HI",28180.0,2019-09-01,-21,0,-21
"Kapaa, HI",28180.0,2019-10-01,-18,0,-18
"Kapaa, HI",28180.0,2019-11-01,9,0,9
"Kapaa, HI",28180.0,2019-12-01,-4,0,-4
"Kapaa, HI",28180.0,2020-01-01,43,12,31
"Kapaa, HI",28180.0,2020-02-01,8,0,8
"Kapaa, HI",28180.0,2020-03-01,40,12,28
"Kapaa, HI",28180.0,2020-04-01,-13,0,-13
"Kapaa, HI",28180.0,2020-05-01,45,21,24
"Kapaa, HI",28180.0,2020-06-01,39,12,27
"Kapaa, HI",28180.0,2020-07-01,26,12,14
"Kapaa, HI",28180.0,2020-08-01,29,13,16
"Kapaa, HI",28180.0,2020-09-01,29,19,10
"Kapaa, HI",28180.0,2020-10-01,22,0,22
"Kapaa, HI",28180.0,2020-11-01,-4,0,-4
"Kapaa, HI",28180.0,2020-12-01,8,11,-3
"Ponca City, OK",38620.0,2019-01-01,-26,0,-26
"Ponca City, OK",38620.0,2019-02-01,0,0,0
"Ponca City, OK",38620.0,2019-03-01,-35,0,-35
"Ponca City, OK",38620.0,2019-04-01,-16,0,-16
"Ponca City, OK",38620.0,2019-05-01,14,0,14
"Ponca City, OK",38620.0,2019-06-01,-13,0,-13
"Ponca City, OK",38620.0,2019-07-01,-23,0,-23
"Ponca City, OK",38620.0,2019-08-01,-32,0,-32
"Ponca City, OK",38620.0,2019-09-01,-31,0,-31
"Ponca City, OK",38620.0,2019-10-01,-35,0,-35
"Ponca City, OK",38620.0,2019-11-01,-6,0,-6
"Ponca City, OK",38620.0,2019-12-01,0,0,0
"Ponca City, OK",38620.0,2020-01-01,2,0,2
"Ponca City, OK",38620.0,2020-02-01,12,0,12
"Ponca City, OK",38620.0,2020-03-01,-4,0,-4
"Ponca City, OK",38620.0,2020-04-01,0,0,0
"Ponca City, OK",38620.0,2020-05-01,-11,0,-11
"Ponca City, OK",38620.0,2020-06-01,-6,0,-6
"Ponca City, OK",38620.0,2020-07-01,-17,0,-17
"Ponca City, OK",38620.0,2020-08-01,4,0,4
"Ponca City, OK",38620.0,2020-09-01,11,0,11
"Ponca City, OK",38620.0,2020-10-01,0,0,0
"Ponca City, OK",38620.0,2020-11-01,0,0,0
"Ponca City, OK",38620.0,2020-12-01,-12,0,-12
"Augusta-Waterville, ME",12300.0,2019-01-01,-30,-49,19
"Augusta-Waterville, ME",12300.0,2019-02-01,27,0,27
"Augusta-Waterville, ME",12300.0,2019-03-01,16,0,16
"Augusta-Waterville, ME",12300.0,2019-04-01,257,178,79
"Augusta-Waterville, ME",12300.0,2019-05-01,453,368,85
"Augusta-Waterville, ME",12300.0,2019-06-01,95,66,29
"Augusta-Waterville, ME",12300.0,2019-07-01,-14,0,-14
"Augusta-Waterville, ME",12300.0,2019-08-01,-31,0,-31
"Augusta-Waterville, ME",12300.0,2019-09-01,39,0,39
"Augusta-Waterville, ME",12300.0,2019-10-01,-241,-268,27
"Augusta-Waterville, ME",12300.0,2019-11-01,-100,-130,30
"Augusta-Waterville, ME",12300.0,2019-12-01,-63,-124,61
"Augusta-Waterville, ME",12300.0,2020-01-01,-61,-73,12
"Augusta-Waterville, ME",12300.0,2020-02-01,-21,0,-21
"Augusta-Waterville, ME",12300.0,2020-03-01,72,0,72
"Augusta-Waterville, ME",12300.0,2020-04-01,101,83,18
"Augusta-Waterville, ME",12300.0,2020-05-01,282,235,47
"Augusta-Waterville, ME",12300.0,2020-06-01,168,162,6
"Augusta-Waterville, ME",12300.0,2020-07-01,93,0,93
"Augusta-Waterville, ME",12300.0,2020-08-01,40,0,40
"Augusta-Waterville, ME",12300.0,2020-09-01,60,0,60
"Augusta-Waterville, ME",12300.0,2020-10-01,-109,-185,76
"Augusta-Waterville, ME",12300.0,2020-11-01,-63,-113,50
"Augusta-Waterville, ME",12300.0,2020-12-01,-52,-54,2
"Dover, DE",20100.0,2019-01-01,81,-11,92
"Dover, DE",20100.0,2019-02-01,130,0,130
"Dover, DE",20100.0,2019-03-01,45,0,45
"Dover, DE",20100.0,2019-04-01,96,0,96
"Dover, DE",20100.0,2019-05-01,50,0,50
"Dover, DE",20100.0,2019-06-01,41,0,41
"Dover, DE",20100.0,2019-07-01,147,0,147
"Dover, DE",20100.0,2019-08-01,142,1,141
"Dover, DE",20100.0,2019-09-01,67,0,67
"Dover, DE",20100.0,2019-10-01,97,0,97
"Dover, DE",20100.0,2019-11-01,119,0,119
"Dover, DE",20100.0,2019-12-01,63,0,63
"Dover, DE",20100.0,2020-01-01,42,-1,43
"Dover, DE",20100.0,2020-02-01,57,0,57
"Dover, DE",20100.0,2020-03-01,49,-30,79
"Dover, DE",20100.0,2020-04-01,78,14,64
"Dover, DE",20100.0,2020-05-01,54,0,54
"Dover, DE",20100.0,2020-06-01,82,0,82
"Dover, DE",20100.0,2020-07-01,26,0,26
"Dover, DE",20100.0,2020-08-01,79,0,79
"Dover, DE",20100.0,2020-09-01,64,0,64
"Dover, DE",20100.0,2020-10-01,20,0,20
"Dover, DE",20100.0,2020-11-01,102,0,102
"Dover, DE",20100.0,2020-12-01,56,-11,67
"Bakersfield, CA",12540.0,2019-01-01,257,-13,270
"Bakersfield, CA",12540.0,2019-02-01,131,-26,157
"Bakersfield, CA",12540.0,2019-03-01,157,-15,172
"Bakersfield, CA",12540.0,2019-04-01,261,4,257
"Bakersfield, CA",12540.0,2019-05-01,228,-18,246
"Bakersfield, CA",12540.0,2019-06-01,228,2,226
"Bakersfield, CA",12540.0,2019-07-01,158,-1,159
"Bakersfield, CA",12540.0,2019-08-01,299,6,293
"Bakersfield, CA",12540.0,2019-09-01,188,15,173
"Bakersfield, CA",12540.0,2019-10-01,192,11,181
"Bakersfield, CA",12540.0,2019-11-01,287,-9,296
"Bakersfield, CA",12540.0,2019-12-01,12,-16,28
"Bakersfield, CA",12540.0,2020-01-01,185,-11,196
"Bakersfield, CA",12540.0,2020-02-01,156,-1,157
"Bakersfield, CA",12540.0,2020-03-01,284,36,248
"Bakersfield, CA",12540.0,2020-04-01,330,0,330
"Bakersfield, CA",12540.0,2020-05-01,396,22,374
"Bakersfield, CA",12540.0,2020-06-01,394,13,381
"Bakersfield, CA",12540.0,2020-07-01,288,20,268
"Bakersfield, CA",12540.0,2020-08-01,236,25,211
"Bakersfield, CA",12540.0,2020-09-01,288,-5,293
"Bakersfield, CA",12540.0,2020-10-01,232,30,202
"Bakersfield, CA",12540.0,2020-11-01,215,17,198
"Bakersfield, CA",12540.0,2020-12-01,316,13,303
"Kerrville, TX",28500.0,2019-01-01,4,0,4
"Kerrville, TX",28500.0,2019-02-01,20,0,20
"Kerrville, TX",28500.0,2019-03-01,14,0,14
"Kerrville, TX",28500.0,2019-04-01,37,0,37
"Kerrville, TX",28500.0,2019-05-01,7,0,7
"Kerrville, TX",28500.0,2019-06-01,26,0,26
"Kerrville, TX",28500.0,2019-07-01,34,0,34
"Kerrville, TX",28500.0,2019-08-01,-17,0,-17
"Kerrville, TX",28500.0,2019-09-01,11,0,11
"Kerrville, TX",28500.0,2019-10-01,8,0,8
"Kerrville, TX",28500.0,2019-11-01,23,0,23
"Kerrville, TX",28500.0,2019-12-01,29,0,29
"Kerrville, TX",28500.0,2020-01-01,-30,0,-30
"Kerrville, TX",28500.0,2020-02-01,22,0,22
"Kerrville, TX",28500.0,2020-03-01,40,0,40
"Kerrville, TX",28500.0,2020-04-01,34,0,34
"Kerrville, TX",28500.0,2020-05-01,-11,0,-11
"Kerrville, TX",28500.0,2020-06-01,-12,0,-12
"Kerrville, TX",28500.0,2020-07-01,34,0,34
"Kerrville, TX",28500.0,2020-08-01,5,0,5
"Kerrville, TX",28500.0,2020-09-01,39,0,39
"Kerrville, TX",28500.0,2020-10-01,24,0,24
"Kerrville, TX",28500.0,2020-11-01,-9,0,-9
"Kerrville, TX",28500.0,2020-12-01,6,0,6
"Ketchikan, AK",28540.0,2019-01-01,0,0,0
"Ketchikan, AK",28540.0,2019-02-01,0,0,0
"Ketchikan, AK",28540.0,2019-03-01,0,0,0
"Ketchikan, AK",28540.0,2019-04-01,11,11,0
"Ketchikan, AK",28540.0,2019-05-01,0,0,0
"Ketchikan, AK",28540.0,2019-06-01,0,0,0
"Ketchikan, AK",28540.0,2019-07-01,0,0,0
"Ketchikan, AK",28540.0,2019-08-01,0,0,0
"Ketchikan, AK",28540.0,2019-09-01,0,0,0
"Ketchikan, AK",28540.0,2019-10-01,0,0,0
"Ketchikan, AK",28540.0,2019-11-01,0,0,0
"Ketchikan, AK",28540.0,2019-12-01,0,0,0
"Ketchikan, AK",28540.0,2020-01-01,0,0,0
"Ketchikan, AK",28540.0,2020-02-01,0,0,0
"Ketchikan, AK",28540.0,2020-03-01,0,0,0
"Ketchikan, AK",28540.0,2020-04-01,0,0,0
"Ketchikan, AK",28540.0,2020-05-01,0,0,0
"Ketchikan, AK",28540.0,2020-06-01,0,0,0
"Ketchikan, AK",28540.0,2020-07-01,0,0,0
"Ketchikan, AK",28540.0,2020-08-01,0,0,0
"Ketchikan, AK",28540.0,2020-09-01,0,0,0
"Ketchikan, AK",28540.0,2020-10-01,0,0,0
"Ketchikan, AK",28540.0,2020-11-01,0,0,0
"Ketchikan, AK",28540.0,2020-12-01,0,0,0
"Seattle-Tacoma-Bellevue, WA",42660.0,2019-01-01,-891,-1639,748
"Seattle-Tacoma-Bellevue, WA",42660.0,2019-02-01,283,-350,633
"Seattle-Tacoma-Bellevue, WA",42660.0,2019-03-01,600,-48,648
"Seattle-Tacoma-Bellevue, WA",42660.0,2019-04-01,1873,1170,703
"Seattle-Tacoma-Bellevue, WA",42660.0,2019-05-01,3519,2009,1510
"Seattle-Tacoma-Bellevue, WA",42660.0,2019-06-01,2106,847,1259
"Seattle-Tacoma-Bellevue, WA",42660.0,2019-07-01,1101,252,849
"Seattle-Tacoma-Bellevue, WA",42660.0,2019-08-01,764,56,708
"Seattle-Tacoma-Bellevue, WA",42660.0,2019-09-01,103,-484,587
"Seattle-Tacoma-Bellevue, WA",42660.0,2019-10-01,-2003,-2111,108
"Seattle-Tacoma-Bellevue, WA",42660.0,2019-11-01,-489,-862,373
"Seattle-Tacoma-Bellevue, WA",42660.0,2019-12-01,-411,-1065,654
"Seattle-Tacoma-Bellevue, WA",42660.0,2020-01-01,-720,-1380,660
"Seattle-Tacoma-Bellevue, WA",42660.0,2020-02-01,506,-379,885
"Seattle-Tacoma-Bellevue, WA",42660.0,2020-03-01,-1755,-1138,-617
"Seattle-Tacoma-Bellevue, WA",42660.0,2020-04-01,-1481,-775,-706
"Seattle-Tacoma-Bellevue, WA",42660.0,2020-05-01,1144,974,170
"Seattle-Tacoma-Bellevue, WA",42660.0,2020-06-01,527,775,-248
"Seattle-Tacoma-Bellevue, WA",42660.0,2020-07-01,-1227,75,-1302
"Seattle-Tacoma-Bellevue, WA",42660.0,2020-08-01,-1915,-121,-1794
"Seattle-Tacoma-Bellevue, WA",42660.0,2020-09-01,-2801,-653,-2148
"Seattle-Tacoma-Bellevue, WA",42660.0,2020-10-01,-4259,-2477,-1782
"Seattle-Tacoma-Bellevue, WA",42660.0,2020-11-01,-2905,-1648,-1257
"Seattle-Tacoma-Bellevue, WA",42660.0,2020-12-01,-1895,-1137,-758
"Hanford-Corcoran, CA",25260.0,2019-01-01,-12,0,-12
"Hanford-Corcoran, CA",25260.0,2019-02-01,45,0,45
"Hanford-Corcoran, CA",25260.0,2019-03-01,6,0,6
"Hanford-Corcoran, CA",25260.0,2019-04-01,-7,0,-7
"Hanford-Corcoran, CA",25260.0,2019-05-01,0,0,0
"Hanford-Corcoran, CA",25260.0,2019-06-01,48,0,48
"Hanford-Corcoran, CA",25260.0,2019-07-01,3,0,3
"Hanford-Corcoran, CA",25260.0,2019-08-01,-31,0,-31
"Hanford-Corcoran, CA",25260.0,2019-09-01,-8,0,-8
"Hanford-Corcoran, CA",25260.0,2019-10-01,-45,0,-45
"Hanford-Corcoran, CA",25260.0,2019-11-01,-32,0,-32
"Hanford-Corcoran, CA",25260.0,2019-12-01,-19,0,-19
"Hanford-Corcoran, CA",25260.0,2020-01-01,3,0,3
"Hanford-Corcoran, CA",25260.0,2020-02-01,-24,0,-24
"Hanford-Corcoran, CA",25260.0,2020-03-01,0,0,0
"Hanford-Corcoran, CA",25260.0,2020-04-01,37,0,37
"Hanford-Corcoran, CA",25260.0,2020-05-01,-32,0,-32
"Hanford-Corcoran, CA",25260.0,2020-06-01,-29,0,-29
"Hanford-Corcoran, CA",25260.0,2020-07-01,-18,0,-18
"Hanford-Corcoran, CA",25260.0,2020-08-01,9,0,9
"Hanford-Corcoran, CA",25260.0,2020-09-01,-8,0,-8
"Hanford-Corcoran, CA",25260.0,2020-10-01,-22,0,-22
"Hanford-Corcoran, CA",25260.0,2020-11-01,-23,0,-23
"Hanford-Corcoran, CA",25260.0,2020-12-01,-15,0,-15
"Bremerton-Silverdale-Port Orchard, WA",14740.0,2019-01-01,104,-137,241
"Bremerton-Silverdale-Port Orchard, WA",14740.0,2019-02-01,69,-26,95
"Bremerton-Silverdale-Port Orchard, WA",14740.0,2019-03-01,105,0,105
"Bremerton-Silverdale-Port Orchard, WA",14740.0,2019-04-01,339,143,196
"Bremerton-Silverdale-Port Orchard, WA",14740.0,2019-05-01,332,135,197
"Bremerton-Silverdale-Port Orchard, WA",14740.0,2019-06-01,232,63,169
"Bremerton-Silverdale-Port Orchard, WA",14740.0,2019-07-01,-43,0,-43
"Bremerton-Silverdale-Port Orchard, WA",14740.0,2019-08-01,95,0,95
"Bremerton-Silverdale-Port Orchard, WA",14740.0,2019-09-01,-158,-70,-88
"Bremerton-Silverdale-Port Orchard, WA",14740.0,2019-10-01,-320,-284,-36
"Bremerton-Silverdale-Port Orchard, WA",14740.0,2019-11-01,-141,-144,3
"Bremerton-Silverdale-Port Orchard, WA",14740.0,2019-12-01,-50,-111,61
"Bremerton-Silverdale-Port Orchard, WA",14740.0,2020-01-01,-162,-138,-24
"Bremerton-Silverdale-Port Orchard, WA",14740.0,2020-02-01,-11,-22,11
"Bremerton-Silverdale-Port Orchard, WA",14740.0,2020-03-01,175,43,132
"Bremerton-Silverdale-Port Orchard, WA",14740.0,2020-04-01,181,46,135
"Bremerton-Silverdale-Port Orchard, WA",14740.0,2020-05-01,240,149,91
"Bremerton-Silverdale-Port Orchard, WA",14740.0,2020-06-01,292,113,179
"Bremerton-Silverdale-Port Orchard, WA",14740.0,2020-07-01,-2,6,-8
"Bremerton-Silverdale-Port Orchard, WA",14740.0,2020-08-01,1,-32,33
"Bremerton-Silverdale-Port Orchard, WA",14740.0,2020-09-01,-30,-48,18
"Bremerton-Silverdale-Port Orchard, WA",14740.0,2020-10-01,-73,-222,149
"Bremerton-Silverdale-Port Orchard, WA",14740.0,2020-11-01,149,-110,259
"Bremerton-Silverdale-Port Orchard, WA",14740.0,2020-12-01,119,-92,211
"Ellensburg, WA",21260.0,2019-01-01,-41,-14,-27
"Ellensburg, WA",21260.0,2019-02-01,-25,0,-25
"Ellensburg, WA",21260.0,2019-03-01,-12,0,-12
"Ellensburg, WA",21260.0,2019-04-01,64,46,18
"Ellensburg, WA",21260.0,2019-05-01,91,25,66
"Ellensburg, WA",21260.0,2019-06-01,-59,0,-59
"Ellensburg, WA",21260.0,2019-07-01,-35,0,-35
"Ellensburg, WA",21260.0,2019-08-01,-43,0,-43
"Ellensburg, WA",21260.0,2019-09-01,69,0,69
"Ellensburg, WA",21260.0,2019-10-01,-30,-76,46
"Ellensburg, WA",21260.0,2019-11-01,28,-29,57
"Ellensburg, WA",21260.0,2019-12-01,10,-24,34
"Ellensburg, WA",21260.0,2020-01-01,13,-20,33
"Ellensburg, WA",21260.0,2020-02-01,27,0,27
"Ellensburg, WA",21260.0,2020-03-01,39,22,17
"Ellensburg, WA",21260.0,2020-04-01,49,-11,60
"Ellensburg, WA",21260.0,2020-05-01,87,49,38
"Ellensburg, WA",21260.0,2020-06-01,20,0,20
"Ellensburg, WA",21260.0,2020-07-01,0,0,0
"Ellensburg, WA",21260.0,2020-08-01,11,0,11
"Ellensburg, WA",21260.0,2020-09-01,142,0,142
"Ellensburg, WA",21260.0,2020-10-01,-25,-94,69
"Ellensburg, WA",21260.0,2020-11-01,-8,-51,43
"Ellensburg, WA",21260.0,2020-12-01,5,-18,23
"Klamath Falls, OR",28900.0,2019-01-01,-25,0,-25
"Klamath Falls, OR",28900.0,2019-02-01,-1,0,-1
"Klamath Falls, OR",28900.0,2019-03-01,-21,0,-21
"Klamath Falls, OR",28900.0,2019-04-01,23,0,23
"Klamath Falls, OR",28900.0,2019-05-01,54,12,42
"Klamath Falls, OR",28900.0,2019-06-01,-24,0,-24
"Klamath Falls, OR",28900.0,2019-07-01,-10,0,-10
"Klamath Falls, OR",28900.0,2019-08-01,-31,0,-31
"Klamath Falls, OR",28900.0,2019-09-01,17,0,17
"Klamath Falls, OR",28900.0,2019-10-01,-17,-15,-2
"Klamath Falls, OR",28900.0,2019-11-01,-25,0,-25
"Klamath Falls, OR",28900.0,2019-12-01,-28,-14,-14
"Klamath Falls, OR",28900.0,2020-01-01,-35,0,-35
"Klamath Falls, OR",28900.0,2020-02-01,-15,0,-15
"Klamath Falls, OR",28900.0,2020-03-01,5,0,5
"Klamath Falls, OR",28900.0,2020-04-01,-21,0,-21
"Klamath Falls, OR",28900.0,2020-05-01,25,0,25
"Klamath Falls, OR",28900.0,2020-06-01,11,0,11
"Klamath Falls, OR",28900.0,2020-07-01,44,0,44
"Klamath Falls, OR",28900.0,2020-08-01,37,0,37
"Klamath Falls, OR",28900.0,2020-09-01,42,0,42
"Klamath Falls, OR",28900.0,2020-10-01,11,-12,23
"Klamath Falls, OR",28900.0,2020-11-01,42,0,42
"Klamath Falls, OR",28900.0,2020-12-01,3,0,3
"Kingsville, TX",28780.0,2019-01-01,7,0,7
"Kingsville, TX",28780.0,2019-02-01,3,0,3
"Kingsville, TX",28780.0,2019-03-01,-7,0,-7
"Kingsville, TX",28780.0,2019-04-01,-14,0,-14
"Kingsville, TX",28780.0,2019-05-01,-8,0,-8
"Kingsville, TX",28780.0,2019-06-01,-1,0,-1
"Kingsville, TX",28780.0,2019-07-01,-30,0,-30
"Kingsville, TX",28780.0,2019-08-01,-9,0,-9
"Kingsville, TX",28780.0,2019-09-01,-9,0,-9
"Kingsville, TX",28780.0,2019-10-01,-4,0,-4
"Kingsville, TX",28780.0,2019-11-01,6,0,6
"Kingsville, TX",28780.0,2019-12-01,0,0,0
"Kingsville, TX",28780.0,2020-01-01,-2,0,-2
"Kingsville, TX",28780.0,2020-02-01,-1,0,-1
"Kingsville, TX",28780.0,2020-03-01,-14,0,-14
"Kingsville, TX",28780.0,2020-04-01,-3,0,-3
"Kingsville, TX",28780.0,2020-05-01,-2,0,-2
"Kingsville, TX",28780.0,2020-06-01,-7,0,-7
"Kingsville, TX",28780.0,2020-07-01,9,0,9
"Kingsville, TX",28780.0,2020-08-01,12,0,12
"Kingsville, TX",28780.0,2020-09-01,-6,0,-6
"Kingsville, TX",28780.0,2020-10-01,-10,0,-10
"Kingsville, TX",28780.0,2020-11-01,-5,0,-5
"Kingsville, TX",28780.0,2020-12-01,-1,0,-1
"Galesburg, IL",23660.0,2019-01-01,26,0,26
"Galesburg, IL",23660.0,2019-02-01,-14,0,-14
"Galesburg, IL",23660.0,2019-03-01,-3,0,-3
"Galesburg, IL",23660.0,2019-04-01,9,0,9
"Galesburg, IL",23660.0,2019-05-01,-18,0,-18
"Galesburg, IL",23660.0,2019-06-01,21,0,21
"Galesburg, IL",23660.0,2019-07-01,15,0,15
"Galesburg, IL",23660.0,2019-08-01,-8,0,-8
"Galesburg, IL",23660.0,2019-09-01,-15,0,-15
"Galesburg, IL",23660.0,2019-10-01,-2,0,-2
"Galesburg, IL",23660.0,2019-11-01,-14,0,-14
"Galesburg, IL",23660.0,2019-12-01,-13,0,-13
"Galesburg, IL",23660.0,2020-01-01,13,-11,24
"Galesburg, IL",23660.0,2020-02-01,22,0,22
"Galesburg, IL",23660.0,2020-03-01,-10,0,-10
"Galesburg, IL",23660.0,2020-04-01,-32,0,-32
"Galesburg, IL",23660.0,2020-05-01,-19,0,-19
"Galesburg, IL",23660.0,2020-06-01,-18,0,-18
"Galesburg, IL",23660.0,2020-07-01,-38,0,-38
"Galesburg, IL",23660.0,2020-08-01,-11,0,-11
"Galesburg, IL",23660.0,2020-09-01,-26,0,-26
"Galesburg, IL",23660.0,2020-10-01,11,0,11
"Galesburg, IL",23660.0,2020-11-01,-11,0,-11
"Galesburg, IL",23660.0,2020-12-01,25,0,25
"Vincennes, IN",47180.0,2019-01-01,15,0,15
"Vincennes, IN",47180.0,2019-02-01,3,0,3
"Vincennes, IN",47180.0,2019-03-01,16,0,16
"Vincennes, IN",47180.0,2019-04-01,14,0,14
"Vincennes, IN",47180.0,2019-05-01,-8,0,-8
"Vincennes, IN",47180.0,2019-06-01,-1,0,-1
"Vincennes, IN",47180.0,2019-07-01,-36,0,-36
"Vincennes, IN",47180.0,2019-08-01,8,0,8
"Vincennes, IN",47180.0,2019-09-01,6,0,6
"Vincennes, IN",47180.0,2019-10-01,14,0,14
"Vincennes, IN",47180.0,2019-11-01,1,0,1
"Vincennes, IN",47180.0,2019-12-01,2,0,2
"Vincennes, IN",47180.0,2020-01-01,4,0,4
"Vincennes, IN",47180.0,2020-02-01,-12,0,-12
"Vincennes, IN",47180.0,2020-03-01,16,0,16
"Vincennes, IN",47180.0,2020-04-01,-36,0,-36
"Vincennes, IN",47180.0,2020-05-01,-12,0,-12
"Vincennes, IN",47180.0,2020-06-01,27,0,27
"Vincennes, IN",47180.0,2020-07-01,-3,0,-3
"Vincennes, IN",47180.0,2020-08-01,-32,0,-32
"Vincennes, IN",47180.0,2020-09-01,10,0,10
"Vincennes, IN",47180.0,2020-10-01,-6,0,-6
"Vincennes, IN",47180.0,2020-11-01,5,0,5
"Vincennes, IN",47180.0,2020-12-01,-13,0,-13
"Mount Vernon, OH",34540.0,2019-01-01,47,0,47
"Mount Vernon, OH",34540.0,2019-02-01,13,0,13
"Mount Vernon, OH",34540.0,2019-03-01,6,0,6
"Mount Vernon, OH",34540.0,2019-04-01,2,0,2
"Mount Vernon, OH",34540.0,2019-05-01,-816,-820,4
"Mount Vernon, OH",34540.0,2019-06-01,29,0,29
"Mount Vernon, OH",34540.0,2019-07-01,33,0,33
"Mount Vernon, OH",34540.0,2019-08-01,33,0,33
"Mount Vernon, OH",34540.0,2019-09-01,64,0,64
"Mount Vernon, OH",34540.0,2019-10-01,24,-14,38
"Mount Vernon, OH",34540.0,2019-11-01,-12,-11,-1
"Mount Vernon, OH",34540.0,2019-12-01,21,0,21
"Mount Vernon, OH",34540.0,2020-01-01,-2,-24,22
"Mount Vernon, OH",34540.0,2020-02-01,1,0,1
"Mount Vernon, OH",34540.0,2020-03-01,-734,-777,43
"Mount Vernon, OH",34540.0,2020-04-01,48,0,48
"Mount Vernon, OH",34540.0,2020-05-01,34,0,34
"Mount Vernon, OH",34540.0,2020-06-01,33,0,33
"Mount Vernon, OH",34540.0,2020-07-01,25,0,25
"Mount Vernon, OH",34540.0,2020-08-01,12,0,12
"Mount Vernon, OH",34540.0,2020-09-01,45,0,45
"Mount Vernon, OH",34540.0,2020-10-01,10,0,10
"Mount Vernon, OH",34540.0,2020-11-01,-2,0,-2
"Mount Vernon, OH",34540.0,2020-12-01,-11,0,-11
"Coeur d'Alene, ID",17660.0,2019-01-01,66,-31,97
"Coeur d'Alene, ID",17660.0,2019-02-01,52,-16,68
"Coeur d'Alene, ID",17660.0,2019-03-01,119,-17,136
"Coeur d'Alene, ID",17660.0,2019-04-01,353,159,194
"Coeur d'Alene, ID",17660.0,2019-05-01,499,283,216
"Coeur d'Alene, ID",17660.0,2019-06-01,359,75,284
"Coeur d'Alene, ID",17660.0,2019-07-01,224,43,181
"Coeur d'Alene, ID",17660.0,2019-08-01,188,0,188
"Coeur d'Alene, ID",17660.0,2019-09-01,29,-50,79
"Coeur d'Alene, ID",17660.0,2019-10-01,-417,-433,16
"Coeur d'Alene, ID",17660.0,2019-11-01,-204,-258,54
"Coeur d'Alene, ID",17660.0,2019-12-01,-40,-115,75
"Coeur d'Alene, ID",17660.0,2020-01-01,2,-68,70
"Coeur d'Alene, ID",17660.0,2020-02-01,148,-16,164
"Coeur d'Alene, ID",17660.0,2020-03-01,236,23,213
"Coeur d'Alene, ID",17660.0,2020-04-01,380,107,273
"Coeur d'Alene, ID",17660.0,2020-05-01,531,256,275
"Coeur d'Alene, ID",17660.0,2020-06-01,387,116,271
"Coeur d'Alene, ID",17660.0,2020-07-01,286,36,250
"Coeur d'Alene, ID",17660.0,2020-08-01,369,0,369
"Coeur d'Alene, ID",17660.0,2020-09-01,329,-45,374
"Coeur d'Alene, ID",17660.0,2020-10-01,-103,-378,275
"Coeur d'Alene, ID",17660.0,2020-11-01,-52,-221,169
"Coeur d'Alene, ID",17660.0,2020-12-01,100,-79,179
"Warsaw, IN",47700.0,2019-01-01,-7,-36,29
"Warsaw, IN",47700.0,2019-02-01,4,0,4
"Warsaw, IN",47700.0,2019-03-01,75,13,62
"Warsaw, IN",47700.0,2019-04-01,153,92,61
"Warsaw, IN",47700.0,2019-05-01,14,57,-43
"Warsaw, IN",47700.0,2019-06-01,-37,0,-37
"Warsaw, IN",47700.0,2019-07-01,13,0,13
"Warsaw, IN",47700.0,2019-08-01,-58,0,-58
"Warsaw, IN",47700.0,2019-09-01,2,0,2
"Warsaw, IN",47700.0,2019-10-01,-100,-111,11
"Warsaw, IN",47700.0,2019-11-01,-121,-86,-35
"Warsaw, IN",47700.0,2019-12-01,-89,-76,-13
"Warsaw, IN",47700.0,2020-01-01,-22,-28,6
"Warsaw, IN",47700.0,2020-02-01,10,0,10
"Warsaw, IN",47700.0,2020-03-01,-1,0,-1
"Warsaw, IN",47700.0,2020-04-01,65,26,39
"Warsaw, IN",47700.0,2020-05-01,140,91,49
"Warsaw, IN",47700.0,2020-06-01,8,13,-5
"Warsaw, IN",47700.0,2020-07-01,31,0,31
"Warsaw, IN",47700.0,2020-08-01,52,0,52
"Warsaw, IN",47700.0,2020-09-01,-19,0,-19
"Warsaw, IN",47700.0,2020-10-01,-88,-94,6
"Warsaw, IN",47700.0,2020-11-01,-94,-89,-5
"Warsaw, IN",47700.0,2020-12-01,-54,-63,9
"Durango, CO",20420.0,2019-01-01,-16,-19,3
"Durango, CO",20420.0,2019-02-01,15,0,15
"Durango, CO",20420.0,2019-03-01,-10,-12,2
"Durango, CO",20420.0,2019-04-01,27,54,-27
"Durango, CO",20420.0,2019-05-01,110,132,-22
"Durango, CO",20420.0,2019-06-01,50,57,-7
"Durango, CO",20420.0,2019-07-01,-2,16,-18
"Durango, CO",20420.0,2019-08-01,2,0,2
"Durango, CO",20420.0,2019-09-01,-67,-12,-55
"Durango, CO",20420.0,2019-10-01,-147,-122,-25
"Durango, CO",20420.0,2019-11-01,-105,-77,-28
"Durango, CO",20420.0,2019-12-01,-75,-34,-41
"Durango, CO",20420.0,2020-01-01,-20,-11,-9
"Durango, CO",20420.0,2020-02-01,-15,-13,-2
"Durango, CO",20420.0,2020-03-01,-22,-13,-9
"Durango, CO",20420.0,2020-04-01,33,26,7
"Durango, CO",20420.0,2020-05-01,164,160,4
"Durango, CO",20420.0,2020-06-01,67,82,-15
"Durango, CO",20420.0,2020-07-01,58,34,24
"Durango, CO",20420.0,2020-08-01,10,0,10
"Durango, CO",20420.0,2020-09-01,-2,-13,11
"Durango, CO",20420.0,2020-10-01,-130,-104,-26
"Durango, CO",20420.0,2020-11-01,-78,-72,-6
"Durango, CO",20420.0,2020-12-01,3,-20,23
"Michigan City-La Porte, IN",33140.0,2019-01-01,-47,-16,-31
"Michigan City-La Porte, IN",33140.0,2019-02-01,-13,0,-13
"Michigan City-La Porte, IN",33140.0,2019-03-01,-1,0,-1
"Michigan City-La Porte, IN",33140.0,2019-04-01,85,27,58
"Michigan City-La Porte, IN",33140.0,2019-05-01,67,58,9
"Michigan City-La Porte, IN",33140.0,2019-06-01,71,0,71
"Michigan City-La Porte, IN",33140.0,2019-07-01,-10,0,-10
"Michigan City-La Porte, IN",33140.0,2019-08-01,73,0,73
"Michigan City-La Porte, IN",33140.0,2019-09-01,11,0,11
"Michigan City-La Porte, IN",33140.0,2019-10-01,-68,-74,6
"Michigan City-La Porte, IN",33140.0,2019-11-01,25,-17,42
"Michigan City-La Porte, IN",33140.0,2019-12-01,-31,-73,42
"Michigan City-La Porte, IN",33140.0,2020-01-01,0,-17,17
"Michigan City-La Porte, IN",33140.0,2020-02-01,63,0,63
"Michigan City-La Porte, IN",33140.0,2020-03-01,15,21,-6
"Michigan City-La Porte, IN",33140.0,2020-04-01,46,36,10
"Michigan City-La Porte, IN",33140.0,2020-05-01,71,41,30
"Michigan City-La Porte, IN",33140.0,2020-06-01,98,12,86
"Michigan City-La Porte, IN",33140.0,2020-07-01,10,0,10
"Michigan City-La Porte, IN",33140.0,2020-08-01,23,0,23
"Michigan City-La Porte, IN",33140.0,2020-09-01,111,0,111
"Michigan City-La Porte, IN",33140.0,2020-10-01,-17,-57,40
"Michigan City-La Porte, IN",33140.0,2020-11-01,21,-26,47
"Michigan City-La Porte, IN",33140.0,2020-12-01,-8,-37,29
"Parsons, KS",37660.0,2019-01-01,13,0,13
"Parsons, KS",37660.0,2019-02-01,0,0,0
"Parsons, KS",37660.0,2019-03-01,11,0,11
"Parsons, KS",37660.0,2019-04-01,0,0,0
"Parsons, KS",37660.0,2019-05-01,11,0,11
"Parsons, KS",37660.0,2019-06-01,0,0,0
"Parsons, KS",37660.0,2019-07-01,-11,0,-11
"Parsons, KS",37660.0,2019-08-01,12,0,12
"Parsons, KS",37660.0,2019-09-01,0,0,0
"Parsons, KS",37660.0,2019-10-01,0,0,0
"Parsons, KS",37660.0,2019-11-01,-7,0,-7
"Parsons, KS",37660.0,2019-12-01,0,0,0
"Parsons, KS",37660.0,2020-01-01,12,0,12
"Parsons, KS",37660.0,2020-02-01,-24,0,-24
"Parsons, KS",37660.0,2020-03-01,-26,0,-26
"Parsons, KS",37660.0,2020-04-01,0,0,0
"Parsons, KS",37660.0,2020-05-01,-12,0,-12
"Parsons, KS",37660.0,2020-06-01,0,0,0
"Parsons, KS",37660.0,2020-07-01,0,0,0
"Parsons, KS",37660.0,2020-08-01,-1,0,-1
"Parsons, KS",37660.0,2020-09-01,24,0,24
"Parsons, KS",37660.0,2020-10-01,0,0,0
"Parsons, KS",37660.0,2020-11-01,0,0,0
"Parsons, KS",37660.0,2020-12-01,0,0,0
"Scranton--Wilkes-Barre, PA",42540.0,2019-01-01,-115,-197,82
"Scranton--Wilkes-Barre, PA",42540.0,2019-02-01,-4,0,-4
"Scranton--Wilkes-Barre, PA",42540.0,2019-03-01,-5,0,-5
"Scranton--Wilkes-Barre, PA",42540.0,2019-04-01,226,65,161
"Scranton--Wilkes-Barre, PA",42540.0,2019-05-01,226,194,32
"Scranton--Wilkes-Barre, PA",42540.0,2019-06-01,36,36,0
"Scranton--Wilkes-Barre, PA",42540.0,2019-07-01,89,0,89
"Scranton--Wilkes-Barre, PA",42540.0,2019-08-01,165,0,165
"Scranton--Wilkes-Barre, PA",42540.0,2019-09-01,9,0,9
"Scranton--Wilkes-Barre, PA",42540.0,2019-10-01,-38,-114,76
"Scranton--Wilkes-Barre, PA",42540.0,2019-11-01,37,-13,50
"Scranton--Wilkes-Barre, PA",42540.0,2019-12-01,-266,-200,-66
"Scranton--Wilkes-Barre, PA",42540.0,2020-01-01,-131,-171,40
"Scranton--Wilkes-Barre, PA",42540.0,2020-02-01,65,0,65
"Scranton--Wilkes-Barre, PA",42540.0,2020-03-01,262,67,195
"Scranton--Wilkes-Barre, PA",42540.0,2020-04-01,165,33,132
"Scranton--Wilkes-Barre, PA",42540.0,2020-05-01,210,104,106
"Scranton--Wilkes-Barre, PA",42540.0,2020-06-01,245,115,130
"Scranton--Wilkes-Barre, PA",42540.0,2020-07-01,266,0,266
"Scranton--Wilkes-Barre, PA",42540.0,2020-08-01,96,0,96
"Scranton--Wilkes-Barre, PA",42540.0,2020-09-01,136,0,136
"Scranton--Wilkes-Barre, PA",42540.0,2020-10-01,-49,-95,46
"Scranton--Wilkes-Barre, PA",42540.0,2020-11-01,82,0,82
"Scranton--Wilkes-Barre, PA",42540.0,2020-12-01,-12,-87,75
"Lebanon, MO",30060.0,2019-01-01,-1,0,-1
"Lebanon, MO",30060.0,2019-02-01,-22,0,-22
"Lebanon, MO",30060.0,2019-03-01,-46,0,-46
"Lebanon, MO",30060.0,2019-04-01,-18,0,-18
"Lebanon, MO",30060.0,2019-05-01,-27,0,-27
"Lebanon, MO",30060.0,2019-06-01,14,0,14
"Lebanon, MO",30060.0,2019-07-01,39,0,39
"Lebanon, MO",30060.0,2019-08-01,41,0,41
"Lebanon, MO",30060.0,2019-09-01,-18,0,-18
"Lebanon, MO",30060.0,2019-10-01,1,0,1
"Lebanon, MO",30060.0,2019-11-01,11,0,11
"Lebanon, MO",30060.0,2019-12-01,24,0,24
"Lebanon, MO",30060.0,2020-01-01,6,0,6
"Lebanon, MO",30060.0,2020-02-01,7,0,7
"Lebanon, MO",30060.0,2020-03-01,-6,0,-6
"Lebanon, MO",30060.0,2020-04-01,20,0,20
"Lebanon, MO",30060.0,2020-05-01,-5,0,-5
"Lebanon, MO",30060.0,2020-06-01,7,0,7
"Lebanon, MO",30060.0,2020-07-01,4,0,4
"Lebanon, MO",30060.0,2020-08-01,-12,0,-12
"Lebanon, MO",30060.0,2020-09-01,27,0,27
"Lebanon, MO",30060.0,2020-10-01,15,0,15
"Lebanon, MO",30060.0,2020-11-01,27,0,27
"Lebanon, MO",30060.0,2020-12-01,-1,0,-1
"Oxford, MS",37060.0,2019-01-01,41,0,41
"Oxford, MS",37060.0,2019-02-01,31,0,31
"Oxford, MS",37060.0,2019-03-01,-5,0,-5
"Oxford, MS",37060.0,2019-04-01,0,0,0
"Oxford, MS",37060.0,2019-05-01,-23,0,-23
"Oxford, MS",37060.0,2019-06-01,-1,0,-1
"Oxford, MS",37060.0,2019-07-01,-90,0,-90
"Oxford, MS",37060.0,2019-08-01,5,0,5
"Oxford, MS",37060.0,2019-09-01,4,0,4
"Oxford, MS",37060.0,2019-10-01,0,0,0
"Oxford, MS",37060.0,2019-11-01,-11,0,-11
"Oxford, MS",37060.0,2019-12-01,11,0,11
"Oxford, MS",37060.0,2020-01-01,-14,0,-14
"Oxford, MS",37060.0,2020-02-01,-12,0,-12
"Oxford, MS",37060.0,2020-03-01,53,0,53
"Oxford, MS",37060.0,2020-04-01,12,0,12
"Oxford, MS",37060.0,2020-05-01,-20,0,-20
"Oxford, MS",37060.0,2020-06-01,-19,0,-19
"Oxford, MS",37060.0,2020-07-01,-98,0,-98
"Oxford, MS",37060.0,2020-08-01,5,0,5
"Oxford, MS",37060.0,2020-09-01,0,0,0
"Oxford, MS",37060.0,2020-10-01,13,0,13
"Oxford, MS",37060.0,2020-11-01,0,0,0
"Oxford, MS",37060.0,2020-12-01,-17,0,-17
"Houma-Thibodaux, LA",26380.0,2019-01-01,25,0,25
"Houma-Thibodaux, LA",26380.0,2019-02-01,-26,0,-26
"Houma-Thibodaux, LA",26380.0,2019-03-01,29,0,29
"Houma-Thibodaux, LA",26380.0,2019-04-01,0,0,0
"Houma-Thibodaux, LA",26380.0,2019-05-01,-27,0,-27
"Houma-Thibodaux, LA",26380.0,2019-06-01,-3,0,-3
"Houma-Thibodaux, LA",26380.0,2019-07-01,-10,0,-10
"Houma-Thibodaux, LA",26380.0,2019-08-01,-2,0,-2
"Houma-Thibodaux, LA",26380.0,2019-09-01,7,0,7
"Houma-Thibodaux, LA",26380.0,2019-10-01,-4,0,-4
"Houma-Thibodaux, LA",26380.0,2019-11-01,2,0,2
"Houma-Thibodaux, LA",26380.0,2019-12-01,-14,0,-14
"Houma-Thibodaux, LA",26380.0,2020-01-01,21,0,21
"Houma-Thibodaux, LA",26380.0,2020-02-01,3,0,3
"Houma-Thibodaux, LA",26380.0,2020-03-01,-43,-14,-29
"Houma-Thibodaux, LA",26380.0,2020-04-01,6,0,6
"Houma-Thibodaux, LA",26380.0,2020-05-01,1,0,1
"Houma-Thibodaux, LA",26380.0,2020-06-01,18,0,18
"Houma-Thibodaux, LA",26380.0,2020-07-01,-44,0,-44
"Houma-Thibodaux, LA",26380.0,2020-08-01,3,0,3
"Houma-Thibodaux, LA",26380.0,2020-09-01,12,0,12
"Houma-Thibodaux, LA",26380.0,2020-10-01,-15,0,-15
"Houma-Thibodaux, LA",26380.0,2020-11-01,29,0,29
"Houma-Thibodaux, LA",26380.0,2020-12-01,2,0,2
"Clearlake, CA",17340.0,2019-01-01,59,0,59
"Clearlake, CA",17340.0,2019-02-01,-3,0,-3
"Clearlake, CA",17340.0,2019-03-01,22,0,22
"Clearlake, CA",17340.0,2019-04-01,54,0,54
"Clearlake, CA",17340.0,2019-05-01,5,0,5
"Clearlake, CA",17340.0,2019-06-01,56,0,56
"Clearlake, CA",17340.0,2019-07-01,35,0,35
"Clearlake, CA",17340.0,2019-08-01,55,0,55
"Clearlake, CA",17340.0,2019-09-01,36,0,36
"Clearlake, CA",17340.0,2019-10-01,19,0,19
"Clearlake, CA",17340.0,2019-11-01,15,0,15
"Clearlake, CA",17340.0,2019-12-01,53,0,53
"Clearlake, CA",17340.0,2020-01-01,25,0,25
"Clearlake, CA",17340.0,2020-02-01,8,0,8
"Clearlake, CA",17340.0,2020-03-01,60,0,60
"Clearlake, CA",17340.0,2020-04-01,55,0,55
"Clearlake, CA",17340.0,2020-05-01,34,0,34
"Clearlake, CA",17340.0,2020-06-01,62,0,62
"Clearlake, CA",17340.0,2020-07-01,58,0,58
"Clearlake, CA",17340.0,2020-08-01,100,0,100
"Clearlake, CA",17340.0,2020-09-01,75,0,75
"Clearlake, CA",17340.0,2020-10-01,42,0,42
"Clearlake, CA",17340.0,2020-11-01,19,0,19
"Clearlake, CA",17340.0,2020-12-01,26,0,26
"Orlando-Kissimmee-Sanford, FL",36740.0,2019-01-01,504,680,-176
"Orlando-Kissimmee-Sanford, FL",36740.0,2019-02-01,-503,20,-523
"Orlando-Kissimmee-Sanford, FL",36740.0,2019-03-01,-476,-14,-462
"Orlando-Kissimmee-Sanford, FL",36740.0,2019-04-01,-1454,-870,-584
"Orlando-Kissimmee-Sanford, FL",36740.0,2019-05-01,-2109,-1382,-727
"Orlando-Kissimmee-Sanford, FL",36740.0,2019-06-01,-476,-243,-233
"Orlando-Kissimmee-Sanford, FL",36740.0,2019-07-01,-148,1,-149
"Orlando-Kissimmee-Sanford, FL",36740.0,2019-08-01,79,28,51
"Orlando-Kissimmee-Sanford, FL",36740.0,2019-09-01,-214,25,-239
"Orlando-Kissimmee-Sanford, FL",36740.0,2019-10-01,1245,1353,-108
"Orlando-Kissimmee-Sanford, FL",36740.0,2019-11-01,208,730,-522
"Orlando-Kissimmee-Sanford, FL",36740.0,2019-12-01,557,1109,-552
"Orlando-Kissimmee-Sanford, FL",36740.0,2020-01-01,367,766,-399
"Orlando-Kissimmee-Sanford, FL",36740.0,2020-02-01,-702,-27,-675
"Orlando-Kissimmee-Sanford, FL",36740.0,2020-03-01,-539,92,-631
"Orlando-Kissimmee-Sanford, FL",36740.0,2020-04-01,-906,-69,-837
"Orlando-Kissimmee-Sanford, FL",36740.0,2020-05-01,-1197,-600,-597
"Orlando-Kissimmee-Sanford, FL",36740.0,2020-06-01,-943,-455,-488
"Orlando-Kissimmee-Sanford, FL",36740.0,2020-07-01,-442,-81,-361
"Orlando-Kissimmee-Sanford, FL",36740.0,2020-08-01,-288,-20,-268
"Orlando-Kissimmee-Sanford, FL",36740.0,2020-09-01,-252,12,-264
"Orlando-Kissimmee-Sanford, FL",36740.0,2020-10-01,635,1092,-457
"Orlando-Kissimmee-Sanford, FL",36740.0,2020-11-01,302,689,-387
"Orlando-Kissimmee-Sanford, FL",36740.0,2020-12-01,305,771,-466
"Paris, TX",37580.0,2019-01-01,-8,0,-8
"Paris, TX",37580.0,2019-02-01,27,0,27
"Paris, TX",37580.0,2019-03-01,12,0,12
"Paris, TX",37580.0,2019-04-01,11,0,11
"Paris, TX",37580.0,2019-05-01,28,0,28
"Paris, TX",37580.0,2019-06-01,1,0,1
"Paris, TX",37580.0,2019-07-01,29,0,29
"Paris, TX",37580.0,2019-08-01,39,0,39
"Paris, TX",37580.0,2019-09-01,-12,0,-12
"Paris, TX",37580.0,2019-10-01,24,0,24
"Paris, TX",37580.0,2019-11-01,12,0,12
"Paris, TX",37580.0,2019-12-01,12,0,12
"Paris, TX",37580.0,2020-01-01,9,0,9
"Paris, TX",37580.0,2020-02-01,11,0,11
"Paris, TX",37580.0,2020-03-01,10,0,10
"Paris, TX",37580.0,2020-04-01,9,0,9
"Paris, TX",37580.0,2020-05-01,-14,0,-14
"Paris, TX",37580.0,2020-06-01,-11,0,-11
"Paris, TX",37580.0,2020-07-01,-8,0,-8
"Paris, TX",37580.0,2020-08-01,14,0,14
"Paris, TX",37580.0,2020-09-01,-13,0,-13
"Paris, TX",37580.0,2020-10-01,18,0,18
"Paris, TX",37580.0,2020-11-01,19,0,19
"Paris, TX",37580.0,2020-12-01,12,0,12
"Lincoln, NE",30700.0,2019-01-01,-107,-79,-28
"Lincoln, NE",30700.0,2019-02-01,-76,-12,-64
"Lincoln, NE",30700.0,2019-03-01,31,11,20
"Lincoln, NE",30700.0,2019-04-01,35,73,-38
"Lincoln, NE",30700.0,2019-05-01,-110,30,-140
"Lincoln, NE",30700.0,2019-06-01,-132,0,-132
"Lincoln, NE",30700.0,2019-07-01,-139,-11,-128
"Lincoln, NE",30700.0,2019-08-01,-104,11,-115
"Lincoln, NE",30700.0,2019-09-01,-65,0,-65
"Lincoln, NE",30700.0,2019-10-01,-138,-85,-53
"Lincoln, NE",30700.0,2019-11-01,-97,-68,-29
"Lincoln, NE",30700.0,2019-12-01,-200,-152,-48
"Lincoln, NE",30700.0,2020-01-01,-91,-72,-19
"Lincoln, NE",30700.0,2020-02-01,12,-12,24
"Lincoln, NE",30700.0,2020-03-01,67,18,49
"Lincoln, NE",30700.0,2020-04-01,-39,25,-64
"Lincoln, NE",30700.0,2020-05-01,-1,34,-35
"Lincoln, NE",30700.0,2020-06-01,-91,13,-104
"Lincoln, NE",30700.0,2020-07-01,-130,0,-130
"Lincoln, NE",30700.0,2020-08-01,-49,0,-49
"Lincoln, NE",30700.0,2020-09-01,-97,0,-97
"Lincoln, NE",30700.0,2020-10-01,-65,-55,-10
"Lincoln, NE",30700.0,2020-11-01,-87,-63,-24
"Lincoln, NE",30700.0,2020-12-01,-121,-96,-25
"Lancaster, PA",29540.0,2019-01-01,-192,-266,74
"Lancaster, PA",29540.0,2019-02-01,-4,-17,13
"Lancaster, PA",29540.0,2019-03-01,54,12,42
"Lancaster, PA",29540.0,2019-04-01,161,82,79
"Lancaster, PA",29540.0,2019-05-01,32,58,-26
"Lancaster, PA",29540.0,2019-06-01,76,-11,87
"Lancaster, PA",29540.0,2019-07-01,67,0,67
"Lancaster, PA",29540.0,2019-08-01,-46,0,-46
"Lancaster, PA",29540.0,2019-09-01,-11,0,-11
"Lancaster, PA",29540.0,2019-10-01,-122,-65,-57
"Lancaster, PA",29540.0,2019-11-01,2,-45,47
"Lancaster, PA",29540.0,2019-12-01,-312,-255,-57
"Lancaster, PA",29540.0,2020-01-01,-314,-260,-54
"Lancaster, PA",29540.0,2020-02-01,21,0,21
"Lancaster, PA",29540.0,2020-03-01,103,68,35
"Lancaster, PA",29540.0,2020-04-01,146,74,72
"Lancaster, PA",29540.0,2020-05-01,108,63,45
"Lancaster, PA",29540.0,2020-06-01,100,7,93
"Lancaster, PA",29540.0,2020-07-01,68,1,67
"Lancaster, PA",29540.0,2020-08-01,49,0,49
"Lancaster, PA",29540.0,2020-09-01,28,0,28
"Lancaster, PA",29540.0,2020-10-01,70,-37,107
"Lancaster, PA",29540.0,2020-11-01,-59,-69,10
"Lancaster, PA",29540.0,2020-12-01,-207,-181,-26
"Eugene-Springfield, OR",21660.0,2019-01-01,-36,-97,61
"Eugene-Springfield, OR",21660.0,2019-02-01,46,0,46
"Eugene-Springfield, OR",21660.0,2019-03-01,101,0,101
"Eugene-Springfield, OR",21660.0,2019-04-01,165,118,47
"Eugene-Springfield, OR",21660.0,2019-05-01,158,118,40
"Eugene-Springfield, OR",21660.0,2019-06-01,26,65,-39
"Eugene-Springfield, OR",21660.0,2019-07-01,-212,16,-228
"Eugene-Springfield, OR",21660.0,2019-08-01,-217,0,-217
"Eugene-Springfield, OR",21660.0,2019-09-01,-94,-29,-65
"Eugene-Springfield, OR",21660.0,2019-10-01,-234,-240,6
"Eugene-Springfield, OR",21660.0,2019-11-01,-135,-146,11
"Eugene-Springfield, OR",21660.0,2019-12-01,-178,-130,-48
"Eugene-Springfield, OR",21660.0,2020-01-01,-119,-89,-30
"Eugene-Springfield, OR",21660.0,2020-02-01,-27,0,-27
"Eugene-Springfield, OR",21660.0,2020-03-01,5,-29,34
"Eugene-Springfield, OR",21660.0,2020-04-01,94,34,60
"Eugene-Springfield, OR",21660.0,2020-05-01,113,114,-1
"Eugene-Springfield, OR",21660.0,2020-06-01,-18,95,-113
"Eugene-Springfield, OR",21660.0,2020-07-01,51,13,38
"Eugene-Springfield, OR",21660.0,2020-08-01,-45,0,-45
"Eugene-Springfield, OR",21660.0,2020-09-01,61,-57,118
"Eugene-Springfield, OR",21660.0,2020-10-01,-150,-197,47
"Eugene-Springfield, OR",21660.0,2020-11-01,-156,-125,-31
"Eugene-Springfield, OR",21660.0,2020-12-01,-52,-58,6
"Detroit-Warren-Dearborn, MI",19820.0,2019-01-01,-5033,-4793,-240
"Detroit-Warren-Dearborn, MI",19820.0,2019-02-01,-781,-717,-64
"Detroit-Warren-Dearborn, MI",19820.0,2019-03-01,622,6,616
"Detroit-Warren-Dearborn, MI",19820.0,2019-04-01,5444,3360,2084
"Detroit-Warren-Dearborn, MI",19820.0,2019-05-01,5034,4012,1022
"Detroit-Warren-Dearborn, MI",19820.0,2019-06-01,373,611,-238
"Detroit-Warren-Dearborn, MI",19820.0,2019-07-01,193,182,11
"Detroit-Warren-Dearborn, MI",19820.0,2019-08-01,-270,11,-281
"Detroit-Warren-Dearborn, MI",19820.0,2019-09-01,-891,-319,-572
"Detroit-Warren-Dearborn, MI",19820.0,2019-10-01,-4093,-3205,-888
"Detroit-Warren-Dearborn, MI",19820.0,2019-11-01,-3205,-2800,-405
"Detroit-Warren-Dearborn, MI",19820.0,2019-12-01,-5883,-5447,-436
"Detroit-Warren-Dearborn, MI",19820.0,2020-01-01,-4671,-4449,-222
"Detroit-Warren-Dearborn, MI",19820.0,2020-02-01,-624,-647,23
"Detroit-Warren-Dearborn, MI",19820.0,2020-03-01,1539,444,1095
"Detroit-Warren-Dearborn, MI",19820.0,2020-04-01,925,87,838
"Detroit-Warren-Dearborn, MI",19820.0,2020-05-01,3756,2585,1171
"Detroit-Warren-Dearborn, MI",19820.0,2020-06-01,2461,2155,306
"Detroit-Warren-Dearborn, MI",19820.0,2020-07-01,901,566,335
"Detroit-Warren-Dearborn, MI",19820.0,2020-08-01,39,215,-176
"Detroit-Warren-Dearborn, MI",19820.0,2020-09-01,-751,-152,-599
"Detroit-Warren-Dearborn, MI",19820.0,2020-10-01,-3966,-3074,-892
"Detroit-Warren-Dearborn, MI",19820.0,2020-11-01,-3627,-3024,-603
"Detroit-Warren-Dearborn, MI",19820.0,2020-12-01,-5039,-4491,-548
"Cheyenne, WY",16940.0,2019-01-01,56,0,56
"Cheyenne, WY",16940.0,2019-02-01,33,-12,45
"Cheyenne, WY",16940.0,2019-03-01,24,0,24
"Cheyenne, WY",16940.0,2019-04-01,60,18,42
"Cheyenne, WY",16940.0,2019-05-01,75,29,46
"Cheyenne, WY",16940.0,2019-06-01,-27,0,-27
"Cheyenne, WY",16940.0,2019-07-01,7,0,7
"Cheyenne, WY",16940.0,2019-08-01,14,0,14
"Cheyenne, WY",16940.0,2019-09-01,5,0,5
"Cheyenne, WY",16940.0,2019-10-01,6,-64,70
"Cheyenne, WY",16940.0,2019-11-01,-31,-24,-7
"Cheyenne, WY",16940.0,2019-12-01,10,-15,25
"Cheyenne, WY",16940.0,2020-01-01,62,0,62
"Cheyenne, WY",16940.0,2020-02-01,30,0,30
"Cheyenne, WY",16940.0,2020-03-01,8,0,8
"Cheyenne, WY",16940.0,2020-04-01,83,1,82
"Cheyenne, WY",16940.0,2020-05-01,100,19,81
"Cheyenne, WY",16940.0,2020-06-01,45,15,30
"Cheyenne, WY",16940.0,2020-07-01,56,0,56
"Cheyenne, WY",16940.0,2020-08-01,14,0,14
"Cheyenne, WY",16940.0,2020-09-01,42,0,42
"Cheyenne, WY",16940.0,2020-10-01,-50,-58,8
"Cheyenne, WY",16940.0,2020-11-01,-8,-39,31
"Cheyenne, WY",16940.0,2020-12-01,44,-12,56
"Fort Collins, CO",22660.0,2019-01-01,-220,-130,-90
"Fort Collins, CO",22660.0,2019-02-01,-106,-20,-86
"Fort Collins, CO",22660.0,2019-03-01,-73,-11,-62
"Fort Collins, CO",22660.0,2019-04-01,132,133,-1
"Fort Collins, CO",22660.0,2019-05-01,-7,238,-245
"Fort Collins, CO",22660.0,2019-06-01,-51,77,-128
"Fort Collins, CO",22660.0,2019-07-01,-432,-2,-430
"Fort Collins, CO",22660.0,2019-08-01,-155,2,-157
"Fort Collins, CO",22660.0,2019-09-01,-108,-28,-80
"Fort Collins, CO",22660.0,2019-10-01,-354,-195,-159
"Fort Collins, CO",22660.0,2019-11-01,-255,-165,-90
"Fort Collins, CO",22660.0,2019-12-01,-115,-102,-13
"Fort Collins, CO",22660.0,2020-01-01,-217,-99,-118
"Fort Collins, CO",22660.0,2020-02-01,-104,-12,-92
"Fort Collins, CO",22660.0,2020-03-01,55,51,4
"Fort Collins, CO",22660.0,2020-04-01,52,70,-18
"Fort Collins, CO",22660.0,2020-05-01,81,157,-76
"Fort Collins, CO",22660.0,2020-06-01,-82,94,-176
"Fort Collins, CO",22660.0,2020-07-01,-221,51,-272
"Fort Collins, CO",22660.0,2020-08-01,193,2,191
"Fort Collins, CO",22660.0,2020-09-01,73,-39,112
"Fort Collins, CO",22660.0,2020-10-01,-85,-252,167
"Fort Collins, CO",22660.0,2020-11-01,92,-91,183
"Fort Collins, CO",22660.0,2020-12-01,-42,-118,76
"Susanville, CA",45000.0,2019-01-01,0,0,0
"Susanville, CA",45000.0,2019-02-01,6,0,6
"Susanville, CA",45000.0,2019-03-01,22,0,22
"Susanville, CA",45000.0,2019-04-01,26,0,26
"Susanville, CA",45000.0,2019-05-01,51,24,27
"Susanville, CA",45000.0,2019-06-01,4,0,4
"Susanville, CA",45000.0,2019-07-01,-11,0,-11
"Susanville, CA",45000.0,2019-08-01,5,0,5
"Susanville, CA",45000.0,2019-09-01,-11,0,-11
"Susanville, CA",45000.0,2019-10-01,-25,-12,-13
"Susanville, CA",45000.0,2019-11-01,-6,0,-6
"Susanville, CA",45000.0,2019-12-01,12,0,12
"Susanville, CA",45000.0,2020-01-01,-14,0,-14
"Susanville, CA",45000.0,2020-02-01,0,0,0
"Susanville, CA",45000.0,2020-03-01,-27,0,-27
"Susanville, CA",45000.0,2020-04-01,-2,0,-2
"Susanville, CA",45000.0,2020-05-01,41,13,28
"Susanville, CA",45000.0,2020-06-01,1,13,-12
"Susanville, CA",45000.0,2020-07-01,0,0,0
"Susanville, CA",45000.0,2020-08-01,-14,0,-14
"Susanville, CA",45000.0,2020-09-01,0,0,0
"Susanville, CA",45000.0,2020-10-01,0,0,0
"Susanville, CA",45000.0,2020-11-01,0,0,0
"Susanville, CA",45000.0,2020-12-01,-1,0,-1
"Moscow, ID",34140.0,2019-01-01,-29,0,-29
"Moscow, ID",34140.0,2019-02-01,-26,0,-26
"Moscow, ID",34140.0,2019-03-01,-14,0,-14
"Moscow, ID",34140.0,2019-04-01,-7,0,-7
"Moscow, ID",34140.0,2019-05-01,-95,0,-95
"Moscow, ID",34140.0,2019-06-01,-40,0,-40
"Moscow, ID",34140.0,2019-07-01,-31,0,-31
"Moscow, ID",34140.0,2019-08-01,29,0,29
"Moscow, ID",34140.0,2019-09-01,46,0,46
"Moscow, ID",34140.0,2019-10-01,-15,0,-15
"Moscow, ID",34140.0,2019-11-01,3,0,3
"Moscow, ID",34140.0,2019-12-01,13,0,13
"Moscow, ID",34140.0,2020-01-01,0,0,0
"Moscow, ID",34140.0,2020-02-01,0,0,0
"Moscow, ID",34140.0,2020-03-01,-19,0,-19
"Moscow, ID",34140.0,2020-04-01,-35,0,-35
"Moscow, ID",34140.0,2020-05-01,-134,0,-134
"Moscow, ID",34140.0,2020-06-01,-29,0,-29
"Moscow, ID",34140.0,2020-07-01,-45,0,-45
"Moscow, ID",34140.0,2020-08-01,35,0,35
"Moscow, ID",34140.0,2020-09-01,2,0,2
"Moscow, ID",34140.0,2020-10-01,-15,0,-15
"Moscow, ID",34140.0,2020-11-01,14,0,14
"Moscow, ID",34140.0,2020-12-01,-17,0,-17
"Decatur, AL",19460.0,2019-01-01,16,0,16
"Decatur, AL",19460.0,2019-02-01,43,0,43
"Decatur, AL",19460.0,2019-03-01,8,0,8
"Decatur, AL",19460.0,2019-04-01,22,0,22
"Decatur, AL",19460.0,2019-05-01,53,0,53
"Decatur, AL",19460.0,2019-06-01,-14,0,-14
"Decatur, AL",19460.0,2019-07-01,-38,0,-38
"Decatur, AL",19460.0,2019-08-01,-22,0,-22
"Decatur, AL",19460.0,2019-09-01,-37,0,-37
"Decatur, AL",19460.0,2019-10-01,4,0,4
"Decatur, AL",19460.0,2019-11-01,15,0,15
"Decatur, AL",19460.0,2019-12-01,9,0,9
"Decatur, AL",19460.0,2020-01-01,-17,0,-17
"Decatur, AL",19460.0,2020-02-01,-4,0,-4
"Decatur, AL",19460.0,2020-03-01,9,0,9
"Decatur, AL",19460.0,2020-04-01,-6,0,-6
"Decatur, AL",19460.0,2020-05-01,31,0,31
"Decatur, AL",19460.0,2020-06-01,26,0,26
"Decatur, AL",19460.0,2020-07-01,-3,0,-3
"Decatur, AL",19460.0,2020-08-01,24,0,24
"Decatur, AL",19460.0,2020-09-01,26,0,26
"Decatur, AL",19460.0,2020-10-01,20,0,20
"Decatur, AL",19460.0,2020-11-01,39,0,39
"Decatur, AL",19460.0,2020-12-01,-2,0,-2
"Bedford, IN",13260.0,2019-01-01,-1,0,-1
"Bedford, IN",13260.0,2019-02-01,23,0,23
"Bedford, IN",13260.0,2019-03-01,8,0,8
"Bedford, IN",13260.0,2019-04-01,22,0,22
"Bedford, IN",13260.0,2019-05-01,2,0,2
"Bedford, IN",13260.0,2019-06-01,13,0,13
"Bedford, IN",13260.0,2019-07-01,11,0,11
"Bedford, IN",13260.0,2019-08-01,-11,0,-11
"Bedford, IN",13260.0,2019-09-01,10,0,10
"Bedford, IN",13260.0,2019-10-01,11,0,11
"Bedford, IN",13260.0,2019-11-01,23,0,23
"Bedford, IN",13260.0,2019-12-01,-16,0,-16
"Bedford, IN",13260.0,2020-01-01,23,0,23
"Bedford, IN",13260.0,2020-02-01,13,0,13
"Bedford, IN",13260.0,2020-03-01,-11,0,-11
"Bedford, IN",13260.0,2020-04-01,12,0,12
"Bedford, IN",13260.0,2020-05-01,26,0,26
"Bedford, IN",13260.0,2020-06-01,19,0,19
"Bedford, IN",13260.0,2020-07-01,37,0,37
"Bedford, IN",13260.0,2020-08-01,16,0,16
"Bedford, IN",13260.0,2020-09-01,22,0,22
"Bedford, IN",13260.0,2020-10-01,-9,0,-9
"Bedford, IN",13260.0,2020-11-01,40,0,40
"Bedford, IN",13260.0,2020-12-01,9,0,9
"New Castle, PA",35260.0,2019-01-01,-22,-30,8
"New Castle, PA",35260.0,2019-02-01,3,0,3
"New Castle, PA",35260.0,2019-03-01,41,0,41
"New Castle, PA",35260.0,2019-04-01,10,0,10
"New Castle, PA",35260.0,2019-05-01,23,0,23
"New Castle, PA",35260.0,2019-06-01,32,0,32
"New Castle, PA",35260.0,2019-07-01,23,0,23
"New Castle, PA",35260.0,2019-08-01,26,0,26
"New Castle, PA",35260.0,2019-09-01,-6,0,-6
"New Castle, PA",35260.0,2019-10-01,-41,-15,-26
"New Castle, PA",35260.0,2019-11-01,-2,0,-2
"New Castle, PA",35260.0,2019-12-01,39,0,39
"New Castle, PA",35260.0,2020-01-01,55,-21,76
"New Castle, PA",35260.0,2020-02-01,-1,0,-1
"New Castle, PA",35260.0,2020-03-01,14,0,14
"New Castle, PA",35260.0,2020-04-01,24,0,24
"New Castle, PA",35260.0,2020-05-01,-18,0,-18
"New Castle, PA",35260.0,2020-06-01,2,0,2
"New Castle, PA",35260.0,2020-07-01,81,0,81
"New Castle, PA",35260.0,2020-08-01,17,0,17
"New Castle, PA",35260.0,2020-09-01,9,0,9
"New Castle, PA",35260.0,2020-10-01,21,-15,36
"New Castle, PA",35260.0,2020-11-01,-23,-31,8
"New Castle, PA",35260.0,2020-12-01,2,0,2
"Spearfish, SD",43940.0,2019-01-01,-36,-14,-22
"Spearfish, SD",43940.0,2019-02-01,-7,0,-7
"Spearfish, SD",43940.0,2019-03-01,15,0,15
"Spearfish, SD",43940.0,2019-04-01,-13,12,-25
"Spearfish, SD",43940.0,2019-05-01,13,30,-17
"Spearfish, SD",43940.0,2019-06-01,14,17,-3
"Spearfish, SD",43940.0,2019-07-01,-40,0,-40
"Spearfish, SD",43940.0,2019-08-01,-14,0,-14
"Spearfish, SD",43940.0,2019-09-01,-7,0,-7
"Spearfish, SD",43940.0,2019-10-01,-49,-60,11
"Spearfish, SD",43940.0,2019-11-01,-17,-37,20
"Spearfish, SD",43940.0,2019-12-01,-29,-15,-14
"Spearfish, SD",43940.0,2020-01-01,-37,-23,-14
"Spearfish, SD",43940.0,2020-02-01,-11,0,-11
"Spearfish, SD",43940.0,2020-03-01,0,0,0
"Spearfish, SD",43940.0,2020-04-01,-33,0,-33
"Spearfish, SD",43940.0,2020-05-01,8,22,-14
"Spearfish, SD",43940.0,2020-06-01,6,15,-9
"Spearfish, SD",43940.0,2020-07-01,-22,0,-22
"Spearfish, SD",43940.0,2020-08-01,-2,0,-2
"Spearfish, SD",43940.0,2020-09-01,-25,0,-25
"Spearfish, SD",43940.0,2020-10-01,-71,-69,-2
"Spearfish, SD",43940.0,2020-11-01,-53,-25,-28
"Spearfish, SD",43940.0,2020-12-01,-21,-20,-1
"Lawrenceburg, TN",29980.0,2019-01-01,16,0,16
"Lawrenceburg, TN",29980.0,2019-02-01,-26,0,-26
"Lawrenceburg, TN",29980.0,2019-03-01,2,0,2
"Lawrenceburg, TN",29980.0,2019-04-01,5,0,5
"Lawrenceburg, TN",29980.0,2019-05-01,-10,0,-10
"Lawrenceburg, TN",29980.0,2019-06-01,24,0,24
"Lawrenceburg, TN",29980.0,2019-07-01,20,0,20
"Lawrenceburg, TN",29980.0,2019-08-01,9,0,9
"Lawrenceburg, TN",29980.0,2019-09-01,26,0,26
"Lawrenceburg, TN",29980.0,2019-10-01,-11,0,-11
"Lawrenceburg, TN",29980.0,2019-11-01,32,0,32
"Lawrenceburg, TN",29980.0,2019-12-01,-8,0,-8
"Lawrenceburg, TN",29980.0,2020-01-01,2,0,2
"Lawrenceburg, TN",29980.0,2020-02-01,11,0,11
"Lawrenceburg, TN",29980.0,2020-03-01,19,0,19
"Lawrenceburg, TN",29980.0,2020-04-01,-2,0,-2
"Lawrenceburg, TN",29980.0,2020-05-01,4,0,4
"Lawrenceburg, TN",29980.0,2020-06-01,27,0,27
"Lawrenceburg, TN",29980.0,2020-07-01,31,0,31
"Lawrenceburg, TN",29980.0,2020-08-01,34,0,34
"Lawrenceburg, TN",29980.0,2020-09-01,19,0,19
"Lawrenceburg, TN",29980.0,2020-10-01,2,0,2
"Lawrenceburg, TN",29980.0,2020-11-01,-1,0,-1
"Lawrenceburg, TN",29980.0,2020-12-01,37,0,37
"Hobbs, NM",26020.0,2019-01-01,0,0,0
"Hobbs, NM",26020.0,2019-02-01,-2,0,-2
"Hobbs, NM",26020.0,2019-03-01,0,0,0
"Hobbs, NM",26020.0,2019-04-01,-11,0,-11
"Hobbs, NM",26020.0,2019-05-01,0,0,0
"Hobbs, NM",26020.0,2019-06-01,1,0,1
"Hobbs, NM",26020.0,2019-07-01,-12,0,-12
"Hobbs, NM",26020.0,2019-08-01,-11,0,-11
"Hobbs, NM",26020.0,2019-09-01,-15,0,-15
"Hobbs, NM",26020.0,2019-10-01,15,0,15
"Hobbs, NM",26020.0,2019-11-01,11,0,11
"Hobbs, NM",26020.0,2019-12-01,-19,0,-19
"Hobbs, NM",26020.0,2020-01-01,-15,0,-15
"Hobbs, NM",26020.0,2020-02-01,0,0,0
"Hobbs, NM",26020.0,2020-03-01,0,0,0
"Hobbs, NM",26020.0,2020-04-01,-17,0,-17
"Hobbs, NM",26020.0,2020-05-01,-22,0,-22
"Hobbs, NM",26020.0,2020-06-01,-25,0,-25
"Hobbs, NM",26020.0,2020-07-01,-12,0,-12
"Hobbs, NM",26020.0,2020-08-01,-39,0,-39
"Hobbs, NM",26020.0,2020-09-01,-24,0,-24
"Hobbs, NM",26020.0,2020-10-01,-5,0,-5
"Hobbs, NM",26020.0,2020-11-01,0,0,0
"Hobbs, NM",26020.0,2020-12-01,0,0,0
"Lebanon, PA",30140.0,2019-01-01,-46,-14,-32
"Lebanon, PA",30140.0,2019-02-01,56,14,42
"Lebanon, PA",30140.0,2019-03-01,43,0,43
"Lebanon, PA",30140.0,2019-04-01,-19,0,-19
"Lebanon, PA",30140.0,2019-05-01,28,11,17
"Lebanon, PA",30140.0,2019-06-01,76,0,76
"Lebanon, PA",30140.0,2019-07-01,8,0,8
"Lebanon, PA",30140.0,2019-08-01,19,0,19
"Lebanon, PA",30140.0,2019-09-01,11,0,11
"Lebanon, PA",30140.0,2019-10-01,-19,0,-19
"Lebanon, PA",30140.0,2019-11-01,31,0,31
"Lebanon, PA",30140.0,2019-12-01,20,0,20
"Lebanon, PA",30140.0,2020-01-01,-14,0,-14
"Lebanon, PA",30140.0,2020-02-01,-18,0,-18
"Lebanon, PA",30140.0,2020-03-01,13,0,13
"Lebanon, PA",30140.0,2020-04-01,14,-14,28
"Lebanon, PA",30140.0,2020-05-01,-27,0,-27
"Lebanon, PA",30140.0,2020-06-01,-4,0,-4
"Lebanon, PA",30140.0,2020-07-01,34,0,34
"Lebanon, PA",30140.0,2020-08-01,6,0,6
"Lebanon, PA",30140.0,2020-09-01,-17,0,-17
"Lebanon, PA",30140.0,2020-10-01,-7,0,-7
"Lebanon, PA",30140.0,2020-11-01,11,0,11
"Lebanon, PA",30140.0,2020-12-01,15,-11,26
"Auburn-Opelika, AL",12220.0,2019-01-01,-25,0,-25
"Auburn-Opelika, AL",12220.0,2019-02-01,78,0,78
"Auburn-Opelika, AL",12220.0,2019-03-01,-25,0,-25
"Auburn-Opelika, AL",12220.0,2019-04-01,1,0,1
"Auburn-Opelika, AL",12220.0,2019-05-01,-117,0,-117
"Auburn-Opelika, AL",12220.0,2019-06-01,-14,0,-14
"Auburn-Opelika, AL",12220.0,2019-07-01,-224,0,-224
"Auburn-Opelika, AL",12220.0,2019-08-01,-6,0,-6
"Auburn-Opelika, AL",12220.0,2019-09-01,38,0,38
"Auburn-Opelika, AL",12220.0,2019-10-01,20,0,20
"Auburn-Opelika, AL",12220.0,2019-11-01,52,0,52
"Auburn-Opelika, AL",12220.0,2019-12-01,10,0,10
"Auburn-Opelika, AL",12220.0,2020-01-01,9,0,9
"Auburn-Opelika, AL",12220.0,2020-02-01,64,0,64
"Auburn-Opelika, AL",12220.0,2020-03-01,35,0,35
"Auburn-Opelika, AL",12220.0,2020-04-01,28,0,28
"Auburn-Opelika, AL",12220.0,2020-05-01,-60,0,-60
"Auburn-Opelika, AL",12220.0,2020-06-01,-53,0,-53
"Auburn-Opelika, AL",12220.0,2020-07-01,-148,0,-148
"Auburn-Opelika, AL",12220.0,2020-08-01,106,0,106
"Auburn-Opelika, AL",12220.0,2020-09-01,16,0,16
"Auburn-Opelika, AL",12220.0,2020-10-01,50,0,50
"Auburn-Opelika, AL",12220.0,2020-11-01,51,0,51
"Auburn-Opelika, AL",12220.0,2020-12-01,-9,0,-9
"Cape Coral-Fort Myers, FL",15980.0,2019-01-01,13193,12712,481
"Cape Coral-Fort Myers, FL",15980.0,2019-02-01,578,1569,-991
"Cape Coral-Fort Myers, FL",15980.0,2019-03-01,-1297,-147,-1150
"Cape Coral-Fort Myers, FL",15980.0,2019-04-01,-14482,-9960,-4522
"Cape Coral-Fort Myers, FL",15980.0,2019-05-01,-15529,-14447,-1082
"Cape Coral-Fort Myers, FL",15980.0,2019-06-01,-2568,-3085,517
"Cape Coral-Fort Myers, FL",15980.0,2019-07-01,90,-600,690
"Cape Coral-Fort Myers, FL",15980.0,2019-08-01,852,-125,977
"Cape Coral-Fort Myers, FL",15980.0,2019-09-01,2823,1394,1429
"Cape Coral-Fort Myers, FL",15980.0,2019-10-01,14336,12118,2218
"Cape Coral-Fort Myers, FL",15980.0,2019-11-01,6654,6022,632
"Cape Coral-Fort Myers, FL",15980.0,2019-12-01,13867,13303,564
"Cape Coral-Fort Myers, FL",15980.0,2020-01-01,12970,12505,465
"Cape Coral-Fort Myers, FL",15980.0,2020-02-01,1685,1470,215
"Cape Coral-Fort Myers, FL",15980.0,2020-03-01,-3304,-929,-2375
"Cape Coral-Fort Myers, FL",15980.0,2020-04-01,-4273,-2619,-1654
"Cape Coral-Fort Myers, FL",15980.0,2020-05-01,-10154,-9186,-968
"Cape Coral-Fort Myers, FL",15980.0,2020-06-01,-5988,-6252,264
"Cape Coral-Fort Myers, FL",15980.0,2020-07-01,-449,-1484,1035
"Cape Coral-Fort Myers, FL",15980.0,2020-08-01,1048,-386,1434
"Cape Coral-Fort Myers, FL",15980.0,2020-09-01,2418,808,1610
"Cape Coral-Fort Myers, FL",15980.0,2020-10-01,13743,11206,2537
"Cape Coral-Fort Myers, FL",15980.0,2020-11-01,8422,7282,1140
"Cape Coral-Fort Myers, FL",15980.0,2020-12-01,12942,11813,1129
"Dixon, IL",19940.0,2019-01-01,-21,0,-21
"Dixon, IL",19940.0,2019-02-01,-2,0,-2
"Dixon, IL",19940.0,2019-03-01,21,0,21
"Dixon, IL",19940.0,2019-04-01,-45,0,-45
"Dixon, IL",19940.0,2019-05-01,9,0,9
"Dixon, IL",19940.0,2019-06-01,-12,0,-12
"Dixon, IL",19940.0,2019-07-01,16,0,16
"Dixon, IL",19940.0,2019-08-01,-23,0,-23
"Dixon, IL",19940.0,2019-09-01,7,0,7
"Dixon, IL",19940.0,2019-10-01,-8,0,-8
"Dixon, IL",19940.0,2019-11-01,-27,-11,-16
"Dixon, IL",19940.0,2019-12-01,-3,0,-3
"Dixon, IL",19940.0,2020-01-01,-24,0,-24
"Dixon, IL",19940.0,2020-02-01,14,0,14
"Dixon, IL",19940.0,2020-03-01,-13,0,-13
"Dixon, IL",19940.0,2020-04-01,8,0,8
"Dixon, IL",19940.0,2020-05-01,6,0,6
"Dixon, IL",19940.0,2020-06-01,-12,0,-12
"Dixon, IL",19940.0,2020-07-01,19,0,19
"Dixon, IL",19940.0,2020-08-01,3,0,3
"Dixon, IL",19940.0,2020-09-01,-19,0,-19
"Dixon, IL",19940.0,2020-10-01,4,-13,17
"Dixon, IL",19940.0,2020-11-01,4,-13,17
"Dixon, IL",19940.0,2020-12-01,-24,0,-24
"Sanford, NC",41820.0,2019-01-01,17,0,17
"Sanford, NC",41820.0,2019-02-01,27,0,27
"Sanford, NC",41820.0,2019-03-01,-2,0,-2
"Sanford, NC",41820.0,2019-04-01,30,0,30
"Sanford, NC",41820.0,2019-05-01,36,0,36
"Sanford, NC",41820.0,2019-06-01,30,0,30
"Sanford, NC",41820.0,2019-07-01,1,0,1
"Sanford, NC",41820.0,2019-08-01,22,0,22
"Sanford, NC",41820.0,2019-09-01,9,0,9
"Sanford, NC",41820.0,2019-10-01,59,0,59
"Sanford, NC",41820.0,2019-11-01,18,0,18
"Sanford, NC",41820.0,2019-12-01,2,0,2
"Sanford, NC",41820.0,2020-01-01,23,0,23
"Sanford, NC",41820.0,2020-02-01,-6,0,-6
"Sanford, NC",41820.0,2020-03-01,35,0,35
"Sanford, NC",41820.0,2020-04-01,18,0,18
"Sanford, NC",41820.0,2020-05-01,11,0,11
"Sanford, NC",41820.0,2020-06-01,83,0,83
"Sanford, NC",41820.0,2020-07-01,35,0,35
"Sanford, NC",41820.0,2020-08-01,53,0,53
"Sanford, NC",41820.0,2020-09-01,43,0,43
"Sanford, NC",41820.0,2020-10-01,22,0,22
"Sanford, NC",41820.0,2020-11-01,32,0,32
"Sanford, NC",41820.0,2020-12-01,45,0,45
"Adrian, MI",10300.0,2019-01-01,-21,-55,34
"Adrian, MI",10300.0,2019-02-01,-3,0,-3
"Adrian, MI",10300.0,2019-03-01,10,0,10
"Adrian, MI",10300.0,2019-04-01,213,111,102
"Adrian, MI",10300.0,2019-05-01,74,61,13
"Adrian, MI",10300.0,2019-06-01,-3,0,-3
"Adrian, MI",10300.0,2019-07-01,-1,0,-1
"Adrian, MI",10300.0,2019-08-01,54,0,54
"Adrian, MI",10300.0,2019-09-01,12,0,12
"Adrian, MI",10300.0,2019-10-01,-187,-151,-36
"Adrian, MI",10300.0,2019-11-01,-129,-93,-36
"Adrian, MI",10300.0,2019-12-01,-110,-113,3
"Adrian, MI",10300.0,2020-01-01,-79,-50,-29
"Adrian, MI",10300.0,2020-02-01,6,0,6
"Adrian, MI",10300.0,2020-03-01,52,12,40
"Adrian, MI",10300.0,2020-04-01,3,15,-12
"Adrian, MI",10300.0,2020-05-01,80,37,43
"Adrian, MI",10300.0,2020-06-01,36,0,36
"Adrian, MI",10300.0,2020-07-01,18,0,18
"Adrian, MI",10300.0,2020-08-01,60,0,60
"Adrian, MI",10300.0,2020-09-01,47,0,47
"Adrian, MI",10300.0,2020-10-01,-46,-80,34
"Adrian, MI",10300.0,2020-11-01,-98,-86,-12
"Adrian, MI",10300.0,2020-12-01,2,-42,44
"Kinston, NC",28820.0,2019-01-01,-7,0,-7
"Kinston, NC",28820.0,2019-02-01,34,0,34
"Kinston, NC",28820.0,2019-03-01,27,0,27
"Kinston, NC",28820.0,2019-04-01,50,0,50
"Kinston, NC",28820.0,2019-05-01,23,0,23
"Kinston, NC",28820.0,2019-06-01,7,0,7
"Kinston, NC",28820.0,2019-07-01,5,0,5
"Kinston, NC",28820.0,2019-08-01,-8,0,-8
"Kinston, NC",28820.0,2019-09-01,-42,0,-42
"Kinston, NC",28820.0,2019-10-01,3,0,3
"Kinston, NC",28820.0,2019-11-01,-32,0,-32
"Kinston, NC",28820.0,2019-12-01,-9,0,-9
"Kinston, NC",28820.0,2020-01-01,-29,0,-29
"Kinston, NC",28820.0,2020-02-01,14,0,14
"Kinston, NC",28820.0,2020-03-01,-24,0,-24
"Kinston, NC",28820.0,2020-04-01,-10,0,-10
"Kinston, NC",28820.0,2020-05-01,22,0,22
"Kinston, NC",28820.0,2020-06-01,-11,0,-11
"Kinston, NC",28820.0,2020-07-01,6,0,6
"Kinston, NC",28820.0,2020-08-01,-3,0,-3
"Kinston, NC",28820.0,2020-09-01,19,0,19
"Kinston, NC",28820.0,2020-10-01,-15,0,-15
"Kinston, NC",28820.0,2020-11-01,23,0,23
"Kinston, NC",28820.0,2020-12-01,17,0,17
"Centralia, WA",16500.0,2019-01-01,30,-13,43
"Centralia, WA",16500.0,2019-02-01,41,0,41
"Centralia, WA",16500.0,2019-03-01,65,0,65
"Centralia, WA",16500.0,2019-04-01,96,12,84
"Centralia, WA",16500.0,2019-05-01,117,39,78
"Centralia, WA",16500.0,2019-06-01,132,0,132
"Centralia, WA",16500.0,2019-07-01,95,0,95
"Centralia, WA",16500.0,2019-08-01,115,0,115
"Centralia, WA",16500.0,2019-09-01,76,-14,90
"Centralia, WA",16500.0,2019-10-01,-26,-104,78
"Centralia, WA",16500.0,2019-11-01,30,-38,68
"Centralia, WA",16500.0,2019-12-01,29,-33,62
"Centralia, WA",16500.0,2020-01-01,33,-11,44
"Centralia, WA",16500.0,2020-02-01,65,0,65
"Centralia, WA",16500.0,2020-03-01,117,11,106
"Centralia, WA",16500.0,2020-04-01,90,0,90
"Centralia, WA",16500.0,2020-05-01,80,31,49
"Centralia, WA",16500.0,2020-06-01,93,0,93
"Centralia, WA",16500.0,2020-07-01,85,0,85
"Centralia, WA",16500.0,2020-08-01,145,0,145
"Centralia, WA",16500.0,2020-09-01,106,0,106
"Centralia, WA",16500.0,2020-10-01,39,-77,116
"Centralia, WA",16500.0,2020-11-01,65,-19,84
"Centralia, WA",16500.0,2020-12-01,56,-18,74
"Hinesville, GA",25980.0,2019-01-01,-3,0,-3
"Hinesville, GA",25980.0,2019-02-01,-8,0,-8
"Hinesville, GA",25980.0,2019-03-01,-38,0,-38
"Hinesville, GA",25980.0,2019-04-01,4,0,4
"Hinesville, GA",25980.0,2019-05-01,-11,0,-11
"Hinesville, GA",25980.0,2019-06-01,-12,0,-12
"Hinesville, GA",25980.0,2019-07-01,-51,0,-51
"Hinesville, GA",25980.0,2019-08-01,19,0,19
"Hinesville, GA",25980.0,2019-09-01,-42,0,-42
"Hinesville, GA",25980.0,2019-10-01,-65,0,-65
"Hinesville, GA",25980.0,2019-11-01,24,0,24
"Hinesville, GA",25980.0,2019-12-01,18,0,18
"Hinesville, GA",25980.0,2020-01-01,-5,0,-5
"Hinesville, GA",25980.0,2020-02-01,11,0,11
"Hinesville, GA",25980.0,2020-03-01,-35,0,-35
"Hinesville, GA",25980.0,2020-04-01,5,0,5
"Hinesville, GA",25980.0,2020-05-01,-29,0,-29
"Hinesville, GA",25980.0,2020-06-01,13,0,13
"Hinesville, GA",25980.0,2020-07-01,-36,0,-36
"Hinesville, GA",25980.0,2020-08-01,7,0,7
"Hinesville, GA",25980.0,2020-09-01,-22,0,-22
"Hinesville, GA",25980.0,2020-10-01,-12,0,-12
"Hinesville, GA",25980.0,2020-11-01,2,0,2
"Hinesville, GA",25980.0,2020-12-01,43,0,43
"Huntsville, AL",26620.0,2019-01-01,75,0,75
"Huntsville, AL",26620.0,2019-02-01,4,0,4
"Huntsville, AL",26620.0,2019-03-01,116,0,116
"Huntsville, AL",26620.0,2019-04-01,132,0,132
"Huntsville, AL",26620.0,2019-05-01,112,0,112
"Huntsville, AL",26620.0,2019-06-01,177,0,177
"Huntsville, AL",26620.0,2019-07-01,169,0,169
"Huntsville, AL",26620.0,2019-08-01,139,0,139
"Huntsville, AL",26620.0,2019-09-01,39,0,39
"Huntsville, AL",26620.0,2019-10-01,-28,0,-28
"Huntsville, AL",26620.0,2019-11-01,20,0,20
"Huntsville, AL",26620.0,2019-12-01,24,0,24
"Huntsville, AL",26620.0,2020-01-01,122,0,122
"Huntsville, AL",26620.0,2020-02-01,34,0,34
"Huntsville, AL",26620.0,2020-03-01,105,0,105
"Huntsville, AL",26620.0,2020-04-01,106,0,106
"Huntsville, AL",26620.0,2020-05-01,31,0,31
"Huntsville, AL",26620.0,2020-06-01,59,0,59
"Huntsville, AL",26620.0,2020-07-01,283,0,283
"Huntsville, AL",26620.0,2020-08-01,20,0,20
"Huntsville, AL",26620.0,2020-09-01,60,0,60
"Huntsville, AL",26620.0,2020-10-01,-61,0,-61
"Huntsville, AL",26620.0,2020-11-01,85,0,85
"Huntsville, AL",26620.0,2020-12-01,-15,0,-15
"Ruston, LA",40820.0,2019-01-01,14,0,14
"Ruston, LA",40820.0,2019-02-01,-18,0,-18
"Ruston, LA",40820.0,2019-03-01,-14,0,-14
"Ruston, LA",40820.0,2019-04-01,-12,0,-12
"Ruston, LA",40820.0,2019-05-01,-26,0,-26
"Ruston, LA",40820.0,2019-06-01,-5,0,-5
"Ruston, LA",40820.0,2019-07-01,-40,0,-40
"Ruston, LA",40820.0,2019-08-01,-8,0,-8
"Ruston, LA",40820.0,2019-09-01,-32,0,-32
"Ruston, LA",40820.0,2019-10-01,-15,0,-15
"Ruston, LA",40820.0,2019-11-01,0,0,0
"Ruston, LA",40820.0,2019-12-01,10,0,10
"Ruston, LA",40820.0,2020-01-01,15,0,15
"Ruston, LA",40820.0,2020-02-01,0,0,0
"Ruston, LA",40820.0,2020-03-01,-52,0,-52
"Ruston, LA",40820.0,2020-04-01,9,0,9
"Ruston, LA",40820.0,2020-05-01,-36,0,-36
"Ruston, LA",40820.0,2020-06-01,-72,0,-72
"Ruston, LA",40820.0,2020-07-01,-32,0,-32
"Ruston, LA",40820.0,2020-08-01,-8,0,-8
"Ruston, LA",40820.0,2020-09-01,0,0,0
"Ruston, LA",40820.0,2020-10-01,-8,0,-8
"Ruston, LA",40820.0,2020-11-01,16,0,16
"Ruston, LA",40820.0,2020-12-01,-9,0,-9
"Brookhaven, MS",15020.0,2019-01-01,-17,0,-17
"Brookhaven, MS",15020.0,2019-02-01,21,0,21
"Brookhaven, MS",15020.0,2019-03-01,31,0,31
"Brookhaven, MS",15020.0,2019-04-01,41,0,41
"Brookhaven, MS",15020.0,2019-05-01,-13,0,-13
"Brookhaven, MS",15020.0,2019-06-01,-24,0,-24
"Brookhaven, MS",15020.0,2019-07-01,18,0,18
"Brookhaven, MS",15020.0,2019-08-01,-33,0,-33
"Brookhaven, MS",15020.0,2019-09-01,8,0,8
"Brookhaven, MS",15020.0,2019-10-01,13,0,13
"Brookhaven, MS",15020.0,2019-11-01,0,0,0
"Brookhaven, MS",15020.0,2019-12-01,14,0,14
"Brookhaven, MS",15020.0,2020-01-01,11,0,11
"Brookhaven, MS",15020.0,2020-02-01,0,0,0
"Brookhaven, MS",15020.0,2020-03-01,-1,0,-1
"Brookhaven, MS",15020.0,2020-04-01,-16,0,-16
"Brookhaven, MS",15020.0,2020-05-01,-14,0,-14
"Brookhaven, MS",15020.0,2020-06-01,3,0,3
"Brookhaven, MS",15020.0,2020-07-01,-15,0,-15
"Brookhaven, MS",15020.0,2020-08-01,15,0,15
"Brookhaven, MS",15020.0,2020-09-01,26,0,26
"Brookhaven, MS",15020.0,2020-10-01,-1,0,-1
"Brookhaven, MS",15020.0,2020-11-01,-6,0,-6
"Brookhaven, MS",15020.0,2020-12-01,2,0,2
"North Platte, NE",35820.0,2019-01-01,-13,0,-13
"North Platte, NE",35820.0,2019-02-01,0,0,0
"North Platte, NE",35820.0,2019-03-01,-11,0,-11
"North Platte, NE",35820.0,2019-04-01,0,0,0
"North Platte, NE",35820.0,2019-05-01,9,0,9
"North Platte, NE",35820.0,2019-06-01,0,0,0
"North Platte, NE",35820.0,2019-07-01,-16,0,-16
"North Platte, NE",35820.0,2019-08-01,-11,0,-11
"North Platte, NE",35820.0,2019-09-01,11,0,11
"North Platte, NE",35820.0,2019-10-01,17,0,17
"North Platte, NE",35820.0,2019-11-01,0,0,0
"North Platte, NE",35820.0,2019-12-01,13,0,13
"North Platte, NE",35820.0,2020-01-01,0,0,0
"North Platte, NE",35820.0,2020-02-01,0,0,0
"North Platte, NE",35820.0,2020-03-01,0,0,0
"North Platte, NE",35820.0,2020-04-01,0,0,0
"North Platte, NE",35820.0,2020-05-01,0,0,0
"North Platte, NE",35820.0,2020-06-01,16,0,16
"North Platte, NE",35820.0,2020-07-01,-14,0,-14
"North Platte, NE",35820.0,2020-08-01,3,0,3
"North Platte, NE",35820.0,2020-09-01,12,0,12
"North Platte, NE",35820.0,2020-10-01,0,0,0
"North Platte, NE",35820.0,2020-11-01,12,0,12
"North Platte, NE",35820.0,2020-12-01,0,0,0
"Ruidoso, NM",40760.0,2019-01-01,11,0,11
"Ruidoso, NM",40760.0,2019-02-01,0,0,0
"Ruidoso, NM",40760.0,2019-03-01,-12,0,-12
"Ruidoso, NM",40760.0,2019-04-01,0,0,0
"Ruidoso, NM",40760.0,2019-05-01,13,24,-11
"Ruidoso, NM",40760.0,2019-06-01,32,26,6
"Ruidoso, NM",40760.0,2019-07-01,11,11,0
"Ruidoso, NM",40760.0,2019-08-01,0,0,0
"Ruidoso, NM",40760.0,2019-09-01,0,0,0
"Ruidoso, NM",40760.0,2019-10-01,-35,-23,-12
"Ruidoso, NM",40760.0,2019-11-01,0,0,0
"Ruidoso, NM",40760.0,2019-12-01,0,0,0
"Ruidoso, NM",40760.0,2020-01-01,0,0,0
"Ruidoso, NM",40760.0,2020-02-01,12,0,12
"Ruidoso, NM",40760.0,2020-03-01,13,0,13
"Ruidoso, NM",40760.0,2020-04-01,0,0,0
"Ruidoso, NM",40760.0,2020-05-01,-18,0,-18
"Ruidoso, NM",40760.0,2020-06-01,-15,0,-15
"Ruidoso, NM",40760.0,2020-07-01,-13,0,-13
"Ruidoso, NM",40760.0,2020-08-01,12,0,12
"Ruidoso, NM",40760.0,2020-09-01,11,0,11
"Ruidoso, NM",40760.0,2020-10-01,0,0,0
"Ruidoso, NM",40760.0,2020-11-01,-14,0,-14
"Ruidoso, NM",40760.0,2020-12-01,0,0,0
"Newport, OR",35440.0,2019-01-01,8,0,8
"Newport, OR",35440.0,2019-02-01,-7,0,-7
"Newport, OR",35440.0,2019-03-01,19,0,19
"Newport, OR",35440.0,2019-04-01,7,12,-5
"Newport, OR",35440.0,2019-05-01,120,85,35
"Newport, OR",35440.0,2019-06-01,22,55,-33
"Newport, OR",35440.0,2019-07-01,-6,12,-18
"Newport, OR",35440.0,2019-08-01,19,0,19
"Newport, OR",35440.0,2019-09-01,-8,0,-8
"Newport, OR",35440.0,2019-10-01,-111,-87,-24
"Newport, OR",35440.0,2019-11-01,-27,-44,17
"Newport, OR",35440.0,2019-12-01,-36,0,-36
"Newport, OR",35440.0,2020-01-01,5,0,5
"Newport, OR",35440.0,2020-02-01,14,0,14
"Newport, OR",35440.0,2020-03-01,38,13,25
"Newport, OR",35440.0,2020-04-01,4,0,4
"Newport, OR",35440.0,2020-05-01,116,67,49
"Newport, OR",35440.0,2020-06-01,94,35,59
"Newport, OR",35440.0,2020-07-01,55,12,43
"Newport, OR",35440.0,2020-08-01,-12,0,-12
"Newport, OR",35440.0,2020-09-01,-46,0,-46
"Newport, OR",35440.0,2020-10-01,-55,-40,-15
"Newport, OR",35440.0,2020-11-01,31,-16,47
"Newport, OR",35440.0,2020-12-01,-46,0,-46
"Sioux Falls, SD",43620.0,2019-01-01,-145,-159,14
"Sioux Falls, SD",43620.0,2019-02-01,50,0,50
"Sioux Falls, SD",43620.0,2019-03-01,102,1,101
"Sioux Falls, SD",43620.0,2019-04-01,327,166,161
"Sioux Falls, SD",43620.0,2019-05-01,277,143,134
"Sioux Falls, SD",43620.0,2019-06-01,133,15,118
"Sioux Falls, SD",43620.0,2019-07-01,47,0,47
"Sioux Falls, SD",43620.0,2019-08-01,152,0,152
"Sioux Falls, SD",43620.0,2019-09-01,60,-17,77
"Sioux Falls, SD",43620.0,2019-10-01,-183,-193,10
"Sioux Falls, SD",43620.0,2019-11-01,-140,-195,55
"Sioux Falls, SD",43620.0,2019-12-01,-302,-298,-4
"Sioux Falls, SD",43620.0,2020-01-01,-111,-138,27
"Sioux Falls, SD",43620.0,2020-02-01,27,0,27
"Sioux Falls, SD",43620.0,2020-03-01,141,-12,153
"Sioux Falls, SD",43620.0,2020-04-01,208,37,171
"Sioux Falls, SD",43620.0,2020-05-01,291,116,175
"Sioux Falls, SD",43620.0,2020-06-01,104,54,50
"Sioux Falls, SD",43620.0,2020-07-01,37,0,37
"Sioux Falls, SD",43620.0,2020-08-01,87,0,87
"Sioux Falls, SD",43620.0,2020-09-01,56,-13,69
"Sioux Falls, SD",43620.0,2020-10-01,14,-207,221
"Sioux Falls, SD",43620.0,2020-11-01,-182,-201,19
"Sioux Falls, SD",43620.0,2020-12-01,-159,-185,26
"Wausau-Weston, WI",48140.0,2019-01-01,-61,-66,5
"Wausau-Weston, WI",48140.0,2019-02-01,-7,0,-7
"Wausau-Weston, WI",48140.0,2019-03-01,-34,0,-34
"Wausau-Weston, WI",48140.0,2019-04-01,42,21,21
"Wausau-Weston, WI",48140.0,2019-05-01,104,29,75
"Wausau-Weston, WI",48140.0,2019-06-01,14,0,14
"Wausau-Weston, WI",48140.0,2019-07-01,59,-12,71
"Wausau-Weston, WI",48140.0,2019-08-01,49,0,49
"Wausau-Weston, WI",48140.0,2019-09-01,13,0,13
"Wausau-Weston, WI",48140.0,2019-10-01,27,-42,69
"Wausau-Weston, WI",48140.0,2019-11-01,-48,-40,-8
"Wausau-Weston, WI",48140.0,2019-12-01,-90,-106,16
"Wausau-Weston, WI",48140.0,2020-01-01,-47,-59,12
"Wausau-Weston, WI",48140.0,2020-02-01,19,0,19
"Wausau-Weston, WI",48140.0,2020-03-01,57,12,45
"Wausau-Weston, WI",48140.0,2020-04-01,-35,15,-50
"Wausau-Weston, WI",48140.0,2020-05-01,41,41,0
"Wausau-Weston, WI",48140.0,2020-06-01,42,0,42
"Wausau-Weston, WI",48140.0,2020-07-01,16,0,16
"Wausau-Weston, WI",48140.0,2020-08-01,19,0,19
"Wausau-Weston, WI",48140.0,2020-09-01,71,0,71
"Wausau-Weston, WI",48140.0,2020-10-01,-26,-41,15
"Wausau-Weston, WI",48140.0,2020-11-01,-19,-37,18
"Wausau-Weston, WI",48140.0,2020-12-01,-49,-69,20
"Albany-Lebanon, OR",10540.0,2019-01-01,84,0,84
"Albany-Lebanon, OR",10540.0,2019-02-01,-10,0,-10
"Albany-Lebanon, OR",10540.0,2019-03-01,45,0,45
"Albany-Lebanon, OR",10540.0,2019-04-01,126,11,115
"Albany-Lebanon, OR",10540.0,2019-05-01,41,13,28
"Albany-Lebanon, OR",10540.0,2019-06-01,94,0,94
"Albany-Lebanon, OR",10540.0,2019-07-01,181,0,181
"Albany-Lebanon, OR",10540.0,2019-08-01,74,0,74
"Albany-Lebanon, OR",10540.0,2019-09-01,130,0,130
"Albany-Lebanon, OR",10540.0,2019-10-01,4,-69,73
"Albany-Lebanon, OR",10540.0,2019-11-01,77,-16,93
"Albany-Lebanon, OR",10540.0,2019-12-01,28,-24,52
"Albany-Lebanon, OR",10540.0,2020-01-01,-18,-13,-5
"Albany-Lebanon, OR",10540.0,2020-02-01,49,0,49
"Albany-Lebanon, OR",10540.0,2020-03-01,93,11,82
"Albany-Lebanon, OR",10540.0,2020-04-01,15,0,15
"Albany-Lebanon, OR",10540.0,2020-05-01,167,13,154
"Albany-Lebanon, OR",10540.0,2020-06-01,90,11,79
"Albany-Lebanon, OR",10540.0,2020-07-01,108,0,108
"Albany-Lebanon, OR",10540.0,2020-08-01,42,0,42
"Albany-Lebanon, OR",10540.0,2020-09-01,-41,-28,-13
"Albany-Lebanon, OR",10540.0,2020-10-01,12,-34,46
"Albany-Lebanon, OR",10540.0,2020-11-01,84,-30,114
"Albany-Lebanon, OR",10540.0,2020-12-01,76,0,76
"Torrington, CT",45860.0,2019-01-01,-90,-146,56
"Torrington, CT",45860.0,2019-02-01,101,0,101
"Torrington, CT",45860.0,2019-03-01,73,0,73
"Torrington, CT",45860.0,2019-04-01,340,173,167
"Torrington, CT",45860.0,2019-05-01,360,311,49
"Torrington, CT",45860.0,2019-06-01,165,70,95
"Torrington, CT",45860.0,2019-07-01,63,13,50
"Torrington, CT",45860.0,2019-08-01,131,0,131
"Torrington, CT",45860.0,2019-09-01,87,-13,100
"Torrington, CT",45860.0,2019-10-01,-132,-166,34
"Torrington, CT",45860.0,2019-11-01,-66,-123,57
"Torrington, CT",45860.0,2019-12-01,-103,-180,77
"Torrington, CT",45860.0,2020-01-01,-99,-171,72
"Torrington, CT",45860.0,2020-02-01,54,0,54
"Torrington, CT",45860.0,2020-03-01,971,778,193
"Torrington, CT",45860.0,2020-04-01,684,483,201
"Torrington, CT",45860.0,2020-05-01,663,475,188
"Torrington, CT",45860.0,2020-06-01,688,420,268
"Torrington, CT",45860.0,2020-07-01,403,195,208
"Torrington, CT",45860.0,2020-08-01,261,93,168
"Torrington, CT",45860.0,2020-09-01,337,143,194
"Torrington, CT",45860.0,2020-10-01,-14,-60,46
"Torrington, CT",45860.0,2020-11-01,171,3,168
"Torrington, CT",45860.0,2020-12-01,99,-32,131
"Pontiac, IL",38700.0,2019-01-01,-11,0,-11
"Pontiac, IL",38700.0,2019-02-01,11,0,11
"Pontiac, IL",38700.0,2019-03-01,-14,0,-14
"Pontiac, IL",38700.0,2019-04-01,27,0,27
"Pontiac, IL",38700.0,2019-05-01,9,0,9
"Pontiac, IL",38700.0,2019-06-01,-8,0,-8
"Pontiac, IL",38700.0,2019-07-01,-20,0,-20
"Pontiac, IL",38700.0,2019-08-01,0,0,0
"Pontiac, IL",38700.0,2019-09-01,23,0,23
"Pontiac, IL",38700.0,2019-10-01,23,0,23
"Pontiac, IL",38700.0,2019-11-01,11,0,11
"Pontiac, IL",38700.0,2019-12-01,-3,0,-3
"Pontiac, IL",38700.0,2020-01-01,7,0,7
"Pontiac, IL",38700.0,2020-02-01,-3,0,-3
"Pontiac, IL",38700.0,2020-03-01,11,0,11
"Pontiac, IL",38700.0,2020-04-01,3,0,3
"Pontiac, IL",38700.0,2020-05-01,21,0,21
"Pontiac, IL",38700.0,2020-06-01,16,0,16
"Pontiac, IL",38700.0,2020-07-01,10,0,10
"Pontiac, IL",38700.0,2020-08-01,20,0,20
"Pontiac, IL",38700.0,2020-09-01,-4,0,-4
"Pontiac, IL",38700.0,2020-10-01,-6,0,-6
"Pontiac, IL",38700.0,2020-11-01,23,0,23
"Pontiac, IL",38700.0,2020-12-01,25,0,25
"Rochester, NY",40380.0,2019-01-01,-1438,-1429,-9
"Rochester, NY",40380.0,2019-02-01,-199,-226,27
"Rochester, NY",40380.0,2019-03-01,36,-36,72
"Rochester, NY",40380.0,2019-04-01,1387,831,556
"Rochester, NY",40380.0,2019-05-01,1499,1358,141
"Rochester, NY",40380.0,2019-06-01,292,223,69
"Rochester, NY",40380.0,2019-07-01,-46,48,-94
"Rochester, NY",40380.0,2019-08-01,-31,-12,-19
"Rochester, NY",40380.0,2019-09-01,-195,-82,-113
"Rochester, NY",40380.0,2019-10-01,-1187,-989,-198
"Rochester, NY",40380.0,2019-11-01,-645,-671,26
"Rochester, NY",40380.0,2019-12-01,-1225,-1241,16
"Rochester, NY",40380.0,2020-01-01,-1383,-1414,31
"Rochester, NY",40380.0,2020-02-01,-202,-212,10
"Rochester, NY",40380.0,2020-03-01,348,102,246
"Rochester, NY",40380.0,2020-04-01,594,234,360
"Rochester, NY",40380.0,2020-05-01,1268,903,365
"Rochester, NY",40380.0,2020-06-01,645,554,91
"Rochester, NY",40380.0,2020-07-01,77,111,-34
"Rochester, NY",40380.0,2020-08-01,47,12,35
"Rochester, NY",40380.0,2020-09-01,-133,-61,-72
"Rochester, NY",40380.0,2020-10-01,-893,-780,-113
"Rochester, NY",40380.0,2020-11-01,-628,-673,45
"Rochester, NY",40380.0,2020-12-01,-1013,-1076,63
"Sterling, CO",44540.0,2019-01-01,0,0,0
"Sterling, CO",44540.0,2019-02-01,0,0,0
"Sterling, CO",44540.0,2019-03-01,0,0,0
"Sterling, CO",44540.0,2019-04-01,-11,0,-11
"Sterling, CO",44540.0,2019-05-01,20,0,20
"Sterling, CO",44540.0,2019-06-01,0,0,0
"Sterling, CO",44540.0,2019-07-01,14,0,14
"Sterling, CO",44540.0,2019-08-01,13,0,13
"Sterling, CO",44540.0,2019-09-01,17,0,17
"Sterling, CO",44540.0,2019-10-01,0,0,0
"Sterling, CO",44540.0,2019-11-01,0,0,0
"Sterling, CO",44540.0,2019-12-01,0,0,0
"Sterling, CO",44540.0,2020-01-01,0,0,0
"Sterling, CO",44540.0,2020-02-01,0,0,0
"Sterling, CO",44540.0,2020-03-01,-14,0,-14
"Sterling, CO",44540.0,2020-04-01,0,0,0
"Sterling, CO",44540.0,2020-05-01,0,0,0
"Sterling, CO",44540.0,2020-06-01,0,0,0
"Sterling, CO",44540.0,2020-07-01,-5,0,-5
"Sterling, CO",44540.0,2020-08-01,12,0,12
"Sterling, CO",44540.0,2020-09-01,0,0,0
"Sterling, CO",44540.0,2020-10-01,0,0,0
"Sterling, CO",44540.0,2020-11-01,0,0,0
"Sterling, CO",44540.0,2020-12-01,0,0,0
"Lincoln, IL",30660.0,2019-01-01,0,0,0
"Lincoln, IL",30660.0,2019-02-01,-16,0,-16
"Lincoln, IL",30660.0,2019-03-01,6,0,6
"Lincoln, IL",30660.0,2019-04-01,0,0,0
"Lincoln, IL",30660.0,2019-05-01,6,0,6
"Lincoln, IL",30660.0,2019-06-01,-22,0,-22
"Lincoln, IL",30660.0,2019-07-01,-13,0,-13
"Lincoln, IL",30660.0,2019-08-01,1,0,1
"Lincoln, IL",30660.0,2019-09-01,-27,0,-27
"Lincoln, IL",30660.0,2019-10-01,9,0,9
"Lincoln, IL",30660.0,2019-11-01,12,0,12
"Lincoln, IL",30660.0,2019-12-01,-1,0,-1
"Lincoln, IL",30660.0,2020-01-01,13,0,13
"Lincoln, IL",30660.0,2020-02-01,2,0,2
"Lincoln, IL",30660.0,2020-03-01,-11,0,-11
"Lincoln, IL",30660.0,2020-04-01,10,0,10
"Lincoln, IL",30660.0,2020-05-01,-12,0,-12
"Lincoln, IL",30660.0,2020-06-01,30,0,30
"Lincoln, IL",30660.0,2020-07-01,-3,0,-3
"Lincoln, IL",30660.0,2020-08-01,6,0,6
"Lincoln, IL",30660.0,2020-09-01,-13,0,-13
"Lincoln, IL",30660.0,2020-10-01,3,0,3
"Lincoln, IL",30660.0,2020-11-01,-16,0,-16
"Lincoln, IL",30660.0,2020-12-01,0,0,0
"Bellefontaine, OH",13340.0,2019-01-01,-53,-25,-28
"Bellefontaine, OH",13340.0,2019-02-01,-16,0,-16
"Bellefontaine, OH",13340.0,2019-03-01,10,0,10
"Bellefontaine, OH",13340.0,2019-04-01,5,0,5
"Bellefontaine, OH",13340.0,2019-05-01,4,0,4
"Bellefontaine, OH",13340.0,2019-06-01,9,0,9
"Bellefontaine, OH",13340.0,2019-07-01,5,0,5
"Bellefontaine, OH",13340.0,2019-08-01,-35,0,-35
"Bellefontaine, OH",13340.0,2019-09-01,-39,0,-39
"Bellefontaine, OH",13340.0,2019-10-01,-111,-40,-71
"Bellefontaine, OH",13340.0,2019-11-01,-38,-24,-14
"Bellefontaine, OH",13340.0,2019-12-01,-20,-19,-1
"Bellefontaine, OH",13340.0,2020-01-01,4,0,4
"Bellefontaine, OH",13340.0,2020-02-01,-10,0,-10
"Bellefontaine, OH",13340.0,2020-03-01,32,0,32
"Bellefontaine, OH",13340.0,2020-04-01,4,0,4
"Bellefontaine, OH",13340.0,2020-05-01,42,13,29
"Bellefontaine, OH",13340.0,2020-06-01,-12,0,-12
"Bellefontaine, OH",13340.0,2020-07-01,-14,0,-14
"Bellefontaine, OH",13340.0,2020-08-01,56,0,56
"Bellefontaine, OH",13340.0,2020-09-01,-9,0,-9
"Bellefontaine, OH",13340.0,2020-10-01,-56,-40,-16
"Bellefontaine, OH",13340.0,2020-11-01,24,0,24
"Bellefontaine, OH",13340.0,2020-12-01,-29,-38,9
"Mount Gay-Shamrock, WV",34350.0,2019-01-01,0,0,0
"Mount Gay-Shamrock, WV",34350.0,2019-02-01,0,0,0
"Mount Gay-Shamrock, WV",34350.0,2019-03-01,-1,0,-1
"Mount Gay-Shamrock, WV",34350.0,2019-04-01,0,0,0
"Mount Gay-Shamrock, WV",34350.0,2019-05-01,0,0,0
"Mount Gay-Shamrock, WV",34350.0,2019-06-01,0,0,0
"Mount Gay-Shamrock, WV",34350.0,2019-07-01,0,0,0
"Mount Gay-Shamrock, WV",34350.0,2019-08-01,0,0,0
"Mount Gay-Shamrock, WV",34350.0,2019-09-01,0,0,0
"Mount Gay-Shamrock, WV",34350.0,2019-10-01,0,0,0
"Mount Gay-Shamrock, WV",34350.0,2019-11-01,0,0,0
"Mount Gay-Shamrock, WV",34350.0,2019-12-01,0,0,0
"Mount Gay-Shamrock, WV",34350.0,2020-01-01,0,0,0
"Mount Gay-Shamrock, WV",34350.0,2020-02-01,0,0,0
"Mount Gay-Shamrock, WV",34350.0,2020-03-01,0,0,0
"Mount Gay-Shamrock, WV",34350.0,2020-04-01,12,0,12
"Mount Gay-Shamrock, WV",34350.0,2020-05-01,0,0,0
"Mount Gay-Shamrock, WV",34350.0,2020-06-01,0,0,0
"Mount Gay-Shamrock, WV",34350.0,2020-07-01,0,0,0
"Mount Gay-Shamrock, WV",34350.0,2020-08-01,0,0,0
"Mount Gay-Shamrock, WV",34350.0,2020-09-01,0,0,0
"Mount Gay-Shamrock, WV",34350.0,2020-10-01,0,0,0
"Mount Gay-Shamrock, WV",34350.0,2020-11-01,0,0,0
"Mount Gay-Shamrock, WV",34350.0,2020-12-01,0,0,0
"Los Alamos, NM",31060.0,2019-01-01,11,0,11
"Los Alamos, NM",31060.0,2019-02-01,0,0,0
"Los Alamos, NM",31060.0,2019-03-01,0,0,0
"Los Alamos, NM",31060.0,2019-04-01,13,0,13
"Los Alamos, NM",31060.0,2019-05-01,-29,0,-29
"Los Alamos, NM",31060.0,2019-06-01,-23,0,-23
"Los Alamos, NM",31060.0,2019-07-01,-30,0,-30
"Los Alamos, NM",31060.0,2019-08-01,-15,0,-15
"Los Alamos, NM",31060.0,2019-09-01,5,0,5
"Los Alamos, NM",31060.0,2019-10-01,0,0,0
"Los Alamos, NM",31060.0,2019-11-01,-14,0,-14
"Los Alamos, NM",31060.0,2019-12-01,-18,0,-18
"Los Alamos, NM",31060.0,2020-01-01,-1,0,-1
"Los Alamos, NM",31060.0,2020-02-01,-15,0,-15
"Los Alamos, NM",31060.0,2020-03-01,-15,0,-15
"Los Alamos, NM",31060.0,2020-04-01,15,0,15
"Los Alamos, NM",31060.0,2020-05-01,-11,0,-11
"Los Alamos, NM",31060.0,2020-06-01,-12,0,-12
"Los Alamos, NM",31060.0,2020-07-01,-16,0,-16
"Los Alamos, NM",31060.0,2020-08-01,-10,0,-10
"Los Alamos, NM",31060.0,2020-09-01,-34,0,-34
"Los Alamos, NM",31060.0,2020-10-01,-18,0,-18
"Los Alamos, NM",31060.0,2020-11-01,5,0,5
"Los Alamos, NM",31060.0,2020-12-01,13,0,13
"Los Angeles-Long Beach-Anaheim, CA",31080.0,2019-01-01,-4904,303,-5207
"Los Angeles-Long Beach-Anaheim, CA",31080.0,2019-02-01,-4116,93,-4209
"Los Angeles-Long Beach-Anaheim, CA",31080.0,2019-03-01,-4984,178,-5162
"Los Angeles-Long Beach-Anaheim, CA",31080.0,2019-04-01,-5361,151,-5512
"Los Angeles-Long Beach-Anaheim, CA",31080.0,2019-05-01,-4374,589,-4963
"Los Angeles-Long Beach-Anaheim, CA",31080.0,2019-06-01,-6280,404,-6684
"Los Angeles-Long Beach-Anaheim, CA",31080.0,2019-07-01,-5881,211,-6092
"Los Angeles-Long Beach-Anaheim, CA",31080.0,2019-08-01,-5680,38,-5718
"Los Angeles-Long Beach-Anaheim, CA",31080.0,2019-09-01,-5171,64,-5235
"Los Angeles-Long Beach-Anaheim, CA",31080.0,2019-10-01,-5744,95,-5839
"Los Angeles-Long Beach-Anaheim, CA",31080.0,2019-11-01,-4928,173,-5101
"Los Angeles-Long Beach-Anaheim, CA",31080.0,2019-12-01,-4764,362,-5126
"Los Angeles-Long Beach-Anaheim, CA",31080.0,2020-01-01,-4717,433,-5150
"Los Angeles-Long Beach-Anaheim, CA",31080.0,2020-02-01,-4740,-1,-4739
"Los Angeles-Long Beach-Anaheim, CA",31080.0,2020-03-01,-8574,-998,-7576
"Los Angeles-Long Beach-Anaheim, CA",31080.0,2020-04-01,-7990,-993,-6997
"Los Angeles-Long Beach-Anaheim, CA",31080.0,2020-05-01,-6700,-218,-6482
"Los Angeles-Long Beach-Anaheim, CA",31080.0,2020-06-01,-7423,-103,-7320
"Los Angeles-Long Beach-Anaheim, CA",31080.0,2020-07-01,-8630,-172,-8458
"Los Angeles-Long Beach-Anaheim, CA",31080.0,2020-08-01,-11683,-791,-10892
"Los Angeles-Long Beach-Anaheim, CA",31080.0,2020-09-01,-10509,-629,-9880
"Los Angeles-Long Beach-Anaheim, CA",31080.0,2020-10-01,-9868,-237,-9631
"Los Angeles-Long Beach-Anaheim, CA",31080.0,2020-11-01,-8949,-296,-8653
"Los Angeles-Long Beach-Anaheim, CA",31080.0,2020-12-01,-9892,-424,-9468
"Columbus, MS",18060.0,2019-01-01,13,0,13
"Columbus, MS",18060.0,2019-02-01,0,0,0
"Columbus, MS",18060.0,2019-03-01,14,0,14
"Columbus, MS",18060.0,2019-04-01,0,0,0
"Columbus, MS",18060.0,2019-05-01,52,0,52
"Columbus, MS",18060.0,2019-06-01,1,0,1
"Columbus, MS",18060.0,2019-07-01,18,0,18
"Columbus, MS",18060.0,2019-08-01,6,0,6
"Columbus, MS",18060.0,2019-09-01,1,0,1
"Columbus, MS",18060.0,2019-10-01,-34,0,-34
"Columbus, MS",18060.0,2019-11-01,0,0,0
"Columbus, MS",18060.0,2019-12-01,-11,0,-11
"Columbus, MS",18060.0,2020-01-01,2,0,2
"Columbus, MS",18060.0,2020-02-01,-11,0,-11
"Columbus, MS",18060.0,2020-03-01,-11,0,-11
"Columbus, MS",18060.0,2020-04-01,14,0,14
"Columbus, MS",18060.0,2020-05-01,-26,0,-26
"Columbus, MS",18060.0,2020-06-01,-4,0,-4
"Columbus, MS",18060.0,2020-07-01,-4,0,-4
"Columbus, MS",18060.0,2020-08-01,-4,0,-4
"Columbus, MS",18060.0,2020-09-01,3,0,3
"Columbus, MS",18060.0,2020-10-01,12,0,12
"Columbus, MS",18060.0,2020-11-01,-24,0,-24
"Columbus, MS",18060.0,2020-12-01,-10,0,-10
"Deming, NM",19700.0,2019-01-01,-16,0,-16
"Deming, NM",19700.0,2019-02-01,12,0,12
"Deming, NM",19700.0,2019-03-01,-11,0,-11
"Deming, NM",19700.0,2019-04-01,11,0,11
"Deming, NM",19700.0,2019-05-01,0,0,0
"Deming, NM",19700.0,2019-06-01,-12,0,-12
"Deming, NM",19700.0,2019-07-01,-2,0,-2
"Deming, NM",19700.0,2019-08-01,8,0,8
"Deming, NM",19700.0,2019-09-01,-14,0,-14
"Deming, NM",19700.0,2019-10-01,-12,0,-12
"Deming, NM",19700.0,2019-11-01,-31,0,-31
"Deming, NM",19700.0,2019-12-01,0,0,0
"Deming, NM",19700.0,2020-01-01,-12,0,-12
"Deming, NM",19700.0,2020-02-01,0,0,0
"Deming, NM",19700.0,2020-03-01,23,0,23
"Deming, NM",19700.0,2020-04-01,-13,0,-13
"Deming, NM",19700.0,2020-05-01,0,0,0
"Deming, NM",19700.0,2020-06-01,-34,0,-34
"Deming, NM",19700.0,2020-07-01,-18,0,-18
"Deming, NM",19700.0,2020-08-01,-47,0,-47
"Deming, NM",19700.0,2020-09-01,-21,0,-21
"Deming, NM",19700.0,2020-10-01,5,0,5
"Deming, NM",19700.0,2020-11-01,-18,0,-18
"Deming, NM",19700.0,2020-12-01,1,0,1
"Williamsport, PA",48700.0,2019-01-01,25,0,25
"Williamsport, PA",48700.0,2019-02-01,4,0,4
"Williamsport, PA",48700.0,2019-03-01,-3,0,-3
"Williamsport, PA",48700.0,2019-04-01,39,0,39
"Williamsport, PA",48700.0,2019-05-01,-2,0,-2
"Williamsport, PA",48700.0,2019-06-01,24,0,24
"Williamsport, PA",48700.0,2019-07-01,-28,0,-28
"Williamsport, PA",48700.0,2019-08-01,52,0,52
"Williamsport, PA",48700.0,2019-09-01,49,0,49
"Williamsport, PA",48700.0,2019-10-01,23,0,23
"Williamsport, PA",48700.0,2019-11-01,40,0,40
"Williamsport, PA",48700.0,2019-12-01,-57,-45,-12
"Williamsport, PA",48700.0,2020-01-01,-24,0,-24
"Williamsport, PA",48700.0,2020-02-01,-26,0,-26
"Williamsport, PA",48700.0,2020-03-01,-13,0,-13
"Williamsport, PA",48700.0,2020-04-01,11,0,11
"Williamsport, PA",48700.0,2020-05-01,35,0,35
"Williamsport, PA",48700.0,2020-06-01,30,0,30
"Williamsport, PA",48700.0,2020-07-01,-2,0,-2
"Williamsport, PA",48700.0,2020-08-01,-12,0,-12
"Williamsport, PA",48700.0,2020-09-01,6,0,6
"Williamsport, PA",48700.0,2020-10-01,-17,0,-17
"Williamsport, PA",48700.0,2020-11-01,-14,0,-14
"Williamsport, PA",48700.0,2020-12-01,-11,0,-11
"Emporia, KS",21380.0,2019-01-01,-30,0,-30
"Emporia, KS",21380.0,2019-02-01,0,0,0
"Emporia, KS",21380.0,2019-03-01,0,0,0
"Emporia, KS",21380.0,2019-04-01,-16,0,-16
"Emporia, KS",21380.0,2019-05-01,-45,0,-45
"Emporia, KS",21380.0,2019-06-01,-66,0,-66
"Emporia, KS",21380.0,2019-07-01,3,0,3
"Emporia, KS",21380.0,2019-08-01,-78,0,-78
"Emporia, KS",21380.0,2019-09-01,-11,0,-11
"Emporia, KS",21380.0,2019-10-01,0,0,0
"Emporia, KS",21380.0,2019-11-01,0,0,0
"Emporia, KS",21380.0,2019-12-01,-26,0,-26
"Emporia, KS",21380.0,2020-01-01,0,0,0
"Emporia, KS",21380.0,2020-02-01,0,0,0
"Emporia, KS",21380.0,2020-03-01,0,0,0
"Emporia, KS",21380.0,2020-04-01,-8,0,-8
"Emporia, KS",21380.0,2020-05-01,-14,0,-14
"Emporia, KS",21380.0,2020-06-01,-23,0,-23
"Emporia, KS",21380.0,2020-07-01,-2,0,-2
"Emporia, KS",21380.0,2020-08-01,-38,0,-38
"Emporia, KS",21380.0,2020-09-01,12,0,12
"Emporia, KS",21380.0,2020-10-01,14,0,14
"Emporia, KS",21380.0,2020-11-01,13,0,13
"Emporia, KS",21380.0,2020-12-01,-15,0,-15
"Marshall, MN",32140.0,2019-01-01,-14,0,-14
"Marshall, MN",32140.0,2019-02-01,0,0,0
"Marshall, MN",32140.0,2019-03-01,0,0,0
"Marshall, MN",32140.0,2019-04-01,0,0,0
"Marshall, MN",32140.0,2019-05-01,24,0,24
"Marshall, MN",32140.0,2019-06-01,4,0,4
"Marshall, MN",32140.0,2019-07-01,-15,0,-15
"Marshall, MN",32140.0,2019-08-01,-9,0,-9
"Marshall, MN",32140.0,2019-09-01,0,0,0
"Marshall, MN",32140.0,2019-10-01,9,-16,25
"Marshall, MN",32140.0,2019-11-01,4,0,4
"Marshall, MN",32140.0,2019-12-01,-93,-69,-24
"Marshall, MN",32140.0,2020-01-01,0,0,0
"Marshall, MN",32140.0,2020-02-01,0,0,0
"Marshall, MN",32140.0,2020-03-01,0,0,0
"Marshall, MN",32140.0,2020-04-01,0,0,0
"Marshall, MN",32140.0,2020-05-01,0,0,0
"Marshall, MN",32140.0,2020-06-01,12,0,12
"Marshall, MN",32140.0,2020-07-01,0,0,0
"Marshall, MN",32140.0,2020-08-01,0,0,0
"Marshall, MN",32140.0,2020-09-01,-14,0,-14
"Marshall, MN",32140.0,2020-10-01,0,-11,11
"Marshall, MN",32140.0,2020-11-01,-23,-23,0
"Marshall, MN",32140.0,2020-12-01,-41,-41,0
"Fernley, NV",22280.0,2019-01-01,71,0,71
"Fernley, NV",22280.0,2019-02-01,21,0,21
"Fernley, NV",22280.0,2019-03-01,43,0,43
"Fernley, NV",22280.0,2019-04-01,27,0,27
"Fernley, NV",22280.0,2019-05-01,50,0,50
"Fernley, NV",22280.0,2019-06-01,33,0,33
"Fernley, NV",22280.0,2019-07-01,59,0,59
"Fernley, NV",22280.0,2019-08-01,-41,0,-41
"Fernley, NV",22280.0,2019-09-01,76,0,76
"Fernley, NV",22280.0,2019-10-01,25,0,25
"Fernley, NV",22280.0,2019-11-01,-1,0,-1
"Fernley, NV",22280.0,2019-12-01,17,0,17
"Fernley, NV",22280.0,2020-01-01,33,0,33
"Fernley, NV",22280.0,2020-02-01,26,0,26
"Fernley, NV",22280.0,2020-03-01,64,0,64
"Fernley, NV",22280.0,2020-04-01,48,0,48
"Fernley, NV",22280.0,2020-05-01,85,0,85
"Fernley, NV",22280.0,2020-06-01,74,0,74
"Fernley, NV",22280.0,2020-07-01,73,0,73
"Fernley, NV",22280.0,2020-08-01,69,0,69
"Fernley, NV",22280.0,2020-09-01,43,0,43
"Fernley, NV",22280.0,2020-10-01,88,0,88
"Fernley, NV",22280.0,2020-11-01,88,0,88
"Fernley, NV",22280.0,2020-12-01,88,0,88
"Decatur, IL",19500.0,2019-01-01,7,-21,28
"Decatur, IL",19500.0,2019-02-01,3,0,3
"Decatur, IL",19500.0,2019-03-01,4,0,4
"Decatur, IL",19500.0,2019-04-01,27,0,27
"Decatur, IL",19500.0,2019-05-01,25,17,8
"Decatur, IL",19500.0,2019-06-01,-28,0,-28
"Decatur, IL",19500.0,2019-07-01,41,0,41
"Decatur, IL",19500.0,2019-08-01,-9,0,-9
"Decatur, IL",19500.0,2019-09-01,-53,0,-53
"Decatur, IL",19500.0,2019-10-01,-33,-15,-18
"Decatur, IL",19500.0,2019-11-01,2,-13,15
"Decatur, IL",19500.0,2019-12-01,-53,-46,-7
"Decatur, IL",19500.0,2020-01-01,-15,-17,2
"Decatur, IL",19500.0,2020-02-01,9,0,9
"Decatur, IL",19500.0,2020-03-01,22,0,22
"Decatur, IL",19500.0,2020-04-01,-14,0,-14
"Decatur, IL",19500.0,2020-05-01,-36,0,-36
"Decatur, IL",19500.0,2020-06-01,15,14,1
"Decatur, IL",19500.0,2020-07-01,9,0,9
"Decatur, IL",19500.0,2020-08-01,-18,0,-18
"Decatur, IL",19500.0,2020-09-01,-20,0,-20
"Decatur, IL",19500.0,2020-10-01,9,-18,27
"Decatur, IL",19500.0,2020-11-01,-10,-35,25
"Decatur, IL",19500.0,2020-12-01,-85,-17,-68
"Madera, CA",31460.0,2019-01-01,-10,-12,2
"Madera, CA",31460.0,2019-02-01,81,0,81
"Madera, CA",31460.0,2019-03-01,62,0,62
"Madera, CA",31460.0,2019-04-01,8,0,8
"Madera, CA",31460.0,2019-05-01,56,0,56
"Madera, CA",31460.0,2019-06-01,108,0,108
"Madera, CA",31460.0,2019-07-01,109,0,109
"Madera, CA",31460.0,2019-08-01,78,0,78
"Madera, CA",31460.0,2019-09-01,6,0,6
"Madera, CA",31460.0,2019-10-01,64,0,64
"Madera, CA",31460.0,2019-11-01,20,0,20
"Madera, CA",31460.0,2019-12-01,95,0,95
"Madera, CA",31460.0,2020-01-01,37,0,37
"Madera, CA",31460.0,2020-02-01,103,0,103
"Madera, CA",31460.0,2020-03-01,32,-1,33
"Madera, CA",31460.0,2020-04-01,97,-11,108
"Madera, CA",31460.0,2020-05-01,81,0,81
"Madera, CA",31460.0,2020-06-01,103,0,103
"Madera, CA",31460.0,2020-07-01,157,0,157
"Madera, CA",31460.0,2020-08-01,106,0,106
"Madera, CA",31460.0,2020-09-01,138,-2,140
"Madera, CA",31460.0,2020-10-01,109,0,109
"Madera, CA",31460.0,2020-11-01,71,0,71
"Madera, CA",31460.0,2020-12-01,97,0,97
"Norfolk, NE",35740.0,2019-01-01,-24,-13,-11
"Norfolk, NE",35740.0,2019-02-01,0,0,0
"Norfolk, NE",35740.0,2019-03-01,0,0,0
"Norfolk, NE",35740.0,2019-04-01,25,12,13
"Norfolk, NE",35740.0,2019-05-01,-16,0,-16
"Norfolk, NE",35740.0,2019-06-01,11,0,11
"Norfolk, NE",35740.0,2019-07-01,10,0,10
"Norfolk, NE",35740.0,2019-08-01,-36,0,-36
"Norfolk, NE",35740.0,2019-09-01,11,0,11
"Norfolk, NE",35740.0,2019-10-01,-28,-12,-16
"Norfolk, NE",35740.0,2019-11-01,-11,0,-11
"Norfolk, NE",35740.0,2019-12-01,-14,-14,0
"Norfolk, NE",35740.0,2020-01-01,-16,0,-16
"Norfolk, NE",35740.0,2020-02-01,0,0,0
"Norfolk, NE",35740.0,2020-03-01,-31,0,-31
"Norfolk, NE",35740.0,2020-04-01,33,11,22
"Norfolk, NE",35740.0,2020-05-01,-17,0,-17
"Norfolk, NE",35740.0,2020-06-01,4,0,4
"Norfolk, NE",35740.0,2020-07-01,-18,0,-18
"Norfolk, NE",35740.0,2020-08-01,-16,0,-16
"Norfolk, NE",35740.0,2020-09-01,-27,0,-27
"Norfolk, NE",35740.0,2020-10-01,-11,0,-11
"Norfolk, NE",35740.0,2020-11-01,0,0,0
"Norfolk, NE",35740.0,2020-12-01,-13,-13,0
"Syracuse, NY",45060.0,2019-01-01,-922,-983,61
"Syracuse, NY",45060.0,2019-02-01,-98,-101,3
"Syracuse, NY",45060.0,2019-03-01,119,0,119
"Syracuse, NY",45060.0,2019-04-01,1041,778,263
"Syracuse, NY",45060.0,2019-05-01,947,881,66
"Syracuse, NY",45060.0,2019-06-01,-229,89,-318
"Syracuse, NY",45060.0,2019-07-01,-100,7,-107
"Syracuse, NY",45060.0,2019-08-01,7,0,7
"Syracuse, NY",45060.0,2019-09-01,-135,-23,-112
"Syracuse, NY",45060.0,2019-10-01,-896,-724,-172
"Syracuse, NY",45060.0,2019-11-01,-609,-603,-6
"Syracuse, NY",45060.0,2019-12-01,-992,-982,-10
"Syracuse, NY",45060.0,2020-01-01,-942,-1018,76
"Syracuse, NY",45060.0,2020-02-01,-114,-85,-29
"Syracuse, NY",45060.0,2020-03-01,320,124,196
"Syracuse, NY",45060.0,2020-04-01,393,176,217
"Syracuse, NY",45060.0,2020-05-01,937,705,232
"Syracuse, NY",45060.0,2020-06-01,508,413,95
"Syracuse, NY",45060.0,2020-07-01,162,44,118
"Syracuse, NY",45060.0,2020-08-01,-124,0,-124
"Syracuse, NY",45060.0,2020-09-01,-28,16,-44
"Syracuse, NY",45060.0,2020-10-01,-740,-683,-57
"Syracuse, NY",45060.0,2020-11-01,-544,-476,-68
"Syracuse, NY",45060.0,2020-12-01,-704,-798,94
"Oskaloosa, IA",36820.0,2019-01-01,16,0,16
"Oskaloosa, IA",36820.0,2019-02-01,-1,0,-1
"Oskaloosa, IA",36820.0,2019-03-01,-12,0,-12
"Oskaloosa, IA",36820.0,2019-04-01,12,0,12
"Oskaloosa, IA",36820.0,2019-05-01,6,0,6
"Oskaloosa, IA",36820.0,2019-06-01,-24,0,-24
"Oskaloosa, IA",36820.0,2019-07-01,-3,0,-3
"Oskaloosa, IA",36820.0,2019-08-01,-12,0,-12
"Oskaloosa, IA",36820.0,2019-09-01,12,0,12
"Oskaloosa, IA",36820.0,2019-10-01,-11,0,-11
"Oskaloosa, IA",36820.0,2019-11-01,9,0,9
"Oskaloosa, IA",36820.0,2019-12-01,8,-11,19
"Oskaloosa, IA",36820.0,2020-01-01,-13,0,-13
"Oskaloosa, IA",36820.0,2020-02-01,0,0,0
"Oskaloosa, IA",36820.0,2020-03-01,20,0,20
"Oskaloosa, IA",36820.0,2020-04-01,4,0,4
"Oskaloosa, IA",36820.0,2020-05-01,-1,0,-1
"Oskaloosa, IA",36820.0,2020-06-01,30,0,30
"Oskaloosa, IA",36820.0,2020-07-01,-27,0,-27
"Oskaloosa, IA",36820.0,2020-08-01,31,0,31
"Oskaloosa, IA",36820.0,2020-09-01,14,0,14
"Oskaloosa, IA",36820.0,2020-10-01,22,0,22
"Oskaloosa, IA",36820.0,2020-11-01,4,-12,16
"Oskaloosa, IA",36820.0,2020-12-01,-11,0,-11
"Youngstown-Warren-Boardman, OH-PA",49660.0,2019-01-01,-297,-266,-31
"Youngstown-Warren-Boardman, OH-PA",49660.0,2019-02-01,34,0,34
"Youngstown-Warren-Boardman, OH-PA",49660.0,2019-03-01,-31,0,-31
"Youngstown-Warren-Boardman, OH-PA",49660.0,2019-04-01,346,201,145
"Youngstown-Warren-Boardman, OH-PA",49660.0,2019-05-01,259,191,68
"Youngstown-Warren-Boardman, OH-PA",49660.0,2019-06-01,88,12,76
"Youngstown-Warren-Boardman, OH-PA",49660.0,2019-07-01,27,0,27
"Youngstown-Warren-Boardman, OH-PA",49660.0,2019-08-01,-7,0,-7
"Youngstown-Warren-Boardman, OH-PA",49660.0,2019-09-01,4,0,4
"Youngstown-Warren-Boardman, OH-PA",49660.0,2019-10-01,-241,-279,38
"Youngstown-Warren-Boardman, OH-PA",49660.0,2019-11-01,-181,-146,-35
"Youngstown-Warren-Boardman, OH-PA",49660.0,2019-12-01,-296,-301,5
"Youngstown-Warren-Boardman, OH-PA",49660.0,2020-01-01,-346,-318,-28
"Youngstown-Warren-Boardman, OH-PA",49660.0,2020-02-01,-28,-12,-16
"Youngstown-Warren-Boardman, OH-PA",49660.0,2020-03-01,77,11,66
"Youngstown-Warren-Boardman, OH-PA",49660.0,2020-04-01,99,32,67
"Youngstown-Warren-Boardman, OH-PA",49660.0,2020-05-01,291,146,145
"Youngstown-Warren-Boardman, OH-PA",49660.0,2020-06-01,182,44,138
"Youngstown-Warren-Boardman, OH-PA",49660.0,2020-07-01,114,0,114
"Youngstown-Warren-Boardman, OH-PA",49660.0,2020-08-01,53,0,53
"Youngstown-Warren-Boardman, OH-PA",49660.0,2020-09-01,97,1,96
"Youngstown-Warren-Boardman, OH-PA",49660.0,2020-10-01,-179,-190,11
"Youngstown-Warren-Boardman, OH-PA",49660.0,2020-11-01,-118,-156,38
"Youngstown-Warren-Boardman, OH-PA",49660.0,2020-12-01,-141,-200,59
"Ontario, OR-ID",36620.0,2019-01-01,14,0,14
"Ontario, OR-ID",36620.0,2019-02-01,-3,0,-3
"Ontario, OR-ID",36620.0,2019-03-01,53,0,53
"Ontario, OR-ID",36620.0,2019-04-01,11,0,11
"Ontario, OR-ID",36620.0,2019-05-01,48,0,48
"Ontario, OR-ID",36620.0,2019-06-01,60,0,60
"Ontario, OR-ID",36620.0,2019-07-01,18,0,18
"Ontario, OR-ID",36620.0,2019-08-01,34,0,34
"Ontario, OR-ID",36620.0,2019-09-01,24,0,24
"Ontario, OR-ID",36620.0,2019-10-01,-15,0,-15
"Ontario, OR-ID",36620.0,2019-11-01,12,0,12
"Ontario, OR-ID",36620.0,2019-12-01,20,0,20
"Ontario, OR-ID",36620.0,2020-01-01,44,0,44
"Ontario, OR-ID",36620.0,2020-02-01,57,0,57
"Ontario, OR-ID",36620.0,2020-03-01,13,0,13
"Ontario, OR-ID",36620.0,2020-04-01,41,0,41
"Ontario, OR-ID",36620.0,2020-05-01,14,0,14
"Ontario, OR-ID",36620.0,2020-06-01,66,0,66
"Ontario, OR-ID",36620.0,2020-07-01,15,0,15
"Ontario, OR-ID",36620.0,2020-08-01,-2,0,-2
"Ontario, OR-ID",36620.0,2020-09-01,31,0,31
"Ontario, OR-ID",36620.0,2020-10-01,12,0,12
"Ontario, OR-ID",36620.0,2020-11-01,30,0,30
"Ontario, OR-ID",36620.0,2020-12-01,29,0,29
"North Port-Sarasota-Bradenton, FL",35840.0,2019-01-01,10223,9750,473
"North Port-Sarasota-Bradenton, FL",35840.0,2019-02-01,1135,1044,91
"North Port-Sarasota-Bradenton, FL",35840.0,2019-03-01,-543,33,-576
"North Port-Sarasota-Bradenton, FL",35840.0,2019-04-01,-10121,-7398,-2723
"North Port-Sarasota-Bradenton, FL",35840.0,2019-05-01,-12387,-11823,-564
"North Port-Sarasota-Bradenton, FL",35840.0,2019-06-01,-2011,-2738,727
"North Port-Sarasota-Bradenton, FL",35840.0,2019-07-01,213,-495,708
"North Port-Sarasota-Bradenton, FL",35840.0,2019-08-01,685,-13,698
"North Port-Sarasota-Bradenton, FL",35840.0,2019-09-01,1832,735,1097
"North Port-Sarasota-Bradenton, FL",35840.0,2019-10-01,10606,8868,1738
"North Port-Sarasota-Bradenton, FL",35840.0,2019-11-01,5257,4711,546
"North Port-Sarasota-Bradenton, FL",35840.0,2019-12-01,10713,10361,352
"North Port-Sarasota-Bradenton, FL",35840.0,2020-01-01,10041,9620,421
"North Port-Sarasota-Bradenton, FL",35840.0,2020-02-01,1129,902,227
"North Port-Sarasota-Bradenton, FL",35840.0,2020-03-01,-1814,-361,-1453
"North Port-Sarasota-Bradenton, FL",35840.0,2020-04-01,-1204,-467,-737
"North Port-Sarasota-Bradenton, FL",35840.0,2020-05-01,-6741,-6151,-590
"North Port-Sarasota-Bradenton, FL",35840.0,2020-06-01,-5039,-5376,337
"North Port-Sarasota-Bradenton, FL",35840.0,2020-07-01,-145,-1170,1025
"North Port-Sarasota-Bradenton, FL",35840.0,2020-08-01,1221,-202,1423
"North Port-Sarasota-Bradenton, FL",35840.0,2020-09-01,1868,523,1345
"North Port-Sarasota-Bradenton, FL",35840.0,2020-10-01,9715,7513,2202
"North Port-Sarasota-Bradenton, FL",35840.0,2020-11-01,6718,5599,1119
"North Port-Sarasota-Bradenton, FL",35840.0,2020-12-01,9535,8739,796
"Manitowoc, WI",31820.0,2019-01-01,-10,-17,7
"Manitowoc, WI",31820.0,2019-02-01,1,0,1
"Manitowoc, WI",31820.0,2019-03-01,2,0,2
"Manitowoc, WI",31820.0,2019-04-01,37,0,37
"Manitowoc, WI",31820.0,2019-05-01,27,12,15
"Manitowoc, WI",31820.0,2019-06-01,-24,0,-24
"Manitowoc, WI",31820.0,2019-07-01,39,0,39
"Manitowoc, WI",31820.0,2019-08-01,-2,0,-2
"Manitowoc, WI",31820.0,2019-09-01,-16,0,-16
"Manitowoc, WI",31820.0,2019-10-01,29,-13,42
"Manitowoc, WI",31820.0,2019-11-01,-2,0,-2
"Manitowoc, WI",31820.0,2019-12-01,-36,-14,-22
"Manitowoc, WI",31820.0,2020-01-01,-6,-16,10
"Manitowoc, WI",31820.0,2020-02-01,9,0,9
"Manitowoc, WI",31820.0,2020-03-01,30,0,30
"Manitowoc, WI",31820.0,2020-04-01,1,0,1
"Manitowoc, WI",31820.0,2020-05-01,2,0,2
"Manitowoc, WI",31820.0,2020-06-01,34,0,34
"Manitowoc, WI",31820.0,2020-07-01,27,0,27
"Manitowoc, WI",31820.0,2020-08-01,28,0,28
"Manitowoc, WI",31820.0,2020-09-01,50,0,50
"Manitowoc, WI",31820.0,2020-10-01,38,-12,50
"Manitowoc, WI",31820.0,2020-11-01,9,0,9
"Manitowoc, WI",31820.0,2020-12-01,19,-13,32
"Phoenix-Mesa-Chandler, AZ",38060.0,2019-01-01,12354,10200,2154
"Phoenix-Mesa-Chandler, AZ",38060.0,2019-02-01,3100,1553,1547
"Phoenix-Mesa-Chandler, AZ",38060.0,2019-03-01,872,207,665
"Phoenix-Mesa-Chandler, AZ",38060.0,2019-04-01,-14130,-10532,-3598
"Phoenix-Mesa-Chandler, AZ",38060.0,2019-05-01,-16239,-16654,415
"Phoenix-Mesa-Chandler, AZ",38060.0,2019-06-01,-2140,-5902,3762
"Phoenix-Mesa-Chandler, AZ",38060.0,2019-07-01,4345,-1332,5677
"Phoenix-Mesa-Chandler, AZ",38060.0,2019-08-01,4263,-89,4352
"Phoenix-Mesa-Chandler, AZ",38060.0,2019-09-01,7116,2747,4369
"Phoenix-Mesa-Chandler, AZ",38060.0,2019-10-01,25417,20213,5204
"Phoenix-Mesa-Chandler, AZ",38060.0,2019-11-01,13661,10893,2768
"Phoenix-Mesa-Chandler, AZ",38060.0,2019-12-01,14936,12812,2124
"Phoenix-Mesa-Chandler, AZ",38060.0,2020-01-01,12442,10051,2391
"Phoenix-Mesa-Chandler, AZ",38060.0,2020-02-01,3018,1554,1464
"Phoenix-Mesa-Chandler, AZ",38060.0,2020-03-01,-125,255,-380
"Phoenix-Mesa-Chandler, AZ",38060.0,2020-04-01,-2254,-2063,-191
"Phoenix-Mesa-Chandler, AZ",38060.0,2020-05-01,-12184,-12296,112
"Phoenix-Mesa-Chandler, AZ",38060.0,2020-06-01,-4438,-6831,2393
"Phoenix-Mesa-Chandler, AZ",38060.0,2020-07-01,1983,-1820,3803
"Phoenix-Mesa-Chandler, AZ",38060.0,2020-08-01,3237,-305,3542
"Phoenix-Mesa-Chandler, AZ",38060.0,2020-09-01,5847,2091,3756
"Phoenix-Mesa-Chandler, AZ",38060.0,2020-10-01,22504,18373,4131
"Phoenix-Mesa-Chandler, AZ",38060.0,2020-11-01,14544,12050,2494
"Phoenix-Mesa-Chandler, AZ",38060.0,2020-12-01,12383,10257,2126
"Marinette, WI-MI",31940.0,2019-01-01,-15,0,-15
"Marinette, WI-MI",31940.0,2019-02-01,40,0,40
"Marinette, WI-MI",31940.0,2019-03-01,5,0,5
"Marinette, WI-MI",31940.0,2019-04-01,13,0,13
"Marinette, WI-MI",31940.0,2019-05-01,-5,12,-17
"Marinette, WI-MI",31940.0,2019-06-01,-30,0,-30
"Marinette, WI-MI",31940.0,2019-07-01,10,0,10
"Marinette, WI-MI",31940.0,2019-08-01,16,0,16
"Marinette, WI-MI",31940.0,2019-09-01,-19,0,-19
"Marinette, WI-MI",31940.0,2019-10-01,48,0,48
"Marinette, WI-MI",31940.0,2019-11-01,-20,0,-20
"Marinette, WI-MI",31940.0,2019-12-01,-49,-14,-35
"Marinette, WI-MI",31940.0,2020-01-01,-24,0,-24
"Marinette, WI-MI",31940.0,2020-02-01,10,0,10
"Marinette, WI-MI",31940.0,2020-03-01,19,0,19
"Marinette, WI-MI",31940.0,2020-04-01,34,0,34
"Marinette, WI-MI",31940.0,2020-05-01,14,0,14
"Marinette, WI-MI",31940.0,2020-06-01,-16,0,-16
"Marinette, WI-MI",31940.0,2020-07-01,41,0,41
"Marinette, WI-MI",31940.0,2020-08-01,30,0,30
"Marinette, WI-MI",31940.0,2020-09-01,0,0,0
"Marinette, WI-MI",31940.0,2020-10-01,-27,-12,-15
"Marinette, WI-MI",31940.0,2020-11-01,-14,0,-14
"Marinette, WI-MI",31940.0,2020-12-01,25,0,25
"Ocala, FL",36100.0,2019-01-01,364,116,248
"Ocala, FL",36100.0,2019-02-01,215,0,215
"Ocala, FL",36100.0,2019-03-01,334,0,334
"Ocala, FL",36100.0,2019-04-01,-122,-318,196
"Ocala, FL",36100.0,2019-05-01,-321,-562,241
"Ocala, FL",36100.0,2019-06-01,259,-70,329
"Ocala, FL",36100.0,2019-07-01,353,0,353
"Ocala, FL",36100.0,2019-08-01,225,0,225
"Ocala, FL",36100.0,2019-09-01,251,0,251
"Ocala, FL",36100.0,2019-10-01,681,386,295
"Ocala, FL",36100.0,2019-11-01,432,161,271
"Ocala, FL",36100.0,2019-12-01,435,126,309
"Ocala, FL",36100.0,2020-01-01,313,79,234
"Ocala, FL",36100.0,2020-02-01,237,0,237
"Ocala, FL",36100.0,2020-03-01,367,0,367
"Ocala, FL",36100.0,2020-04-01,349,23,326
"Ocala, FL",36100.0,2020-05-01,204,-243,447
"Ocala, FL",36100.0,2020-06-01,155,-212,367
"Ocala, FL",36100.0,2020-07-01,425,0,425
"Ocala, FL",36100.0,2020-08-01,449,0,449
"Ocala, FL",36100.0,2020-09-01,449,0,449
"Ocala, FL",36100.0,2020-10-01,649,255,394
"Ocala, FL",36100.0,2020-11-01,474,102,372
"Ocala, FL",36100.0,2020-12-01,372,110,262
"Pella, IA",37800.0,2019-01-01,-30,-14,-16
"Pella, IA",37800.0,2019-02-01,38,0,38
"Pella, IA",37800.0,2019-03-01,11,0,11
"Pella, IA",37800.0,2019-04-01,2,0,2
"Pella, IA",37800.0,2019-05-01,6,0,6
"Pella, IA",37800.0,2019-06-01,2,0,2
"Pella, IA",37800.0,2019-07-01,-12,0,-12
"Pella, IA",37800.0,2019-08-01,-1,0,-1
"Pella, IA",37800.0,2019-09-01,-20,0,-20
"Pella, IA",37800.0,2019-10-01,-6,-12,6
"Pella, IA",37800.0,2019-11-01,-9,-13,4
"Pella, IA",37800.0,2019-12-01,-24,-11,-13
"Pella, IA",37800.0,2020-01-01,-20,0,-20
"Pella, IA",37800.0,2020-02-01,-1,0,-1
"Pella, IA",37800.0,2020-03-01,-18,0,-18
"Pella, IA",37800.0,2020-04-01,6,0,6
"Pella, IA",37800.0,2020-05-01,2,0,2
"Pella, IA",37800.0,2020-06-01,-33,0,-33
"Pella, IA",37800.0,2020-07-01,3,0,3
"Pella, IA",37800.0,2020-08-01,-18,0,-18
"Pella, IA",37800.0,2020-09-01,-29,0,-29
"Pella, IA",37800.0,2020-10-01,0,-17,17
"Pella, IA",37800.0,2020-11-01,-2,0,-2
"Pella, IA",37800.0,2020-12-01,-14,0,-14
"Centralia, IL",16460.0,2019-01-01,6,0,6
"Centralia, IL",16460.0,2019-02-01,0,0,0
"Centralia, IL",16460.0,2019-03-01,-12,0,-12
"Centralia, IL",16460.0,2019-04-01,5,0,5
"Centralia, IL",16460.0,2019-05-01,-13,0,-13
"Centralia, IL",16460.0,2019-06-01,-14,0,-14
"Centralia, IL",16460.0,2019-07-01,26,0,26
"Centralia, IL",16460.0,2019-08-01,-4,0,-4
"Centralia, IL",16460.0,2019-09-01,-2,0,-2
"Centralia, IL",16460.0,2019-10-01,-3,0,-3
"Centralia, IL",16460.0,2019-11-01,-9,0,-9
"Centralia, IL",16460.0,2019-12-01,11,0,11
"Centralia, IL",16460.0,2020-01-01,-17,0,-17
"Centralia, IL",16460.0,2020-02-01,20,0,20
"Centralia, IL",16460.0,2020-03-01,6,0,6
"Centralia, IL",16460.0,2020-04-01,9,0,9
"Centralia, IL",16460.0,2020-05-01,-11,0,-11
"Centralia, IL",16460.0,2020-06-01,-21,0,-21
"Centralia, IL",16460.0,2020-07-01,8,0,8
"Centralia, IL",16460.0,2020-08-01,4,0,4
"Centralia, IL",16460.0,2020-09-01,-8,0,-8
"Centralia, IL",16460.0,2020-10-01,3,0,3
"Centralia, IL",16460.0,2020-11-01,5,0,5
"Centralia, IL",16460.0,2020-12-01,-5,0,-5
"Hannibal, MO",25300.0,2019-01-01,0,0,0
"Hannibal, MO",25300.0,2019-02-01,-12,0,-12
"Hannibal, MO",25300.0,2019-03-01,10,0,10
"Hannibal, MO",25300.0,2019-04-01,24,0,24
"Hannibal, MO",25300.0,2019-05-01,-6,0,-6
"Hannibal, MO",25300.0,2019-06-01,1,0,1
"Hannibal, MO",25300.0,2019-07-01,-11,0,-11
"Hannibal, MO",25300.0,2019-08-01,-4,0,-4
"Hannibal, MO",25300.0,2019-09-01,-8,0,-8
"Hannibal, MO",25300.0,2019-10-01,17,0,17
"Hannibal, MO",25300.0,2019-11-01,6,0,6
"Hannibal, MO",25300.0,2019-12-01,12,0,12
"Hannibal, MO",25300.0,2020-01-01,16,0,16
"Hannibal, MO",25300.0,2020-02-01,0,0,0
"Hannibal, MO",25300.0,2020-03-01,12,0,12
"Hannibal, MO",25300.0,2020-04-01,21,0,21
"Hannibal, MO",25300.0,2020-05-01,4,0,4
"Hannibal, MO",25300.0,2020-06-01,4,0,4
"Hannibal, MO",25300.0,2020-07-01,-7,0,-7
"Hannibal, MO",25300.0,2020-08-01,-12,0,-12
"Hannibal, MO",25300.0,2020-09-01,11,0,11
"Hannibal, MO",25300.0,2020-10-01,16,0,16
"Hannibal, MO",25300.0,2020-11-01,0,0,0
"Hannibal, MO",25300.0,2020-12-01,6,0,6
"Marion, OH",32020.0,2019-01-01,-12,0,-12
"Marion, OH",32020.0,2019-02-01,1,0,1
"Marion, OH",32020.0,2019-03-01,46,0,46
"Marion, OH",32020.0,2019-04-01,47,0,47
"Marion, OH",32020.0,2019-05-01,-1,0,-1
"Marion, OH",32020.0,2019-06-01,6,0,6
"Marion, OH",32020.0,2019-07-01,7,0,7
"Marion, OH",32020.0,2019-08-01,31,0,31
"Marion, OH",32020.0,2019-09-01,23,0,23
"Marion, OH",32020.0,2019-10-01,47,0,47
"Marion, OH",32020.0,2019-11-01,-21,0,-21
"Marion, OH",32020.0,2019-12-01,17,0,17
"Marion, OH",32020.0,2020-01-01,-10,0,-10
"Marion, OH",32020.0,2020-02-01,12,0,12
"Marion, OH",32020.0,2020-03-01,-10,0,-10
"Marion, OH",32020.0,2020-04-01,42,0,42
"Marion, OH",32020.0,2020-05-01,6,0,6
"Marion, OH",32020.0,2020-06-01,-40,0,-40
"Marion, OH",32020.0,2020-07-01,-10,0,-10
"Marion, OH",32020.0,2020-08-01,-8,0,-8
"Marion, OH",32020.0,2020-09-01,10,0,10
"Marion, OH",32020.0,2020-10-01,52,0,52
"Marion, OH",32020.0,2020-11-01,13,0,13
"Marion, OH",32020.0,2020-12-01,15,0,15
"Salem, OR",41420.0,2019-01-01,28,-102,130
"Salem, OR",41420.0,2019-02-01,94,0,94
"Salem, OR",41420.0,2019-03-01,31,-12,43
"Salem, OR",41420.0,2019-04-01,307,106,201
"Salem, OR",41420.0,2019-05-01,91,115,-24
"Salem, OR",41420.0,2019-06-01,156,24,132
"Salem, OR",41420.0,2019-07-01,47,11,36
"Salem, OR",41420.0,2019-08-01,191,-15,206
"Salem, OR",41420.0,2019-09-01,5,0,5
"Salem, OR",41420.0,2019-10-01,-166,-257,91
"Salem, OR",41420.0,2019-11-01,-72,-126,54
"Salem, OR",41420.0,2019-12-01,-50,-99,49
"Salem, OR",41420.0,2020-01-01,99,-95,194
"Salem, OR",41420.0,2020-02-01,73,-16,89
"Salem, OR",41420.0,2020-03-01,133,25,108
"Salem, OR",41420.0,2020-04-01,180,28,152
"Salem, OR",41420.0,2020-05-01,206,94,112
"Salem, OR",41420.0,2020-06-01,190,46,144
"Salem, OR",41420.0,2020-07-01,38,0,38
"Salem, OR",41420.0,2020-08-01,158,0,158
"Salem, OR",41420.0,2020-09-01,82,28,54
"Salem, OR",41420.0,2020-10-01,3,-182,185
"Salem, OR",41420.0,2020-11-01,-19,-92,73
"Salem, OR",41420.0,2020-12-01,30,-60,90
"Fairmont, WV",21900.0,2019-01-01,15,0,15
"Fairmont, WV",21900.0,2019-02-01,-13,0,-13
"Fairmont, WV",21900.0,2019-03-01,18,0,18
"Fairmont, WV",21900.0,2019-04-01,15,0,15
"Fairmont, WV",21900.0,2019-05-01,-21,0,-21
"Fairmont, WV",21900.0,2019-06-01,0,0,0
"Fairmont, WV",21900.0,2019-07-01,1,0,1
"Fairmont, WV",21900.0,2019-08-01,-3,0,-3
"Fairmont, WV",21900.0,2019-09-01,7,0,7
"Fairmont, WV",21900.0,2019-10-01,21,0,21
"Fairmont, WV",21900.0,2019-11-01,-1,0,-1
"Fairmont, WV",21900.0,2019-12-01,25,0,25
"Fairmont, WV",21900.0,2020-01-01,12,0,12
"Fairmont, WV",21900.0,2020-02-01,2,0,2
"Fairmont, WV",21900.0,2020-03-01,-1,0,-1
"Fairmont, WV",21900.0,2020-04-01,5,0,5
"Fairmont, WV",21900.0,2020-05-01,-6,0,-6
"Fairmont, WV",21900.0,2020-06-01,9,0,9
"Fairmont, WV",21900.0,2020-07-01,25,0,25
"Fairmont, WV",21900.0,2020-08-01,-21,0,-21
"Fairmont, WV",21900.0,2020-09-01,22,0,22
"Fairmont, WV",21900.0,2020-10-01,18,0,18
"Fairmont, WV",21900.0,2020-11-01,22,0,22
"Fairmont, WV",21900.0,2020-12-01,28,0,28
"Bennettsville, SC",13500.0,2019-01-01,0,0,0
"Bennettsville, SC",13500.0,2019-02-01,0,0,0
"Bennettsville, SC",13500.0,2019-03-01,0,0,0
"Bennettsville, SC",13500.0,2019-04-01,11,0,11
"Bennettsville, SC",13500.0,2019-05-01,0,0,0
"Bennettsville, SC",13500.0,2019-06-01,0,0,0
"Bennettsville, SC",13500.0,2019-07-01,0,0,0
"Bennettsville, SC",13500.0,2019-08-01,0,0,0
"Bennettsville, SC",13500.0,2019-09-01,0,0,0
"Bennettsville, SC",13500.0,2019-10-01,-13,0,-13
"Bennettsville, SC",13500.0,2019-11-01,0,0,0
"Bennettsville, SC",13500.0,2019-12-01,11,0,11
"Bennettsville, SC",13500.0,2020-01-01,-16,0,-16
"Bennettsville, SC",13500.0,2020-02-01,0,0,0
"Bennettsville, SC",13500.0,2020-03-01,-12,0,-12
"Bennettsville, SC",13500.0,2020-04-01,0,0,0
"Bennettsville, SC",13500.0,2020-05-01,-15,0,-15
"Bennettsville, SC",13500.0,2020-06-01,0,0,0
"Bennettsville, SC",13500.0,2020-07-01,-11,0,-11
"Bennettsville, SC",13500.0,2020-08-01,25,0,25
"Bennettsville, SC",13500.0,2020-09-01,0,0,0
"Bennettsville, SC",13500.0,2020-10-01,-18,0,-18
"Bennettsville, SC",13500.0,2020-11-01,0,0,0
"Bennettsville, SC",13500.0,2020-12-01,13,0,13
"Marquette, MI",32100.0,2019-01-01,-67,-67,0
"Marquette, MI",32100.0,2019-02-01,0,0,0
"Marquette, MI",32100.0,2019-03-01,11,0,11
"Marquette, MI",32100.0,2019-04-01,23,12,11
"Marquette, MI",32100.0,2019-05-01,21,48,-27
"Marquette, MI",32100.0,2019-06-01,7,0,7
"Marquette, MI",32100.0,2019-07-01,-19,0,-19
"Marquette, MI",32100.0,2019-08-01,-17,0,-17
"Marquette, MI",32100.0,2019-09-01,-1,0,-1
"Marquette, MI",32100.0,2019-10-01,-70,-55,-15
"Marquette, MI",32100.0,2019-11-01,-5,-32,27
"Marquette, MI",32100.0,2019-12-01,-100,-87,-13
"Marquette, MI",32100.0,2020-01-01,-105,-105,0
"Marquette, MI",32100.0,2020-02-01,-11,-11,0
"Marquette, MI",32100.0,2020-03-01,15,0,15
"Marquette, MI",32100.0,2020-04-01,0,0,0
"Marquette, MI",32100.0,2020-05-01,60,48,12
"Marquette, MI",32100.0,2020-06-01,0,0,0
"Marquette, MI",32100.0,2020-07-01,-27,0,-27
"Marquette, MI",32100.0,2020-08-01,-2,0,-2
"Marquette, MI",32100.0,2020-09-01,-11,0,-11
"Marquette, MI",32100.0,2020-10-01,-43,-65,22
"Marquette, MI",32100.0,2020-11-01,-29,-29,0
"Marquette, MI",32100.0,2020-12-01,-40,-40,0
"Albertville, AL",10700.0,2019-01-01,-37,0,-37
"Albertville, AL",10700.0,2019-02-01,-6,0,-6
"Albertville, AL",10700.0,2019-03-01,-64,0,-64
"Albertville, AL",10700.0,2019-04-01,12,0,12
"Albertville, AL",10700.0,2019-05-01,4,0,4
"Albertville, AL",10700.0,2019-06-01,27,0,27
"Albertville, AL",10700.0,2019-07-01,-59,0,-59
"Albertville, AL",10700.0,2019-08-01,5,0,5
"Albertville, AL",10700.0,2019-09-01,12,0,12
"Albertville, AL",10700.0,2019-10-01,11,0,11
"Albertville, AL",10700.0,2019-11-01,24,0,24
"Albertville, AL",10700.0,2019-12-01,-19,0,-19
"Albertville, AL",10700.0,2020-01-01,-36,0,-36
"Albertville, AL",10700.0,2020-02-01,-29,0,-29
"Albertville, AL",10700.0,2020-03-01,-27,0,-27
"Albertville, AL",10700.0,2020-04-01,10,0,10
"Albertville, AL",10700.0,2020-05-01,30,0,30
"Albertville, AL",10700.0,2020-06-01,-9,0,-9
"Albertville, AL",10700.0,2020-07-01,32,0,32
"Albertville, AL",10700.0,2020-08-01,-5,0,-5
"Albertville, AL",10700.0,2020-09-01,27,0,27
"Albertville, AL",10700.0,2020-10-01,35,0,35
"Albertville, AL",10700.0,2020-11-01,-12,0,-12
"Albertville, AL",10700.0,2020-12-01,40,0,40
"Marshalltown, IA",32260.0,2019-01-01,-41,-12,-29
"Marshalltown, IA",32260.0,2019-02-01,-14,0,-14
"Marshalltown, IA",32260.0,2019-03-01,-40,0,-40
"Marshalltown, IA",32260.0,2019-04-01,-35,12,-47
"Marshalltown, IA",32260.0,2019-05-01,-22,0,-22
"Marshalltown, IA",32260.0,2019-06-01,38,0,38
"Marshalltown, IA",32260.0,2019-07-01,37,0,37
"Marshalltown, IA",32260.0,2019-08-01,-86,0,-86
"Marshalltown, IA",32260.0,2019-09-01,-27,0,-27
"Marshalltown, IA",32260.0,2019-10-01,-19,-11,-8
"Marshalltown, IA",32260.0,2019-11-01,-43,-11,-32
"Marshalltown, IA",32260.0,2019-12-01,-49,-39,-10
"Marshalltown, IA",32260.0,2020-01-01,-2,-11,9
"Marshalltown, IA",32260.0,2020-02-01,-5,0,-5
"Marshalltown, IA",32260.0,2020-03-01,0,0,0
"Marshalltown, IA",32260.0,2020-04-01,-8,0,-8
"Marshalltown, IA",32260.0,2020-05-01,-16,0,-16
"Marshalltown, IA",32260.0,2020-06-01,-3,0,-3
"Marshalltown, IA",32260.0,2020-07-01,7,0,7
"Marshalltown, IA",32260.0,2020-08-01,-27,0,-27
"Marshalltown, IA",32260.0,2020-09-01,0,0,0
"Marshalltown, IA",32260.0,2020-10-01,-10,0,-10
"Marshalltown, IA",32260.0,2020-11-01,10,-13,23
"Marshalltown, IA",32260.0,2020-12-01,2,-12,14
"Plymouth, IN",38500.0,2019-01-01,-17,0,-17
"Plymouth, IN",38500.0,2019-02-01,-8,-13,5
"Plymouth, IN",38500.0,2019-03-01,-15,0,-15
"Plymouth, IN",38500.0,2019-04-01,63,26,37
"Plymouth, IN",38500.0,2019-05-01,-4,13,-17
"Plymouth, IN",38500.0,2019-06-01,-5,0,-5
"Plymouth, IN",38500.0,2019-07-01,2,0,2
"Plymouth, IN",38500.0,2019-08-01,1,0,1
"Plymouth, IN",38500.0,2019-09-01,-42,0,-42
"Plymouth, IN",38500.0,2019-10-01,8,0,8
"Plymouth, IN",38500.0,2019-11-01,-63,-25,-38
"Plymouth, IN",38500.0,2019-12-01,-18,-23,5
"Plymouth, IN",38500.0,2020-01-01,-3,0,-3
"Plymouth, IN",38500.0,2020-02-01,-5,0,-5
"Plymouth, IN",38500.0,2020-03-01,54,0,54
"Plymouth, IN",38500.0,2020-04-01,44,0,44
"Plymouth, IN",38500.0,2020-05-01,51,11,40
"Plymouth, IN",38500.0,2020-06-01,21,0,21
"Plymouth, IN",38500.0,2020-07-01,29,0,29
"Plymouth, IN",38500.0,2020-08-01,-26,0,-26
"Plymouth, IN",38500.0,2020-09-01,-4,0,-4
"Plymouth, IN",38500.0,2020-10-01,19,-15,34
"Plymouth, IN",38500.0,2020-11-01,-15,-12,-3
"Plymouth, IN",38500.0,2020-12-01,11,-14,25
"Lewisburg, TN",30280.0,2019-01-01,2,0,2
"Lewisburg, TN",30280.0,2019-02-01,30,0,30
"Lewisburg, TN",30280.0,2019-03-01,84,0,84
"Lewisburg, TN",30280.0,2019-04-01,51,0,51
"Lewisburg, TN",30280.0,2019-05-01,32,0,32
"Lewisburg, TN",30280.0,2019-06-01,26,0,26
"Lewisburg, TN",30280.0,2019-07-01,-1,0,-1
"Lewisburg, TN",30280.0,2019-08-01,45,0,45
"Lewisburg, TN",30280.0,2019-09-01,14,0,14
"Lewisburg, TN",30280.0,2019-10-01,44,0,44
"Lewisburg, TN",30280.0,2019-11-01,33,0,33
"Lewisburg, TN",30280.0,2019-12-01,35,0,35
"Lewisburg, TN",30280.0,2020-01-01,12,0,12
"Lewisburg, TN",30280.0,2020-02-01,28,0,28
"Lewisburg, TN",30280.0,2020-03-01,6,0,6
"Lewisburg, TN",30280.0,2020-04-01,6,0,6
"Lewisburg, TN",30280.0,2020-05-01,71,0,71
"Lewisburg, TN",30280.0,2020-06-01,26,0,26
"Lewisburg, TN",30280.0,2020-07-01,-10,0,-10
"Lewisburg, TN",30280.0,2020-08-01,87,0,87
"Lewisburg, TN",30280.0,2020-09-01,40,0,40
"Lewisburg, TN",30280.0,2020-10-01,13,0,13
"Lewisburg, TN",30280.0,2020-11-01,49,0,49
"Lewisburg, TN",30280.0,2020-12-01,67,0,67
"Port St. Lucie, FL",38940.0,2019-01-01,3015,2647,368
"Port St. Lucie, FL",38940.0,2019-02-01,413,143,270
"Port St. Lucie, FL",38940.0,2019-03-01,13,-18,31
"Port St. Lucie, FL",38940.0,2019-04-01,-1625,-1405,-220
"Port St. Lucie, FL",38940.0,2019-05-01,-3143,-3365,222
"Port St. Lucie, FL",38940.0,2019-06-01,-330,-774,444
"Port St. Lucie, FL",38940.0,2019-07-01,559,-85,644
"Port St. Lucie, FL",38940.0,2019-08-01,524,1,523
"Port St. Lucie, FL",38940.0,2019-09-01,656,137,519
"Port St. Lucie, FL",38940.0,2019-10-01,2394,1669,725
"Port St. Lucie, FL",38940.0,2019-11-01,1220,732,488
"Port St. Lucie, FL",38940.0,2019-12-01,2673,2241,432
"Port St. Lucie, FL",38940.0,2020-01-01,2805,2416,389
"Port St. Lucie, FL",38940.0,2020-02-01,571,109,462
"Port St. Lucie, FL",38940.0,2020-03-01,394,59,335
"Port St. Lucie, FL",38940.0,2020-04-01,665,136,529
"Port St. Lucie, FL",38940.0,2020-05-01,-908,-1219,311
"Port St. Lucie, FL",38940.0,2020-06-01,-1383,-1890,507
"Port St. Lucie, FL",38940.0,2020-07-01,408,-243,651
"Port St. Lucie, FL",38940.0,2020-08-01,482,-67,549
"Port St. Lucie, FL",38940.0,2020-09-01,671,82,589
"Port St. Lucie, FL",38940.0,2020-10-01,2244,1354,890
"Port St. Lucie, FL",38940.0,2020-11-01,1627,973,654
"Port St. Lucie, FL",38940.0,2020-12-01,2458,1792,666
"Fairmont, MN",21860.0,2019-01-01,0,0,0
"Fairmont, MN",21860.0,2019-02-01,0,0,0
"Fairmont, MN",21860.0,2019-03-01,0,0,0
"Fairmont, MN",21860.0,2019-04-01,24,24,0
"Fairmont, MN",21860.0,2019-05-01,0,0,0
"Fairmont, MN",21860.0,2019-06-01,0,0,0
"Fairmont, MN",21860.0,2019-07-01,0,0,0
"Fairmont, MN",21860.0,2019-08-01,-12,0,-12
"Fairmont, MN",21860.0,2019-09-01,-12,0,-12
"Fairmont, MN",21860.0,2019-10-01,0,0,0
"Fairmont, MN",21860.0,2019-11-01,-18,-19,1
"Fairmont, MN",21860.0,2019-12-01,-33,-33,0
"Fairmont, MN",21860.0,2020-01-01,-11,-11,0
"Fairmont, MN",21860.0,2020-02-01,-11,0,-11
"Fairmont, MN",21860.0,2020-03-01,0,0,0
"Fairmont, MN",21860.0,2020-04-01,0,0,0
"Fairmont, MN",21860.0,2020-05-01,0,0,0
"Fairmont, MN",21860.0,2020-06-01,0,0,0
"Fairmont, MN",21860.0,2020-07-01,0,0,0
"Fairmont, MN",21860.0,2020-08-01,14,0,14
"Fairmont, MN",21860.0,2020-09-01,0,0,0
"Fairmont, MN",21860.0,2020-10-01,-11,-11,0
"Fairmont, MN",21860.0,2020-11-01,-27,-27,0
"Fairmont, MN",21860.0,2020-12-01,-20,-20,0
"Midland, TX",33260.0,2019-01-01,-65,0,-65
"Midland, TX",33260.0,2019-02-01,-71,0,-71
"Midland, TX",33260.0,2019-03-01,-123,0,-123
"Midland, TX",33260.0,2019-04-01,-59,0,-59
"Midland, TX",33260.0,2019-05-01,-112,0,-112
"Midland, TX",33260.0,2019-06-01,-168,0,-168
"Midland, TX",33260.0,2019-07-01,-161,0,-161
"Midland, TX",33260.0,2019-08-01,-177,0,-177
"Midland, TX",33260.0,2019-09-01,-138,0,-138
"Midland, TX",33260.0,2019-10-01,-112,0,-112
"Midland, TX",33260.0,2019-11-01,-59,0,-59
"Midland, TX",33260.0,2019-12-01,-86,0,-86
"Midland, TX",33260.0,2020-01-01,-85,0,-85
"Midland, TX",33260.0,2020-02-01,-76,0,-76
"Midland, TX",33260.0,2020-03-01,-162,0,-162
"Midland, TX",33260.0,2020-04-01,-160,0,-160
"Midland, TX",33260.0,2020-05-01,-264,0,-264
"Midland, TX",33260.0,2020-06-01,-222,0,-222
"Midland, TX",33260.0,2020-07-01,-197,0,-197
"Midland, TX",33260.0,2020-08-01,-95,0,-95
"Midland, TX",33260.0,2020-09-01,-83,0,-83
"Midland, TX",33260.0,2020-10-01,-61,0,-61
"Midland, TX",33260.0,2020-11-01,-106,0,-106
"Midland, TX",33260.0,2020-12-01,-89,0,-89
"Maysville, KY",32500.0,2019-01-01,14,0,14
"Maysville, KY",32500.0,2019-02-01,0,0,0
"Maysville, KY",32500.0,2019-03-01,0,0,0
"Maysville, KY",32500.0,2019-04-01,2,0,2
"Maysville, KY",32500.0,2019-05-01,11,0,11
"Maysville, KY",32500.0,2019-06-01,-1,0,-1
"Maysville, KY",32500.0,2019-07-01,11,0,11
"Maysville, KY",32500.0,2019-08-01,-4,0,-4
"Maysville, KY",32500.0,2019-09-01,11,0,11
"Maysville, KY",32500.0,2019-10-01,12,0,12
"Maysville, KY",32500.0,2019-11-01,-13,0,-13
"Maysville, KY",32500.0,2019-12-01,0,0,0
"Maysville, KY",32500.0,2020-01-01,15,0,15
"Maysville, KY",32500.0,2020-02-01,-14,0,-14
"Maysville, KY",32500.0,2020-03-01,-39,0,-39
"Maysville, KY",32500.0,2020-04-01,11,0,11
"Maysville, KY",32500.0,2020-05-01,0,0,0
"Maysville, KY",32500.0,2020-06-01,0,0,0
"Maysville, KY",32500.0,2020-07-01,23,0,23
"Maysville, KY",32500.0,2020-08-01,0,0,0
"Maysville, KY",32500.0,2020-09-01,0,0,0
"Maysville, KY",32500.0,2020-10-01,-13,0,-13
"Maysville, KY",32500.0,2020-11-01,12,0,12
"Maysville, KY",32500.0,2020-12-01,0,0,0
"Ludington, MI",31220.0,2019-01-01,0,0,0
"Ludington, MI",31220.0,2019-02-01,-2,0,-2
"Ludington, MI",31220.0,2019-03-01,-24,0,-24
"Ludington, MI",31220.0,2019-04-01,54,16,38
"Ludington, MI",31220.0,2019-05-01,41,40,1
"Ludington, MI",31220.0,2019-06-01,12,0,12
"Ludington, MI",31220.0,2019-07-01,0,0,0
"Ludington, MI",31220.0,2019-08-01,13,0,13
"Ludington, MI",31220.0,2019-09-01,11,0,11
"Ludington, MI",31220.0,2019-10-01,-50,-51,1
"Ludington, MI",31220.0,2019-11-01,-35,-11,-24
"Ludington, MI",31220.0,2019-12-01,-14,-11,-3
"Ludington, MI",31220.0,2020-01-01,-4,0,-4
"Ludington, MI",31220.0,2020-02-01,-12,0,-12
"Ludington, MI",31220.0,2020-03-01,-13,0,-13
"Ludington, MI",31220.0,2020-04-01,12,0,12
"Ludington, MI",31220.0,2020-05-01,32,18,14
"Ludington, MI",31220.0,2020-06-01,-11,0,-11
"Ludington, MI",31220.0,2020-07-01,0,0,0
"Ludington, MI",31220.0,2020-08-01,-4,0,-4
"Ludington, MI",31220.0,2020-09-01,0,0,0
"Ludington, MI",31220.0,2020-10-01,-37,-48,11
"Ludington, MI",31220.0,2020-11-01,9,-15,24
"Ludington, MI",31220.0,2020-12-01,23,0,23
"Shelton, WA",43220.0,2019-01-01,43,-55,98
"Shelton, WA",43220.0,2019-02-01,38,0,38
"Shelton, WA",43220.0,2019-03-01,111,-16,127
"Shelton, WA",43220.0,2019-04-01,211,102,109
"Shelton, WA",43220.0,2019-05-01,195,111,84
"Shelton, WA",43220.0,2019-06-01,99,22,77
"Shelton, WA",43220.0,2019-07-01,75,0,75
"Shelton, WA",43220.0,2019-08-01,108,0,108
"Shelton, WA",43220.0,2019-09-01,42,-41,83
"Shelton, WA",43220.0,2019-10-01,-129,-214,85
"Shelton, WA",43220.0,2019-11-01,-4,-87,83
"Shelton, WA",43220.0,2019-12-01,-3,-48,45
"Shelton, WA",43220.0,2020-01-01,-17,-42,25
"Shelton, WA",43220.0,2020-02-01,44,0,44
"Shelton, WA",43220.0,2020-03-01,58,8,50
"Shelton, WA",43220.0,2020-04-01,210,32,178
"Shelton, WA",43220.0,2020-05-01,278,137,141
"Shelton, WA",43220.0,2020-06-01,162,48,114
"Shelton, WA",43220.0,2020-07-01,134,15,119
"Shelton, WA",43220.0,2020-08-01,104,0,104
"Shelton, WA",43220.0,2020-09-01,68,-38,106
"Shelton, WA",43220.0,2020-10-01,-134,-215,81
"Shelton, WA",43220.0,2020-11-01,-24,-71,47
"Shelton, WA",43220.0,2020-12-01,48,-43,91
"Bay City, TX",13060.0,2019-01-01,0,0,0
"Bay City, TX",13060.0,2019-02-01,11,0,11
"Bay City, TX",13060.0,2019-03-01,3,0,3
"Bay City, TX",13060.0,2019-04-01,-43,0,-43
"Bay City, TX",13060.0,2019-05-01,9,0,9
"Bay City, TX",13060.0,2019-06-01,-29,0,-29
"Bay City, TX",13060.0,2019-07-01,-9,0,-9
"Bay City, TX",13060.0,2019-08-01,-45,0,-45
"Bay City, TX",13060.0,2019-09-01,-19,0,-19
"Bay City, TX",13060.0,2019-10-01,-3,0,-3
"Bay City, TX",13060.0,2019-11-01,7,0,7
"Bay City, TX",13060.0,2019-12-01,-21,0,-21
"Bay City, TX",13060.0,2020-01-01,-13,0,-13
"Bay City, TX",13060.0,2020-02-01,-13,0,-13
"Bay City, TX",13060.0,2020-03-01,-22,0,-22
"Bay City, TX",13060.0,2020-04-01,22,0,22
"Bay City, TX",13060.0,2020-05-01,0,0,0
"Bay City, TX",13060.0,2020-06-01,12,0,12
"Bay City, TX",13060.0,2020-07-01,7,0,7
"Bay City, TX",13060.0,2020-08-01,2,0,2
"Bay City, TX",13060.0,2020-09-01,-17,0,-17
"Bay City, TX",13060.0,2020-10-01,-3,0,-3
"Bay City, TX",13060.0,2020-11-01,15,0,15
"Bay City, TX",13060.0,2020-12-01,-15,0,-15
"Kahului-Wailuku-Lahaina, HI",27980.0,2019-01-01,54,68,-14
"Kahului-Wailuku-Lahaina, HI",27980.0,2019-02-01,31,12,19
"Kahului-Wailuku-Lahaina, HI",27980.0,2019-03-01,-18,0,-18
"Kahului-Wailuku-Lahaina, HI",27980.0,2019-04-01,-31,-11,-20
"Kahului-Wailuku-Lahaina, HI",27980.0,2019-05-01,-29,-27,-2
"Kahului-Wailuku-Lahaina, HI",27980.0,2019-06-01,21,23,-2
"Kahului-Wailuku-Lahaina, HI",27980.0,2019-07-01,45,0,45
"Kahului-Wailuku-Lahaina, HI",27980.0,2019-08-01,49,11,38
"Kahului-Wailuku-Lahaina, HI",27980.0,2019-09-01,27,12,15
"Kahului-Wailuku-Lahaina, HI",27980.0,2019-10-01,34,60,-26
"Kahului-Wailuku-Lahaina, HI",27980.0,2019-11-01,-1,19,-20
"Kahului-Wailuku-Lahaina, HI",27980.0,2019-12-01,-2,10,-12
"Kahului-Wailuku-Lahaina, HI",27980.0,2020-01-01,95,103,-8
"Kahului-Wailuku-Lahaina, HI",27980.0,2020-02-01,-32,0,-32
"Kahului-Wailuku-Lahaina, HI",27980.0,2020-03-01,-1,30,-31
"Kahului-Wailuku-Lahaina, HI",27980.0,2020-04-01,33,-3,36
"Kahului-Wailuku-Lahaina, HI",27980.0,2020-05-01,-60,-3,-57
"Kahului-Wailuku-Lahaina, HI",27980.0,2020-06-01,65,0,65
"Kahului-Wailuku-Lahaina, HI",27980.0,2020-07-01,-4,14,-18
"Kahului-Wailuku-Lahaina, HI",27980.0,2020-08-01,92,11,81
"Kahului-Wailuku-Lahaina, HI",27980.0,2020-09-01,11,-1,12
"Kahului-Wailuku-Lahaina, HI",27980.0,2020-10-01,152,89,63
"Kahului-Wailuku-Lahaina, HI",27980.0,2020-11-01,97,39,58
"Kahului-Wailuku-Lahaina, HI",27980.0,2020-12-01,81,103,-22
"Eagle Pass, TX",20580.0,2019-01-01,6,0,6
"Eagle Pass, TX",20580.0,2019-02-01,-15,0,-15
"Eagle Pass, TX",20580.0,2019-03-01,17,0,17
"Eagle Pass, TX",20580.0,2019-04-01,-15,0,-15
"Eagle Pass, TX",20580.0,2019-05-01,0,0,0
"Eagle Pass, TX",20580.0,2019-06-01,-16,0,-16
"Eagle Pass, TX",20580.0,2019-07-01,-10,0,-10
"Eagle Pass, TX",20580.0,2019-08-01,-11,0,-11
"Eagle Pass, TX",20580.0,2019-09-01,-3,0,-3
"Eagle Pass, TX",20580.0,2019-10-01,-17,0,-17
"Eagle Pass, TX",20580.0,2019-11-01,2,0,2
"Eagle Pass, TX",20580.0,2019-12-01,0,0,0
"Eagle Pass, TX",20580.0,2020-01-01,19,0,19
"Eagle Pass, TX",20580.0,2020-02-01,-14,0,-14
"Eagle Pass, TX",20580.0,2020-03-01,4,0,4
"Eagle Pass, TX",20580.0,2020-04-01,2,0,2
"Eagle Pass, TX",20580.0,2020-05-01,1,0,1
"Eagle Pass, TX",20580.0,2020-06-01,11,0,11
"Eagle Pass, TX",20580.0,2020-07-01,2,0,2
"Eagle Pass, TX",20580.0,2020-08-01,-2,0,-2
"Eagle Pass, TX",20580.0,2020-09-01,-11,0,-11
"Eagle Pass, TX",20580.0,2020-10-01,-12,0,-12
"Eagle Pass, TX",20580.0,2020-11-01,-11,0,-11
"Eagle Pass, TX",20580.0,2020-12-01,13,0,13
"Mayagüez, PR",32420.0,2019-01-01,0,0,0
"Mayagüez, PR",32420.0,2019-02-01,0,0,0
"Mayagüez, PR",32420.0,2019-03-01,0,0,0
"Mayagüez, PR",32420.0,2019-04-01,0,0,0
"Mayagüez, PR",32420.0,2019-05-01,0,0,0
"Mayagüez, PR",32420.0,2019-06-01,0,0,0
"Mayagüez, PR",32420.0,2019-07-01,0,0,0
"Mayagüez, PR",32420.0,2019-08-01,0,0,0
"Mayagüez, PR",32420.0,2020-01-01,0,0,0
"Mayagüez, PR",32420.0,2020-06-01,0,0,0
"Mayagüez, PR",32420.0,2020-07-01,0,0,0
"Mayagüez, PR",32420.0,2020-08-01,0,0,0
"Mayagüez, PR",32420.0,2020-09-01,0,0,0
"Mayagüez, PR",32420.0,2020-10-01,0,0,0
"Mayagüez, PR",32420.0,2020-11-01,0,0,0
"Mayagüez, PR",32420.0,2020-12-01,0,0,0
"Macomb, IL",31380.0,2019-01-01,-23,0,-23
"Macomb, IL",31380.0,2019-02-01,12,0,12
"Macomb, IL",31380.0,2019-03-01,0,0,0
"Macomb, IL",31380.0,2019-04-01,0,0,0
"Macomb, IL",31380.0,2019-05-01,-13,0,-13
"Macomb, IL",31380.0,2019-06-01,-26,0,-26
"Macomb, IL",31380.0,2019-07-01,-16,0,-16
"Macomb, IL",31380.0,2019-08-01,6,0,6
"Macomb, IL",31380.0,2019-09-01,0,0,0
"Macomb, IL",31380.0,2019-10-01,0,0,0
"Macomb, IL",31380.0,2019-11-01,0,0,0
"Macomb, IL",31380.0,2019-12-01,-13,0,-13
"Macomb, IL",31380.0,2020-01-01,0,0,0
"Macomb, IL",31380.0,2020-02-01,0,0,0
"Macomb, IL",31380.0,2020-03-01,-13,0,-13
"Macomb, IL",31380.0,2020-04-01,-15,0,-15
"Macomb, IL",31380.0,2020-05-01,-24,-11,-13
"Macomb, IL",31380.0,2020-06-01,0,0,0
"Macomb, IL",31380.0,2020-07-01,-25,0,-25
"Macomb, IL",31380.0,2020-08-01,2,0,2
"Macomb, IL",31380.0,2020-09-01,0,0,0
"Macomb, IL",31380.0,2020-10-01,11,0,11
"Macomb, IL",31380.0,2020-11-01,0,0,0
"Macomb, IL",31380.0,2020-12-01,-26,0,-26
"Marion, NC",32000.0,2019-01-01,5,0,5
"Marion, NC",32000.0,2019-02-01,14,0,14
"Marion, NC",32000.0,2019-03-01,-9,0,-9
"Marion, NC",32000.0,2019-04-01,-8,0,-8
"Marion, NC",32000.0,2019-05-01,-4,0,-4
"Marion, NC",32000.0,2019-06-01,-8,0,-8
"Marion, NC",32000.0,2019-07-01,-5,0,-5
"Marion, NC",32000.0,2019-08-01,-4,0,-4
"Marion, NC",32000.0,2019-09-01,-4,0,-4
"Marion, NC",32000.0,2019-10-01,-6,0,-6
"Marion, NC",32000.0,2019-11-01,21,0,21
"Marion, NC",32000.0,2019-12-01,6,0,6
"Marion, NC",32000.0,2020-01-01,23,0,23
"Marion, NC",32000.0,2020-02-01,29,0,29
"Marion, NC",32000.0,2020-03-01,20,13,7
"Marion, NC",32000.0,2020-04-01,26,0,26
"Marion, NC",32000.0,2020-05-01,21,0,21
"Marion, NC",32000.0,2020-06-01,36,0,36
"Marion, NC",32000.0,2020-07-01,16,0,16
"Marion, NC",32000.0,2020-08-01,13,0,13
"Marion, NC",32000.0,2020-09-01,12,0,12
"Marion, NC",32000.0,2020-10-01,23,0,23
"Marion, NC",32000.0,2020-11-01,19,0,19
"Marion, NC",32000.0,2020-12-01,3,0,3
"Bradford, PA",14620.0,2019-01-01,-11,0,-11
"Bradford, PA",14620.0,2019-02-01,26,0,26
"Bradford, PA",14620.0,2019-03-01,-12,0,-12
"Bradford, PA",14620.0,2019-04-01,-18,0,-18
"Bradford, PA",14620.0,2019-05-01,11,0,11
"Bradford, PA",14620.0,2019-06-01,-41,0,-41
"Bradford, PA",14620.0,2019-07-01,-26,0,-26
"Bradford, PA",14620.0,2019-08-01,-10,0,-10
"Bradford, PA",14620.0,2019-09-01,-5,0,-5
"Bradford, PA",14620.0,2019-10-01,-27,0,-27
"Bradford, PA",14620.0,2019-11-01,14,0,14
"Bradford, PA",14620.0,2019-12-01,-15,0,-15
"Bradford, PA",14620.0,2020-01-01,28,0,28
"Bradford, PA",14620.0,2020-02-01,0,0,0
"Bradford, PA",14620.0,2020-03-01,-41,0,-41
"Bradford, PA",14620.0,2020-04-01,-5,0,-5
"Bradford, PA",14620.0,2020-05-01,0,0,0
"Bradford, PA",14620.0,2020-06-01,8,0,8
"Bradford, PA",14620.0,2020-07-01,-4,0,-4
"Bradford, PA",14620.0,2020-08-01,11,0,11
"Bradford, PA",14620.0,2020-09-01,11,0,11
"Bradford, PA",14620.0,2020-10-01,16,0,16
"Bradford, PA",14620.0,2020-11-01,-4,0,-4
"Bradford, PA",14620.0,2020-12-01,0,0,0
"Gallup, NM",23700.0,2019-01-01,20,0,20
"Gallup, NM",23700.0,2019-02-01,18,0,18
"Gallup, NM",23700.0,2019-03-01,18,0,18
"Gallup, NM",23700.0,2019-04-01,6,0,6
"Gallup, NM",23700.0,2019-05-01,14,0,14
"Gallup, NM",23700.0,2019-06-01,6,0,6
"Gallup, NM",23700.0,2019-07-01,-2,0,-2
"Gallup, NM",23700.0,2019-08-01,-2,0,-2
"Gallup, NM",23700.0,2019-09-01,27,0,27
"Gallup, NM",23700.0,2019-10-01,-20,0,-20
"Gallup, NM",23700.0,2019-11-01,-13,0,-13
"Gallup, NM",23700.0,2019-12-01,12,0,12
"Gallup, NM",23700.0,2020-01-01,7,0,7
"Gallup, NM",23700.0,2020-02-01,14,0,14
"Gallup, NM",23700.0,2020-03-01,12,0,12
"Gallup, NM",23700.0,2020-04-01,25,0,25
"Gallup, NM",23700.0,2020-05-01,25,0,25
"Gallup, NM",23700.0,2020-06-01,7,0,7
"Gallup, NM",23700.0,2020-07-01,-15,0,-15
"Gallup, NM",23700.0,2020-08-01,11,0,11
"Gallup, NM",23700.0,2020-09-01,8,0,8
"Gallup, NM",23700.0,2020-10-01,-2,0,-2
"Gallup, NM",23700.0,2020-11-01,18,0,18
"Gallup, NM",23700.0,2020-12-01,-1,0,-1
"Bloomington, IL",14010.0,2019-01-01,-74,-69,-5
"Bloomington, IL",14010.0,2019-02-01,-59,0,-59
"Bloomington, IL",14010.0,2019-03-01,-38,0,-38
"Bloomington, IL",14010.0,2019-04-01,113,45,68
"Bloomington, IL",14010.0,2019-05-01,-47,57,-104
"Bloomington, IL",14010.0,2019-06-01,-13,0,-13
"Bloomington, IL",14010.0,2019-07-01,32,0,32
"Bloomington, IL",14010.0,2019-08-01,-7,0,-7
"Bloomington, IL",14010.0,2019-09-01,75,0,75
"Bloomington, IL",14010.0,2019-10-01,-109,-48,-61
"Bloomington, IL",14010.0,2019-11-01,-40,-47,7
"Bloomington, IL",14010.0,2019-12-01,-140,-131,-9
"Bloomington, IL",14010.0,2020-01-01,-77,-75,-2
"Bloomington, IL",14010.0,2020-02-01,-7,0,-7
"Bloomington, IL",14010.0,2020-03-01,31,2,29
"Bloomington, IL",14010.0,2020-04-01,25,30,-5
"Bloomington, IL",14010.0,2020-05-01,-5,46,-51
"Bloomington, IL",14010.0,2020-06-01,-22,31,-53
"Bloomington, IL",14010.0,2020-07-01,-22,0,-22
"Bloomington, IL",14010.0,2020-08-01,27,0,27
"Bloomington, IL",14010.0,2020-09-01,71,0,71
"Bloomington, IL",14010.0,2020-10-01,-78,-51,-27
"Bloomington, IL",14010.0,2020-11-01,-40,-49,9
"Bloomington, IL",14010.0,2020-12-01,-131,-107,-24
"Hutchinson, MN",26780.0,2019-01-01,21,-15,36
"Hutchinson, MN",26780.0,2019-02-01,5,0,5
"Hutchinson, MN",26780.0,2019-03-01,-12,0,-12
"Hutchinson, MN",26780.0,2019-04-01,3,27,-24
"Hutchinson, MN",26780.0,2019-05-01,-9,0,-9
"Hutchinson, MN",26780.0,2019-06-01,31,0,31
"Hutchinson, MN",26780.0,2019-07-01,25,0,25
"Hutchinson, MN",26780.0,2019-08-01,18,0,18
"Hutchinson, MN",26780.0,2019-09-01,15,0,15
"Hutchinson, MN",26780.0,2019-10-01,-25,-43,18
"Hutchinson, MN",26780.0,2019-11-01,-14,-33,19
"Hutchinson, MN",26780.0,2019-12-01,-49,-50,1
"Hutchinson, MN",26780.0,2020-01-01,-10,-21,11
"Hutchinson, MN",26780.0,2020-02-01,-13,0,-13
"Hutchinson, MN",26780.0,2020-03-01,15,0,15
"Hutchinson, MN",26780.0,2020-04-01,34,0,34
"Hutchinson, MN",26780.0,2020-05-01,44,0,44
"Hutchinson, MN",26780.0,2020-06-01,7,0,7
"Hutchinson, MN",26780.0,2020-07-01,-16,0,-16
"Hutchinson, MN",26780.0,2020-08-01,34,0,34
"Hutchinson, MN",26780.0,2020-09-01,11,0,11
"Hutchinson, MN",26780.0,2020-10-01,-12,-31,19
"Hutchinson, MN",26780.0,2020-11-01,-21,-12,-9
"Hutchinson, MN",26780.0,2020-12-01,4,-36,40
"Athens, TN",11940.0,2019-01-01,12,0,12
"Athens, TN",11940.0,2019-02-01,24,0,24
"Athens, TN",11940.0,2019-03-01,13,0,13
"Athens, TN",11940.0,2019-04-01,-14,0,-14
"Athens, TN",11940.0,2019-05-01,53,0,53
"Athens, TN",11940.0,2019-06-01,21,0,21
"Athens, TN",11940.0,2019-07-01,-34,0,-34
"Athens, TN",11940.0,2019-08-01,19,0,19
"Athens, TN",11940.0,2019-09-01,2,0,2
"Athens, TN",11940.0,2019-10-01,22,0,22
"Athens, TN",11940.0,2019-11-01,36,0,36
"Athens, TN",11940.0,2019-12-01,4,0,4
"Athens, TN",11940.0,2020-01-01,7,0,7
"Athens, TN",11940.0,2020-02-01,12,0,12
"Athens, TN",11940.0,2020-03-01,7,0,7
"Athens, TN",11940.0,2020-04-01,74,0,74
"Athens, TN",11940.0,2020-05-01,32,0,32
"Athens, TN",11940.0,2020-06-01,32,0,32
"Athens, TN",11940.0,2020-07-01,11,0,11
"Athens, TN",11940.0,2020-08-01,23,0,23
"Athens, TN",11940.0,2020-09-01,-9,0,-9
"Athens, TN",11940.0,2020-10-01,5,0,5
"Athens, TN",11940.0,2020-11-01,0,0,0
"Athens, TN",11940.0,2020-12-01,35,0,35
"McPherson, KS",32700.0,2019-01-01,-25,0,-25
"McPherson, KS",32700.0,2019-02-01,0,0,0
"McPherson, KS",32700.0,2019-03-01,13,0,13
"McPherson, KS",32700.0,2019-04-01,-36,0,-36
"McPherson, KS",32700.0,2019-05-01,-25,0,-25
"McPherson, KS",32700.0,2019-06-01,14,0,14
"McPherson, KS",32700.0,2019-07-01,10,0,10
"McPherson, KS",32700.0,2019-08-01,11,0,11
"McPherson, KS",32700.0,2019-09-01,40,0,40
"McPherson, KS",32700.0,2019-10-01,-15,0,-15
"McPherson, KS",32700.0,2019-11-01,2,0,2
"McPherson, KS",32700.0,2019-12-01,-18,0,-18
"McPherson, KS",32700.0,2020-01-01,23,0,23
"McPherson, KS",32700.0,2020-02-01,-29,0,-29
"McPherson, KS",32700.0,2020-03-01,-15,0,-15
"McPherson, KS",32700.0,2020-04-01,37,0,37
"McPherson, KS",32700.0,2020-05-01,21,0,21
"McPherson, KS",32700.0,2020-06-01,21,0,21
"McPherson, KS",32700.0,2020-07-01,18,0,18
"McPherson, KS",32700.0,2020-08-01,2,0,2
"McPherson, KS",32700.0,2020-09-01,1,0,1
"McPherson, KS",32700.0,2020-10-01,11,0,11
"McPherson, KS",32700.0,2020-11-01,-13,0,-13
"McPherson, KS",32700.0,2020-12-01,25,0,25
"Rapid City, SD",39660.0,2019-01-01,-29,-55,26
"Rapid City, SD",39660.0,2019-02-01,21,-14,35
"Rapid City, SD",39660.0,2019-03-01,34,0,34
"Rapid City, SD",39660.0,2019-04-01,207,117,90
"Rapid City, SD",39660.0,2019-05-01,206,129,77
"Rapid City, SD",39660.0,2019-06-01,119,25,94
"Rapid City, SD",39660.0,2019-07-01,49,0,49
"Rapid City, SD",39660.0,2019-08-01,30,0,30
"Rapid City, SD",39660.0,2019-09-01,12,-13,25
"Rapid City, SD",39660.0,2019-10-01,-138,-164,26
"Rapid City, SD",39660.0,2019-11-01,-124,-109,-15
"Rapid City, SD",39660.0,2019-12-01,-44,-97,53
"Rapid City, SD",39660.0,2020-01-01,-38,-61,23
"Rapid City, SD",39660.0,2020-02-01,40,-12,52
"Rapid City, SD",39660.0,2020-03-01,51,13,38
"Rapid City, SD",39660.0,2020-04-01,76,36,40
"Rapid City, SD",39660.0,2020-05-01,137,72,65
"Rapid City, SD",39660.0,2020-06-01,73,36,37
"Rapid City, SD",39660.0,2020-07-01,29,0,29
"Rapid City, SD",39660.0,2020-08-01,68,0,68
"Rapid City, SD",39660.0,2020-09-01,70,0,70
"Rapid City, SD",39660.0,2020-10-01,-196,-171,-25
"Rapid City, SD",39660.0,2020-11-01,-97,-114,17
"Rapid City, SD",39660.0,2020-12-01,-27,-74,47
"Big Rapids, MI",13660.0,2019-01-01,-1,0,-1
"Big Rapids, MI",13660.0,2019-02-01,13,0,13
"Big Rapids, MI",13660.0,2019-03-01,43,0,43
"Big Rapids, MI",13660.0,2019-04-01,42,58,-16
"Big Rapids, MI",13660.0,2019-05-01,88,52,36
"Big Rapids, MI",13660.0,2019-06-01,21,0,21
"Big Rapids, MI",13660.0,2019-07-01,-35,0,-35
"Big Rapids, MI",13660.0,2019-08-01,-61,0,-61
"Big Rapids, MI",13660.0,2019-09-01,-3,0,-3
"Big Rapids, MI",13660.0,2019-10-01,-89,-76,-13
"Big Rapids, MI",13660.0,2019-11-01,-4,-44,40
"Big Rapids, MI",13660.0,2019-12-01,-36,-44,8
"Big Rapids, MI",13660.0,2020-01-01,-19,-13,-6
"Big Rapids, MI",13660.0,2020-02-01,-9,0,-9
"Big Rapids, MI",13660.0,2020-03-01,41,0,41
"Big Rapids, MI",13660.0,2020-04-01,1,0,1
"Big Rapids, MI",13660.0,2020-05-01,64,50,14
"Big Rapids, MI",13660.0,2020-06-01,24,0,24
"Big Rapids, MI",13660.0,2020-07-01,62,0,62
"Big Rapids, MI",13660.0,2020-08-01,29,0,29
"Big Rapids, MI",13660.0,2020-09-01,41,0,41
"Big Rapids, MI",13660.0,2020-10-01,-60,-92,32
"Big Rapids, MI",13660.0,2020-11-01,-44,-49,5
"Big Rapids, MI",13660.0,2020-12-01,-32,-66,34
"Springfield, IL",44100.0,2019-01-01,-101,-100,-1
"Springfield, IL",44100.0,2019-02-01,27,0,27
"Springfield, IL",44100.0,2019-03-01,-8,0,-8
"Springfield, IL",44100.0,2019-04-01,113,72,41
"Springfield, IL",44100.0,2019-05-01,35,71,-36
"Springfield, IL",44100.0,2019-06-01,33,0,33
"Springfield, IL",44100.0,2019-07-01,-9,0,-9
"Springfield, IL",44100.0,2019-08-01,-32,0,-32
"Springfield, IL",44100.0,2019-09-01,-10,0,-10
"Springfield, IL",44100.0,2019-10-01,-60,-99,39
"Springfield, IL",44100.0,2019-11-01,-93,-72,-21
"Springfield, IL",44100.0,2019-12-01,-106,-181,75
"Springfield, IL",44100.0,2020-01-01,-118,-103,-15
"Springfield, IL",44100.0,2020-02-01,42,0,42
"Springfield, IL",44100.0,2020-03-01,43,29,14
"Springfield, IL",44100.0,2020-04-01,74,75,-1
"Springfield, IL",44100.0,2020-05-01,116,41,75
"Springfield, IL",44100.0,2020-06-01,36,0,36
"Springfield, IL",44100.0,2020-07-01,58,0,58
"Springfield, IL",44100.0,2020-08-01,20,0,20
"Springfield, IL",44100.0,2020-09-01,27,0,27
"Springfield, IL",44100.0,2020-10-01,-84,-97,13
"Springfield, IL",44100.0,2020-11-01,-66,-78,12
"Springfield, IL",44100.0,2020-12-01,-109,-134,25
"Ukiah, CA",46380.0,2019-01-01,4,0,4
"Ukiah, CA",46380.0,2019-02-01,8,0,8
"Ukiah, CA",46380.0,2019-03-01,38,0,38
"Ukiah, CA",46380.0,2019-04-01,-32,0,-32
"Ukiah, CA",46380.0,2019-05-01,61,0,61
"Ukiah, CA",46380.0,2019-06-01,18,0,18
"Ukiah, CA",46380.0,2019-07-01,5,0,5
"Ukiah, CA",46380.0,2019-08-01,-25,0,-25
"Ukiah, CA",46380.0,2019-09-01,-11,0,-11
"Ukiah, CA",46380.0,2019-10-01,-9,0,-9
"Ukiah, CA",46380.0,2019-11-01,6,0,6
"Ukiah, CA",46380.0,2019-12-01,-20,0,-20
"Ukiah, CA",46380.0,2020-01-01,25,-13,38
"Ukiah, CA",46380.0,2020-02-01,-25,0,-25
"Ukiah, CA",46380.0,2020-03-01,48,37,11
"Ukiah, CA",46380.0,2020-04-01,82,14,68
"Ukiah, CA",46380.0,2020-05-01,57,13,44
"Ukiah, CA",46380.0,2020-06-01,17,0,17
"Ukiah, CA",46380.0,2020-07-01,65,0,65
"Ukiah, CA",46380.0,2020-08-01,89,0,89
"Ukiah, CA",46380.0,2020-09-01,32,0,32
"Ukiah, CA",46380.0,2020-10-01,43,0,43
"Ukiah, CA",46380.0,2020-11-01,16,0,16
"Ukiah, CA",46380.0,2020-12-01,41,14,27
"Merced, CA",32900.0,2019-01-01,167,0,167
"Merced, CA",32900.0,2019-02-01,58,0,58
"Merced, CA",32900.0,2019-03-01,20,0,20
"Merced, CA",32900.0,2019-04-01,74,0,74
"Merced, CA",32900.0,2019-05-01,-19,0,-19
"Merced, CA",32900.0,2019-06-01,56,0,56
"Merced, CA",32900.0,2019-07-01,111,0,111
"Merced, CA",32900.0,2019-08-01,-44,0,-44
"Merced, CA",32900.0,2019-09-01,133,0,133
"Merced, CA",32900.0,2019-10-01,45,0,45
"Merced, CA",32900.0,2019-11-01,120,0,120
"Merced, CA",32900.0,2019-12-01,91,0,91
"Merced, CA",32900.0,2020-01-01,115,0,115
"Merced, CA",32900.0,2020-02-01,93,0,93
"Merced, CA",32900.0,2020-03-01,133,0,133
"Merced, CA",32900.0,2020-04-01,190,0,190
"Merced, CA",32900.0,2020-05-01,123,0,123
"Merced, CA",32900.0,2020-06-01,148,0,148
"Merced, CA",32900.0,2020-07-01,278,0,278
"Merced, CA",32900.0,2020-08-01,193,0,193
"Merced, CA",32900.0,2020-09-01,143,12,131
"Merced, CA",32900.0,2020-10-01,127,0,127
"Merced, CA",32900.0,2020-11-01,248,0,248
"Merced, CA",32900.0,2020-12-01,158,0,158
"Trenton-Princeton, NJ",45940.0,2019-01-01,-2,-84,82
"Trenton-Princeton, NJ",45940.0,2019-02-01,23,0,23
"Trenton-Princeton, NJ",45940.0,2019-03-01,100,0,100
"Trenton-Princeton, NJ",45940.0,2019-04-01,180,70,110
"Trenton-Princeton, NJ",45940.0,2019-05-01,170,95,75
"Trenton-Princeton, NJ",45940.0,2019-06-01,19,35,-16
"Trenton-Princeton, NJ",45940.0,2019-07-01,-40,-14,-26
"Trenton-Princeton, NJ",45940.0,2019-08-01,51,-3,54
"Trenton-Princeton, NJ",45940.0,2019-09-01,97,13,84
"Trenton-Princeton, NJ",45940.0,2019-10-01,22,-29,51
"Trenton-Princeton, NJ",45940.0,2019-11-01,21,-2,23
"Trenton-Princeton, NJ",45940.0,2019-12-01,-14,-88,74
"Trenton-Princeton, NJ",45940.0,2020-01-01,0,-70,70
"Trenton-Princeton, NJ",45940.0,2020-02-01,83,0,83
"Trenton-Princeton, NJ",45940.0,2020-03-01,6,34,-28
"Trenton-Princeton, NJ",45940.0,2020-04-01,122,102,20
"Trenton-Princeton, NJ",45940.0,2020-05-01,190,90,100
"Trenton-Princeton, NJ",45940.0,2020-06-01,80,76,4
"Trenton-Princeton, NJ",45940.0,2020-07-01,201,53,148
"Trenton-Princeton, NJ",45940.0,2020-08-01,178,20,158
"Trenton-Princeton, NJ",45940.0,2020-09-01,217,22,195
"Trenton-Princeton, NJ",45940.0,2020-10-01,119,-44,163
"Trenton-Princeton, NJ",45940.0,2020-11-01,189,-2,191
"Trenton-Princeton, NJ",45940.0,2020-12-01,-12,-65,53
"Celina, OH",16380.0,2019-01-01,-20,0,-20
"Celina, OH",16380.0,2019-02-01,17,0,17
"Celina, OH",16380.0,2019-03-01,5,0,5
"Celina, OH",16380.0,2019-04-01,-4,0,-4
"Celina, OH",16380.0,2019-05-01,-19,0,-19
"Celina, OH",16380.0,2019-06-01,1,0,1
"Celina, OH",16380.0,2019-07-01,-28,0,-28
"Celina, OH",16380.0,2019-08-01,1,0,1
"Celina, OH",16380.0,2019-09-01,-16,0,-16
"Celina, OH",16380.0,2019-10-01,0,-14,14
"Celina, OH",16380.0,2019-11-01,12,0,12
"Celina, OH",16380.0,2019-12-01,0,0,0
"Celina, OH",16380.0,2020-01-01,4,0,4
"Celina, OH",16380.0,2020-02-01,7,0,7
"Celina, OH",16380.0,2020-03-01,-15,0,-15
"Celina, OH",16380.0,2020-04-01,-4,0,-4
"Celina, OH",16380.0,2020-05-01,-3,0,-3
"Celina, OH",16380.0,2020-06-01,5,0,5
"Celina, OH",16380.0,2020-07-01,-11,0,-11
"Celina, OH",16380.0,2020-08-01,4,0,4
"Celina, OH",16380.0,2020-09-01,8,0,8
"Celina, OH",16380.0,2020-10-01,9,-11,20
"Celina, OH",16380.0,2020-11-01,-2,0,-2
"Celina, OH",16380.0,2020-12-01,-14,-11,-3
"Bluefield, WV-VA",14140.0,2019-01-01,-13,0,-13
"Bluefield, WV-VA",14140.0,2019-02-01,16,0,16
"Bluefield, WV-VA",14140.0,2019-03-01,-28,0,-28
"Bluefield, WV-VA",14140.0,2019-04-01,13,0,13
"Bluefield, WV-VA",14140.0,2019-05-01,0,0,0
"Bluefield, WV-VA",14140.0,2019-06-01,0,0,0
"Bluefield, WV-VA",14140.0,2019-07-01,22,0,22
"Bluefield, WV-VA",14140.0,2019-08-01,12,0,12
"Bluefield, WV-VA",14140.0,2019-09-01,12,0,12
"Bluefield, WV-VA",14140.0,2019-10-01,46,0,46
"Bluefield, WV-VA",14140.0,2019-11-01,-2,0,-2
"Bluefield, WV-VA",14140.0,2019-12-01,0,0,0
"Bluefield, WV-VA",14140.0,2020-01-01,11,0,11
"Bluefield, WV-VA",14140.0,2020-02-01,0,0,0
"Bluefield, WV-VA",14140.0,2020-03-01,19,0,19
"Bluefield, WV-VA",14140.0,2020-04-01,0,0,0
"Bluefield, WV-VA",14140.0,2020-05-01,-11,0,-11
"Bluefield, WV-VA",14140.0,2020-06-01,-14,0,-14
"Bluefield, WV-VA",14140.0,2020-07-01,18,0,18
"Bluefield, WV-VA",14140.0,2020-08-01,24,0,24
"Bluefield, WV-VA",14140.0,2020-09-01,20,0,20
"Bluefield, WV-VA",14140.0,2020-10-01,12,0,12
"Bluefield, WV-VA",14140.0,2020-11-01,14,0,14
"Bluefield, WV-VA",14140.0,2020-12-01,-13,0,-13
"Concord, NH",18180.0,2019-01-01,66,-43,109
"Concord, NH",18180.0,2019-02-01,53,0,53
"Concord, NH",18180.0,2019-03-01,90,13,77
"Concord, NH",18180.0,2019-04-01,165,114,51
"Concord, NH",18180.0,2019-05-01,278,181,97
"Concord, NH",18180.0,2019-06-01,163,24,139
"Concord, NH",18180.0,2019-07-01,126,0,126
"Concord, NH",18180.0,2019-08-01,96,12,84
"Concord, NH",18180.0,2019-09-01,148,0,148
"Concord, NH",18180.0,2019-10-01,-155,-166,11
"Concord, NH",18180.0,2019-11-01,-41,-76,35
"Concord, NH",18180.0,2019-12-01,-55,-103,48
"Concord, NH",18180.0,2020-01-01,31,-41,72
"Concord, NH",18180.0,2020-02-01,25,0,25
"Concord, NH",18180.0,2020-03-01,186,73,113
"Concord, NH",18180.0,2020-04-01,163,69,94
"Concord, NH",18180.0,2020-05-01,194,120,74
"Concord, NH",18180.0,2020-06-01,133,56,77
"Concord, NH",18180.0,2020-07-01,104,0,104
"Concord, NH",18180.0,2020-08-01,171,0,171
"Concord, NH",18180.0,2020-09-01,171,12,159
"Concord, NH",18180.0,2020-10-01,26,-98,124
"Concord, NH",18180.0,2020-11-01,-6,-108,102
"Concord, NH",18180.0,2020-12-01,47,-47,94
"Grand Junction, CO",24300.0,2019-01-01,19,0,19
"Grand Junction, CO",24300.0,2019-02-01,-24,0,-24
"Grand Junction, CO",24300.0,2019-03-01,66,0,66
"Grand Junction, CO",24300.0,2019-04-01,58,44,14
"Grand Junction, CO",24300.0,2019-05-01,-49,0,-49
"Grand Junction, CO",24300.0,2019-06-01,18,0,18
"Grand Junction, CO",24300.0,2019-07-01,35,0,35
"Grand Junction, CO",24300.0,2019-08-01,121,0,121
"Grand Junction, CO",24300.0,2019-09-01,40,0,40
"Grand Junction, CO",24300.0,2019-10-01,60,-46,106
"Grand Junction, CO",24300.0,2019-11-01,-8,-46,38
"Grand Junction, CO",24300.0,2019-12-01,-44,-28,-16
"Grand Junction, CO",24300.0,2020-01-01,25,-22,47
"Grand Junction, CO",24300.0,2020-02-01,13,0,13
"Grand Junction, CO",24300.0,2020-03-01,94,11,83
"Grand Junction, CO",24300.0,2020-04-01,79,17,62
"Grand Junction, CO",24300.0,2020-05-01,72,18,54
"Grand Junction, CO",24300.0,2020-06-01,56,0,56
"Grand Junction, CO",24300.0,2020-07-01,56,0,56
"Grand Junction, CO",24300.0,2020-08-01,83,0,83
"Grand Junction, CO",24300.0,2020-09-01,74,0,74
"Grand Junction, CO",24300.0,2020-10-01,60,-31,91
"Grand Junction, CO",24300.0,2020-11-01,0,-54,54
"Grand Junction, CO",24300.0,2020-12-01,-56,-37,-19
"Peru, IN",37940.0,2019-01-01,-4,0,-4
"Peru, IN",37940.0,2019-02-01,-15,0,-15
"Peru, IN",37940.0,2019-03-01,11,0,11
"Peru, IN",37940.0,2019-04-01,-10,0,-10
"Peru, IN",37940.0,2019-05-01,34,0,34
"Peru, IN",37940.0,2019-06-01,4,0,4
"Peru, IN",37940.0,2019-07-01,11,0,11
"Peru, IN",37940.0,2019-08-01,-8,0,-8
"Peru, IN",37940.0,2019-09-01,-25,0,-25
"Peru, IN",37940.0,2019-10-01,-10,-12,2
"Peru, IN",37940.0,2019-11-01,-16,0,-16
"Peru, IN",37940.0,2019-12-01,-46,-13,-33
"Peru, IN",37940.0,2020-01-01,-17,0,-17
"Peru, IN",37940.0,2020-02-01,-23,0,-23
"Peru, IN",37940.0,2020-03-01,11,0,11
"Peru, IN",37940.0,2020-04-01,22,0,22
"Peru, IN",37940.0,2020-05-01,-13,0,-13
"Peru, IN",37940.0,2020-06-01,20,0,20
"Peru, IN",37940.0,2020-07-01,3,0,3
"Peru, IN",37940.0,2020-08-01,-23,0,-23
"Peru, IN",37940.0,2020-09-01,21,0,21
"Peru, IN",37940.0,2020-10-01,-17,-11,-6
"Peru, IN",37940.0,2020-11-01,-13,0,-13
"Peru, IN",37940.0,2020-12-01,-19,-16,-3
"Midland, MI",33220.0,2019-01-01,-21,-64,43
"Midland, MI",33220.0,2019-02-01,16,0,16
"Midland, MI",33220.0,2019-03-01,34,0,34
"Midland, MI",33220.0,2019-04-01,82,39,43
"Midland, MI",33220.0,2019-05-01,50,18,32
"Midland, MI",33220.0,2019-06-01,40,0,40
"Midland, MI",33220.0,2019-07-01,58,0,58
"Midland, MI",33220.0,2019-08-01,37,0,37
"Midland, MI",33220.0,2019-09-01,33,0,33
"Midland, MI",33220.0,2019-10-01,-63,-73,10
"Midland, MI",33220.0,2019-11-01,-79,-73,-6
"Midland, MI",33220.0,2019-12-01,-78,-93,15
"Midland, MI",33220.0,2020-01-01,-18,-38,20
"Midland, MI",33220.0,2020-02-01,24,0,24
"Midland, MI",33220.0,2020-03-01,22,0,22
"Midland, MI",33220.0,2020-04-01,17,0,17
"Midland, MI",33220.0,2020-05-01,46,23,23
"Midland, MI",33220.0,2020-06-01,13,13,0
"Midland, MI",33220.0,2020-07-01,10,0,10
"Midland, MI",33220.0,2020-08-01,-28,0,-28
"Midland, MI",33220.0,2020-09-01,-3,0,-3
"Midland, MI",33220.0,2020-10-01,-91,-43,-48
"Midland, MI",33220.0,2020-11-01,-15,-40,25
"Midland, MI",33220.0,2020-12-01,-14,-62,48
"Lewistown, PA",30380.0,2019-01-01,14,0,14
"Lewistown, PA",30380.0,2019-02-01,-2,0,-2
"Lewistown, PA",30380.0,2019-03-01,28,0,28
"Lewistown, PA",30380.0,2019-04-01,-6,0,-6
"Lewistown, PA",30380.0,2019-05-01,25,0,25
"Lewistown, PA",30380.0,2019-06-01,32,0,32
"Lewistown, PA",30380.0,2019-07-01,-12,0,-12
"Lewistown, PA",30380.0,2019-08-01,38,0,38
"Lewistown, PA",30380.0,2019-09-01,21,0,21
"Lewistown, PA",30380.0,2019-10-01,1,0,1
"Lewistown, PA",30380.0,2019-11-01,15,0,15
"Lewistown, PA",30380.0,2019-12-01,5,0,5
"Lewistown, PA",30380.0,2020-01-01,18,0,18
"Lewistown, PA",30380.0,2020-02-01,0,0,0
"Lewistown, PA",30380.0,2020-03-01,8,0,8
"Lewistown, PA",30380.0,2020-04-01,8,0,8
"Lewistown, PA",30380.0,2020-05-01,-6,0,-6
"Lewistown, PA",30380.0,2020-06-01,1,0,1
"Lewistown, PA",30380.0,2020-07-01,39,0,39
"Lewistown, PA",30380.0,2020-08-01,-11,0,-11
"Lewistown, PA",30380.0,2020-09-01,1,0,1
"Lewistown, PA",30380.0,2020-10-01,2,0,2
"Lewistown, PA",30380.0,2020-11-01,23,0,23
"Lewistown, PA",30380.0,2020-12-01,10,0,10
"Milwaukee-Waukesha, WI",33340.0,2019-01-01,-1476,-1309,-167
"Milwaukee-Waukesha, WI",33340.0,2019-02-01,-353,-209,-144
"Milwaukee-Waukesha, WI",33340.0,2019-03-01,-138,-38,-100
"Milwaukee-Waukesha, WI",33340.0,2019-04-01,706,691,15
"Milwaukee-Waukesha, WI",33340.0,2019-05-01,1203,1384,-181
"Milwaukee-Waukesha, WI",33340.0,2019-06-01,117,195,-78
"Milwaukee-Waukesha, WI",33340.0,2019-07-01,-340,25,-365
"Milwaukee-Waukesha, WI",33340.0,2019-08-01,-356,14,-370
"Milwaukee-Waukesha, WI",33340.0,2019-09-01,-379,-79,-300
"Milwaukee-Waukesha, WI",33340.0,2019-10-01,-1476,-972,-504
"Milwaukee-Waukesha, WI",33340.0,2019-11-01,-798,-555,-243
"Milwaukee-Waukesha, WI",33340.0,2019-12-01,-1249,-1063,-186
"Milwaukee-Waukesha, WI",33340.0,2020-01-01,-1301,-1286,-15
"Milwaukee-Waukesha, WI",33340.0,2020-02-01,-4,-180,176
"Milwaukee-Waukesha, WI",33340.0,2020-03-01,21,74,-53
"Milwaukee-Waukesha, WI",33340.0,2020-04-01,306,253,53
"Milwaukee-Waukesha, WI",33340.0,2020-05-01,1083,962,121
"Milwaukee-Waukesha, WI",33340.0,2020-06-01,225,465,-240
"Milwaukee-Waukesha, WI",33340.0,2020-07-01,-173,74,-247
"Milwaukee-Waukesha, WI",33340.0,2020-08-01,-269,43,-312
"Milwaukee-Waukesha, WI",33340.0,2020-09-01,-619,-104,-515
"Milwaukee-Waukesha, WI",33340.0,2020-10-01,-1281,-978,-303
"Milwaukee-Waukesha, WI",33340.0,2020-11-01,-833,-609,-224
"Milwaukee-Waukesha, WI",33340.0,2020-12-01,-1286,-943,-343
"Cadillac, MI",15620.0,2019-01-01,-27,-11,-16
"Cadillac, MI",15620.0,2019-02-01,-31,0,-31
"Cadillac, MI",15620.0,2019-03-01,-17,0,-17
"Cadillac, MI",15620.0,2019-04-01,39,11,28
"Cadillac, MI",15620.0,2019-05-01,26,0,26
"Cadillac, MI",15620.0,2019-06-01,24,0,24
"Cadillac, MI",15620.0,2019-07-01,8,0,8
"Cadillac, MI",15620.0,2019-08-01,21,0,21
"Cadillac, MI",15620.0,2019-09-01,14,0,14
"Cadillac, MI",15620.0,2019-10-01,-15,-13,-2
"Cadillac, MI",15620.0,2019-11-01,-20,-13,-7
"Cadillac, MI",15620.0,2019-12-01,-12,-12,0
"Cadillac, MI",15620.0,2020-01-01,2,0,2
"Cadillac, MI",15620.0,2020-02-01,23,0,23
"Cadillac, MI",15620.0,2020-03-01,-21,0,-21
"Cadillac, MI",15620.0,2020-04-01,-5,0,-5
"Cadillac, MI",15620.0,2020-05-01,29,0,29
"Cadillac, MI",15620.0,2020-06-01,10,0,10
"Cadillac, MI",15620.0,2020-07-01,15,0,15
"Cadillac, MI",15620.0,2020-08-01,7,0,7
"Cadillac, MI",15620.0,2020-09-01,11,0,11
"Cadillac, MI",15620.0,2020-10-01,-23,-12,-11
"Cadillac, MI",15620.0,2020-11-01,-8,-26,18
"Cadillac, MI",15620.0,2020-12-01,4,0,4
"Blytheville, AR",14180.0,2019-01-01,-4,0,-4
"Blytheville, AR",14180.0,2019-02-01,-21,0,-21
"Blytheville, AR",14180.0,2019-03-01,-7,0,-7
"Blytheville, AR",14180.0,2019-04-01,-5,0,-5
"Blytheville, AR",14180.0,2019-05-01,-24,0,-24
"Blytheville, AR",14180.0,2019-06-01,-14,0,-14
"Blytheville, AR",14180.0,2019-07-01,0,0,0
"Blytheville, AR",14180.0,2019-08-01,6,0,6
"Blytheville, AR",14180.0,2019-09-01,3,0,3
"Blytheville, AR",14180.0,2019-10-01,4,0,4
"Blytheville, AR",14180.0,2019-11-01,-5,0,-5
"Blytheville, AR",14180.0,2019-12-01,0,0,0
"Blytheville, AR",14180.0,2020-01-01,-17,0,-17
"Blytheville, AR",14180.0,2020-02-01,-14,0,-14
"Blytheville, AR",14180.0,2020-03-01,3,0,3
"Blytheville, AR",14180.0,2020-04-01,-14,0,-14
"Blytheville, AR",14180.0,2020-05-01,-21,0,-21
"Blytheville, AR",14180.0,2020-06-01,-8,0,-8
"Blytheville, AR",14180.0,2020-07-01,-33,0,-33
"Blytheville, AR",14180.0,2020-08-01,10,0,10
"Blytheville, AR",14180.0,2020-09-01,-14,0,-14
"Blytheville, AR",14180.0,2020-10-01,-3,0,-3
"Blytheville, AR",14180.0,2020-11-01,-24,0,-24
"Blytheville, AR",14180.0,2020-12-01,-1,0,-1
"Missoula, MT",33540.0,2019-01-01,-38,-35,-3
"Missoula, MT",33540.0,2019-02-01,8,0,8
"Missoula, MT",33540.0,2019-03-01,-18,0,-18
"Missoula, MT",33540.0,2019-04-01,130,64,66
"Missoula, MT",33540.0,2019-05-01,-40,57,-97
"Missoula, MT",33540.0,2019-06-01,-35,14,-49
"Missoula, MT",33540.0,2019-07-01,-108,0,-108
"Missoula, MT",33540.0,2019-08-01,-24,0,-24
"Missoula, MT",33540.0,2019-09-01,-6,-12,6
"Missoula, MT",33540.0,2019-10-01,-183,-120,-63
"Missoula, MT",33540.0,2019-11-01,-132,-89,-43
"Missoula, MT",33540.0,2019-12-01,-37,-28,-9
"Missoula, MT",33540.0,2020-01-01,-28,-13,-15
"Missoula, MT",33540.0,2020-02-01,-41,0,-41
"Missoula, MT",33540.0,2020-03-01,31,3,28
"Missoula, MT",33540.0,2020-04-01,55,23,32
"Missoula, MT",33540.0,2020-05-01,-7,56,-63
"Missoula, MT",33540.0,2020-06-01,-3,19,-22
"Missoula, MT",33540.0,2020-07-01,-145,0,-145
"Missoula, MT",33540.0,2020-08-01,-5,0,-5
"Missoula, MT",33540.0,2020-09-01,-8,-12,4
"Missoula, MT",33540.0,2020-10-01,-155,-110,-45
"Missoula, MT",33540.0,2020-11-01,-155,-58,-97
"Missoula, MT",33540.0,2020-12-01,-52,-27,-25
"Mobile, AL",33660.0,2019-01-01,-41,0,-41
"Mobile, AL",33660.0,2019-02-01,-18,0,-18
"Mobile, AL",33660.0,2019-03-01,-46,0,-46
"Mobile, AL",33660.0,2019-04-01,-114,0,-114
"Mobile, AL",33660.0,2019-05-01,-123,0,-123
"Mobile, AL",33660.0,2019-06-01,-83,0,-83
"Mobile, AL",33660.0,2019-07-01,-49,0,-49
"Mobile, AL",33660.0,2019-08-01,-17,0,-17
"Mobile, AL",33660.0,2019-09-01,-115,0,-115
"Mobile, AL",33660.0,2019-10-01,-71,0,-71
"Mobile, AL",33660.0,2019-11-01,30,0,30
"Mobile, AL",33660.0,2019-12-01,-73,0,-73
"Mobile, AL",33660.0,2020-01-01,-102,0,-102
"Mobile, AL",33660.0,2020-02-01,-63,0,-63
"Mobile, AL",33660.0,2020-03-01,-47,-13,-34
"Mobile, AL",33660.0,2020-04-01,-62,-16,-46
"Mobile, AL",33660.0,2020-05-01,-18,0,-18
"Mobile, AL",33660.0,2020-06-01,-48,0,-48
"Mobile, AL",33660.0,2020-07-01,-41,0,-41
"Mobile, AL",33660.0,2020-08-01,-64,0,-64
"Mobile, AL",33660.0,2020-09-01,-91,0,-91
"Mobile, AL",33660.0,2020-10-01,-40,12,-52
"Mobile, AL",33660.0,2020-11-01,-11,0,-11
"Mobile, AL",33660.0,2020-12-01,-10,0,-10
"Craig, CO",18780.0,2019-01-01,0,0,0
"Craig, CO",18780.0,2019-02-01,0,0,0
"Craig, CO",18780.0,2019-03-01,15,0,15
"Craig, CO",18780.0,2019-04-01,0,0,0
"Craig, CO",18780.0,2019-05-01,0,0,0
"Craig, CO",18780.0,2019-06-01,0,0,0
"Craig, CO",18780.0,2019-07-01,4,0,4
"Craig, CO",18780.0,2019-08-01,-14,0,-14
"Craig, CO",18780.0,2019-09-01,0,0,0
"Craig, CO",18780.0,2019-10-01,-11,-11,0
"Craig, CO",18780.0,2019-11-01,0,0,0
"Craig, CO",18780.0,2019-12-01,0,0,0
"Craig, CO",18780.0,2020-01-01,0,0,0
"Craig, CO",18780.0,2020-02-01,0,0,0
"Craig, CO",18780.0,2020-03-01,-11,0,-11
"Craig, CO",18780.0,2020-04-01,-22,0,-22
"Craig, CO",18780.0,2020-05-01,0,0,0
"Craig, CO",18780.0,2020-06-01,0,0,0
"Craig, CO",18780.0,2020-07-01,12,0,12
"Craig, CO",18780.0,2020-08-01,0,0,0
"Craig, CO",18780.0,2020-09-01,0,0,0
"Craig, CO",18780.0,2020-10-01,12,0,12
"Craig, CO",18780.0,2020-11-01,0,0,0
"Craig, CO",18780.0,2020-12-01,0,0,0
"Lake Havasu City-Kingman, AZ",29420.0,2019-01-01,407,142,265
"Lake Havasu City-Kingman, AZ",29420.0,2019-02-01,240,0,240
"Lake Havasu City-Kingman, AZ",29420.0,2019-03-01,250,0,250
"Lake Havasu City-Kingman, AZ",29420.0,2019-04-01,-82,-203,121
"Lake Havasu City-Kingman, AZ",29420.0,2019-05-01,-56,-335,279
"Lake Havasu City-Kingman, AZ",29420.0,2019-06-01,129,-154,283
"Lake Havasu City-Kingman, AZ",29420.0,2019-07-01,187,-12,199
"Lake Havasu City-Kingman, AZ",29420.0,2019-08-01,218,0,218
"Lake Havasu City-Kingman, AZ",29420.0,2019-09-01,322,13,309
"Lake Havasu City-Kingman, AZ",29420.0,2019-10-01,1021,747,274
"Lake Havasu City-Kingman, AZ",29420.0,2019-11-01,483,312,171
"Lake Havasu City-Kingman, AZ",29420.0,2019-12-01,591,442,149
"Lake Havasu City-Kingman, AZ",29420.0,2020-01-01,302,160,142
"Lake Havasu City-Kingman, AZ",29420.0,2020-02-01,132,0,132
"Lake Havasu City-Kingman, AZ",29420.0,2020-03-01,248,35,213
"Lake Havasu City-Kingman, AZ",29420.0,2020-04-01,302,-15,317
"Lake Havasu City-Kingman, AZ",29420.0,2020-05-01,-23,-208,185
"Lake Havasu City-Kingman, AZ",29420.0,2020-06-01,148,-83,231
"Lake Havasu City-Kingman, AZ",29420.0,2020-07-01,173,-40,213
"Lake Havasu City-Kingman, AZ",29420.0,2020-08-01,264,0,264
"Lake Havasu City-Kingman, AZ",29420.0,2020-09-01,371,42,329
"Lake Havasu City-Kingman, AZ",29420.0,2020-10-01,900,571,329
"Lake Havasu City-Kingman, AZ",29420.0,2020-11-01,515,251,264
"Lake Havasu City-Kingman, AZ",29420.0,2020-12-01,499,289,210
"Morgantown, WV",34060.0,2019-01-01,-16,0,-16
"Morgantown, WV",34060.0,2019-02-01,-4,0,-4
"Morgantown, WV",34060.0,2019-03-01,10,0,10
"Morgantown, WV",34060.0,2019-04-01,-13,0,-13
"Morgantown, WV",34060.0,2019-05-01,-84,0,-84
"Morgantown, WV",34060.0,2019-06-01,-55,0,-55
"Morgantown, WV",34060.0,2019-07-01,-133,0,-133
"Morgantown, WV",34060.0,2019-08-01,38,0,38
"Morgantown, WV",34060.0,2019-09-01,-8,0,-8
"Morgantown, WV",34060.0,2019-10-01,-48,0,-48
"Morgantown, WV",34060.0,2019-11-01,36,0,36
"Morgantown, WV",34060.0,2019-12-01,-14,0,-14
"Morgantown, WV",34060.0,2020-01-01,-6,0,-6
"Morgantown, WV",34060.0,2020-02-01,-10,0,-10
"Morgantown, WV",34060.0,2020-03-01,-35,0,-35
"Morgantown, WV",34060.0,2020-04-01,-49,0,-49
"Morgantown, WV",34060.0,2020-05-01,-36,0,-36
"Morgantown, WV",34060.0,2020-06-01,-54,0,-54
"Morgantown, WV",34060.0,2020-07-01,-87,0,-87
"Morgantown, WV",34060.0,2020-08-01,13,0,13
"Morgantown, WV",34060.0,2020-09-01,-29,0,-29
"Morgantown, WV",34060.0,2020-10-01,-11,0,-11
"Morgantown, WV",34060.0,2020-11-01,-4,0,-4
"Morgantown, WV",34060.0,2020-12-01,-36,0,-36
"Key West, FL",28580.0,2019-01-01,413,469,-56
"Key West, FL",28580.0,2019-02-01,38,23,15
"Key West, FL",28580.0,2019-03-01,-25,0,-25
"Key West, FL",28580.0,2019-04-01,-259,-204,-55
"Key West, FL",28580.0,2019-05-01,-393,-379,-14
"Key West, FL",28580.0,2019-06-01,-43,-58,15
"Key West, FL",28580.0,2019-07-01,-8,0,-8
"Key West, FL",28580.0,2019-08-01,-53,0,-53
"Key West, FL",28580.0,2019-09-01,12,0,12
"Key West, FL",28580.0,2019-10-01,215,218,-3
"Key West, FL",28580.0,2019-11-01,233,240,-7
"Key West, FL",28580.0,2019-12-01,478,477,1
"Key West, FL",28580.0,2020-01-01,340,376,-36
"Key West, FL",28580.0,2020-02-01,8,24,-16
"Key West, FL",28580.0,2020-03-01,31,60,-29
"Key West, FL",28580.0,2020-04-01,34,111,-77
"Key West, FL",28580.0,2020-05-01,-88,-65,-23
"Key West, FL",28580.0,2020-06-01,-161,-158,-3
"Key West, FL",28580.0,2020-07-01,-55,-44,-11
"Key West, FL",28580.0,2020-08-01,-31,0,-31
"Key West, FL",28580.0,2020-09-01,-20,27,-47
"Key West, FL",28580.0,2020-10-01,205,213,-8
"Key West, FL",28580.0,2020-11-01,194,207,-13
"Key West, FL",28580.0,2020-12-01,253,314,-61
"Bloomington, IN",14020.0,2019-01-01,-59,-15,-44
"Bloomington, IN",14020.0,2019-02-01,-32,0,-32
"Bloomington, IN",14020.0,2019-03-01,-6,0,-6
"Bloomington, IN",14020.0,2019-04-01,4,26,-22
"Bloomington, IN",14020.0,2019-05-01,-290,1,-291
"Bloomington, IN",14020.0,2019-06-01,-101,0,-101
"Bloomington, IN",14020.0,2019-07-01,-297,0,-297
"Bloomington, IN",14020.0,2019-08-01,-125,0,-125
"Bloomington, IN",14020.0,2019-09-01,-11,0,-11
"Bloomington, IN",14020.0,2019-10-01,-77,-15,-62
"Bloomington, IN",14020.0,2019-11-01,-22,-15,-7
"Bloomington, IN",14020.0,2019-12-01,-73,-61,-12
"Bloomington, IN",14020.0,2020-01-01,-43,-13,-30
"Bloomington, IN",14020.0,2020-02-01,-66,0,-66
"Bloomington, IN",14020.0,2020-03-01,-30,-13,-17
"Bloomington, IN",14020.0,2020-04-01,-51,0,-51
"Bloomington, IN",14020.0,2020-05-01,-131,0,-131
"Bloomington, IN",14020.0,2020-06-01,-123,0,-123
"Bloomington, IN",14020.0,2020-07-01,-409,0,-409
"Bloomington, IN",14020.0,2020-08-01,-46,0,-46
"Bloomington, IN",14020.0,2020-09-01,-36,0,-36
"Bloomington, IN",14020.0,2020-10-01,-15,0,-15
"Bloomington, IN",14020.0,2020-11-01,-45,-23,-22
"Bloomington, IN",14020.0,2020-12-01,-58,-42,-16
"Monroe, MI",33780.0,2019-01-01,-1,-71,70
"Monroe, MI",33780.0,2019-02-01,63,0,63
"Monroe, MI",33780.0,2019-03-01,99,0,99
"Monroe, MI",33780.0,2019-04-01,272,109,163
"Monroe, MI",33780.0,2019-05-01,147,44,103
"Monroe, MI",33780.0,2019-06-01,122,0,122
"Monroe, MI",33780.0,2019-07-01,101,0,101
"Monroe, MI",33780.0,2019-08-01,-9,0,-9
"Monroe, MI",33780.0,2019-09-01,48,0,48
"Monroe, MI",33780.0,2019-10-01,-20,-90,70
"Monroe, MI",33780.0,2019-11-01,-78,-106,28
"Monroe, MI",33780.0,2019-12-01,-166,-191,25
"Monroe, MI",33780.0,2020-01-01,-16,-62,46
"Monroe, MI",33780.0,2020-02-01,73,0,73
"Monroe, MI",33780.0,2020-03-01,128,1,127
"Monroe, MI",33780.0,2020-04-01,83,1,82
"Monroe, MI",33780.0,2020-05-01,177,43,134
"Monroe, MI",33780.0,2020-06-01,93,22,71
"Monroe, MI",33780.0,2020-07-01,79,0,79
"Monroe, MI",33780.0,2020-08-01,55,-14,69
"Monroe, MI",33780.0,2020-09-01,95,0,95
"Monroe, MI",33780.0,2020-10-01,45,-79,124
"Monroe, MI",33780.0,2020-11-01,21,-76,97
"Monroe, MI",33780.0,2020-12-01,-77,-128,51
"East Stroudsburg, PA",20700.0,2019-01-01,1,-61,62
"East Stroudsburg, PA",20700.0,2019-02-01,40,0,40
"East Stroudsburg, PA",20700.0,2019-03-01,75,0,75
"East Stroudsburg, PA",20700.0,2019-04-01,37,13,24
"East Stroudsburg, PA",20700.0,2019-05-01,161,103,58
"East Stroudsburg, PA",20700.0,2019-06-01,150,53,97
"East Stroudsburg, PA",20700.0,2019-07-01,171,0,171
"East Stroudsburg, PA",20700.0,2019-08-01,83,0,83
"East Stroudsburg, PA",20700.0,2019-09-01,145,-26,171
"East Stroudsburg, PA",20700.0,2019-10-01,-73,-88,15
"East Stroudsburg, PA",20700.0,2019-11-01,76,-14,90
"East Stroudsburg, PA",20700.0,2019-12-01,81,-45,126
"East Stroudsburg, PA",20700.0,2020-01-01,-72,-78,6
"East Stroudsburg, PA",20700.0,2020-02-01,61,0,61
"East Stroudsburg, PA",20700.0,2020-03-01,259,144,115
"East Stroudsburg, PA",20700.0,2020-04-01,341,144,197
"East Stroudsburg, PA",20700.0,2020-05-01,188,92,96
"East Stroudsburg, PA",20700.0,2020-06-01,271,127,144
"East Stroudsburg, PA",20700.0,2020-07-01,119,42,77
"East Stroudsburg, PA",20700.0,2020-08-01,215,23,192
"East Stroudsburg, PA",20700.0,2020-09-01,267,6,261
"East Stroudsburg, PA",20700.0,2020-10-01,127,-47,174
"East Stroudsburg, PA",20700.0,2020-11-01,145,-28,173
"East Stroudsburg, PA",20700.0,2020-12-01,44,-34,78
"Salinas, CA",41500.0,2019-01-01,-94,0,-94
"Salinas, CA",41500.0,2019-02-01,66,0,66
"Salinas, CA",41500.0,2019-03-01,-50,0,-50
"Salinas, CA",41500.0,2019-04-01,-52,34,-86
"Salinas, CA",41500.0,2019-05-01,-16,29,-45
"Salinas, CA",41500.0,2019-06-01,-98,12,-110
"Salinas, CA",41500.0,2019-07-01,-26,0,-26
"Salinas, CA",41500.0,2019-08-01,-64,0,-64
"Salinas, CA",41500.0,2019-09-01,-42,-19,-23
"Salinas, CA",41500.0,2019-10-01,-110,-15,-95
"Salinas, CA",41500.0,2019-11-01,-108,-25,-83
"Salinas, CA",41500.0,2019-12-01,-125,0,-125
"Salinas, CA",41500.0,2020-01-01,-32,0,-32
"Salinas, CA",41500.0,2020-02-01,-71,0,-71
"Salinas, CA",41500.0,2020-03-01,109,66,43
"Salinas, CA",41500.0,2020-04-01,106,79,27
"Salinas, CA",41500.0,2020-05-01,82,60,22
"Salinas, CA",41500.0,2020-06-01,115,26,89
"Salinas, CA",41500.0,2020-07-01,43,17,26
"Salinas, CA",41500.0,2020-08-01,152,43,109
"Salinas, CA",41500.0,2020-09-01,68,13,55
"Salinas, CA",41500.0,2020-10-01,-65,-34,-31
"Salinas, CA",41500.0,2020-11-01,101,-22,123
"Salinas, CA",41500.0,2020-12-01,47,-14,61
"Vidalia, GA",47080.0,2019-01-01,-15,0,-15
"Vidalia, GA",47080.0,2019-02-01,0,0,0
"Vidalia, GA",47080.0,2019-03-01,0,0,0
"Vidalia, GA",47080.0,2019-04-01,0,0,0
"Vidalia, GA",47080.0,2019-05-01,0,0,0
"Vidalia, GA",47080.0,2019-06-01,0,0,0
"Vidalia, GA",47080.0,2019-07-01,-17,0,-17
"Vidalia, GA",47080.0,2019-08-01,0,0,0
"Vidalia, GA",47080.0,2019-09-01,0,0,0
"Vidalia, GA",47080.0,2019-10-01,0,0,0
"Vidalia, GA",47080.0,2019-11-01,0,0,0
"Vidalia, GA",47080.0,2019-12-01,0,0,0
"Vidalia, GA",47080.0,2020-01-01,0,0,0
"Vidalia, GA",47080.0,2020-02-01,0,0,0
"Vidalia, GA",47080.0,2020-03-01,-11,0,-11
"Vidalia, GA",47080.0,2020-04-01,0,0,0
"Vidalia, GA",47080.0,2020-05-01,0,0,0
"Vidalia, GA",47080.0,2020-06-01,-13,0,-13
"Vidalia, GA",47080.0,2020-07-01,0,0,0
"Vidalia, GA",47080.0,2020-08-01,0,0,0
"Vidalia, GA",47080.0,2020-09-01,0,0,0
"Vidalia, GA",47080.0,2020-10-01,0,0,0
"Vidalia, GA",47080.0,2020-11-01,0,0,0
"Vidalia, GA",47080.0,2020-12-01,0,0,0
"Crawfordsville, IN",18820.0,2019-01-01,-21,0,-21
"Crawfordsville, IN",18820.0,2019-02-01,15,0,15
"Crawfordsville, IN",18820.0,2019-03-01,-3,0,-3
"Crawfordsville, IN",18820.0,2019-04-01,35,0,35
"Crawfordsville, IN",18820.0,2019-05-01,23,0,23
"Crawfordsville, IN",18820.0,2019-06-01,-10,0,-10
"Crawfordsville, IN",18820.0,2019-07-01,-3,0,-3
"Crawfordsville, IN",18820.0,2019-08-01,4,0,4
"Crawfordsville, IN",18820.0,2019-09-01,-12,0,-12
"Crawfordsville, IN",18820.0,2019-10-01,-1,0,-1
"Crawfordsville, IN",18820.0,2019-11-01,-4,0,-4
"Crawfordsville, IN",18820.0,2019-12-01,-6,0,-6
"Crawfordsville, IN",18820.0,2020-01-01,29,0,29
"Crawfordsville, IN",18820.0,2020-02-01,-34,0,-34
"Crawfordsville, IN",18820.0,2020-03-01,26,0,26
"Crawfordsville, IN",18820.0,2020-04-01,31,0,31
"Crawfordsville, IN",18820.0,2020-05-01,-3,0,-3
"Crawfordsville, IN",18820.0,2020-06-01,-2,0,-2
"Crawfordsville, IN",18820.0,2020-07-01,56,0,56
"Crawfordsville, IN",18820.0,2020-08-01,-8,0,-8
"Crawfordsville, IN",18820.0,2020-09-01,7,0,7
"Crawfordsville, IN",18820.0,2020-10-01,15,0,15
"Crawfordsville, IN",18820.0,2020-11-01,45,0,45
"Crawfordsville, IN",18820.0,2020-12-01,-10,0,-10
"Coffeyville, KS",17700.0,2019-01-01,-13,0,-13
"Coffeyville, KS",17700.0,2019-02-01,-40,0,-40
"Coffeyville, KS",17700.0,2019-03-01,-12,0,-12
"Coffeyville, KS",17700.0,2019-04-01,0,0,0
"Coffeyville, KS",17700.0,2019-05-01,-17,0,-17
"Coffeyville, KS",17700.0,2019-06-01,0,0,0
"Coffeyville, KS",17700.0,2019-07-01,-25,0,-25
"Coffeyville, KS",17700.0,2019-08-01,-7,0,-7
"Coffeyville, KS",17700.0,2019-09-01,11,0,11
"Coffeyville, KS",17700.0,2019-10-01,0,0,0
"Coffeyville, KS",17700.0,2019-11-01,-15,0,-15
"Coffeyville, KS",17700.0,2019-12-01,0,0,0
"Coffeyville, KS",17700.0,2020-01-01,-23,0,-23
"Coffeyville, KS",17700.0,2020-02-01,13,0,13
"Coffeyville, KS",17700.0,2020-03-01,-18,0,-18
"Coffeyville, KS",17700.0,2020-04-01,0,0,0
"Coffeyville, KS",17700.0,2020-05-01,-23,0,-23
"Coffeyville, KS",17700.0,2020-06-01,0,0,0
"Coffeyville, KS",17700.0,2020-07-01,11,0,11
"Coffeyville, KS",17700.0,2020-08-01,1,0,1
"Coffeyville, KS",17700.0,2020-09-01,-13,0,-13
"Coffeyville, KS",17700.0,2020-10-01,-22,0,-22
"Coffeyville, KS",17700.0,2020-11-01,-13,0,-13
"Coffeyville, KS",17700.0,2020-12-01,0,0,0
"Amsterdam, NY",11220.0,2019-01-01,-23,-12,-11
"Amsterdam, NY",11220.0,2019-02-01,-23,0,-23
"Amsterdam, NY",11220.0,2019-03-01,0,0,0
"Amsterdam, NY",11220.0,2019-04-01,19,0,19
"Amsterdam, NY",11220.0,2019-05-01,-8,0,-8
"Amsterdam, NY",11220.0,2019-06-01,27,0,27
"Amsterdam, NY",11220.0,2019-07-01,-24,0,-24
"Amsterdam, NY",11220.0,2019-08-01,-12,0,-12
"Amsterdam, NY",11220.0,2019-09-01,7,0,7
"Amsterdam, NY",11220.0,2019-10-01,-5,0,-5
"Amsterdam, NY",11220.0,2019-11-01,5,0,5
"Amsterdam, NY",11220.0,2019-12-01,-39,-25,-14
"Amsterdam, NY",11220.0,2020-01-01,-39,0,-39
"Amsterdam, NY",11220.0,2020-02-01,22,0,22
"Amsterdam, NY",11220.0,2020-03-01,3,0,3
"Amsterdam, NY",11220.0,2020-04-01,-6,0,-6
"Amsterdam, NY",11220.0,2020-05-01,18,0,18
"Amsterdam, NY",11220.0,2020-06-01,61,0,61
"Amsterdam, NY",11220.0,2020-07-01,65,0,65
"Amsterdam, NY",11220.0,2020-08-01,18,0,18
"Amsterdam, NY",11220.0,2020-09-01,-12,0,-12
"Amsterdam, NY",11220.0,2020-10-01,-10,0,-10
"Amsterdam, NY",11220.0,2020-11-01,53,0,53
"Amsterdam, NY",11220.0,2020-12-01,31,0,31
"Montrose, CO",33940.0,2019-01-01,-38,0,-38
"Montrose, CO",33940.0,2019-02-01,-17,0,-17
"Montrose, CO",33940.0,2019-03-01,3,0,3
"Montrose, CO",33940.0,2019-04-01,4,13,-9
"Montrose, CO",33940.0,2019-05-01,75,67,8
"Montrose, CO",33940.0,2019-06-01,-12,0,-12
"Montrose, CO",33940.0,2019-07-01,9,0,9
"Montrose, CO",33940.0,2019-08-01,-20,0,-20
"Montrose, CO",33940.0,2019-09-01,22,0,22
"Montrose, CO",33940.0,2019-10-01,-9,-49,40
"Montrose, CO",33940.0,2019-11-01,-7,-31,24
"Montrose, CO",33940.0,2019-12-01,11,-12,23
"Montrose, CO",33940.0,2020-01-01,-18,0,-18
"Montrose, CO",33940.0,2020-02-01,18,0,18
"Montrose, CO",33940.0,2020-03-01,9,0,9
"Montrose, CO",33940.0,2020-04-01,21,0,21
"Montrose, CO",33940.0,2020-05-01,30,27,3
"Montrose, CO",33940.0,2020-06-01,41,11,30
"Montrose, CO",33940.0,2020-07-01,-4,0,-4
"Montrose, CO",33940.0,2020-08-01,-5,0,-5
"Montrose, CO",33940.0,2020-09-01,19,0,19
"Montrose, CO",33940.0,2020-10-01,-19,-19,0
"Montrose, CO",33940.0,2020-11-01,11,-25,36
"Montrose, CO",33940.0,2020-12-01,23,0,23
"Pinehurst-Southern Pines, NC",38240.0,2019-01-01,64,0,64
"Pinehurst-Southern Pines, NC",38240.0,2019-02-01,26,0,26
"Pinehurst-Southern Pines, NC",38240.0,2019-03-01,17,0,17
"Pinehurst-Southern Pines, NC",38240.0,2019-04-01,-11,0,-11
"Pinehurst-Southern Pines, NC",38240.0,2019-05-01,55,0,55
"Pinehurst-Southern Pines, NC",38240.0,2019-06-01,72,0,72
"Pinehurst-Southern Pines, NC",38240.0,2019-07-01,-4,0,-4
"Pinehurst-Southern Pines, NC",38240.0,2019-08-01,53,0,53
"Pinehurst-Southern Pines, NC",38240.0,2019-09-01,25,0,25
"Pinehurst-Southern Pines, NC",38240.0,2019-10-01,21,0,21
"Pinehurst-Southern Pines, NC",38240.0,2019-11-01,27,0,27
"Pinehurst-Southern Pines, NC",38240.0,2019-12-01,22,0,22
"Pinehurst-Southern Pines, NC",38240.0,2020-01-01,-5,0,-5
"Pinehurst-Southern Pines, NC",38240.0,2020-02-01,77,0,77
"Pinehurst-Southern Pines, NC",38240.0,2020-03-01,12,0,12
"Pinehurst-Southern Pines, NC",38240.0,2020-04-01,64,0,64
"Pinehurst-Southern Pines, NC",38240.0,2020-05-01,39,0,39
"Pinehurst-Southern Pines, NC",38240.0,2020-06-01,63,0,63
"Pinehurst-Southern Pines, NC",38240.0,2020-07-01,80,0,80
"Pinehurst-Southern Pines, NC",38240.0,2020-08-01,69,0,69
"Pinehurst-Southern Pines, NC",38240.0,2020-09-01,55,0,55
"Pinehurst-Southern Pines, NC",38240.0,2020-10-01,72,0,72
"Pinehurst-Southern Pines, NC",38240.0,2020-11-01,76,0,76
"Pinehurst-Southern Pines, NC",38240.0,2020-12-01,80,0,80
"Dumas, TX",20300.0,2019-01-01,-11,0,-11
"Dumas, TX",20300.0,2019-02-01,0,0,0
"Dumas, TX",20300.0,2019-03-01,0,0,0
"Dumas, TX",20300.0,2019-04-01,-11,0,-11
"Dumas, TX",20300.0,2019-05-01,-26,0,-26
"Dumas, TX",20300.0,2019-06-01,-13,0,-13
"Dumas, TX",20300.0,2019-07-01,-20,0,-20
"Dumas, TX",20300.0,2019-08-01,0,0,0
"Dumas, TX",20300.0,2019-09-01,-13,0,-13
"Dumas, TX",20300.0,2019-10-01,-11,0,-11
"Dumas, TX",20300.0,2019-11-01,0,0,0
"Dumas, TX",20300.0,2019-12-01,-13,0,-13
"Dumas, TX",20300.0,2020-01-01,-12,0,-12
"Dumas, TX",20300.0,2020-02-01,0,0,0
"Dumas, TX",20300.0,2020-03-01,-14,0,-14
"Dumas, TX",20300.0,2020-04-01,-12,0,-12
"Dumas, TX",20300.0,2020-05-01,-16,0,-16
"Dumas, TX",20300.0,2020-06-01,-12,0,-12
"Dumas, TX",20300.0,2020-07-01,-17,0,-17
"Dumas, TX",20300.0,2020-08-01,-39,-13,-26
"Dumas, TX",20300.0,2020-09-01,-12,0,-12
"Dumas, TX",20300.0,2020-10-01,0,0,0
"Dumas, TX",20300.0,2020-11-01,0,0,0
"Dumas, TX",20300.0,2020-12-01,0,0,0
"Monroe, LA",33740.0,2019-01-01,-12,0,-12
"Monroe, LA",33740.0,2019-02-01,8,0,8
"Monroe, LA",33740.0,2019-03-01,-3,0,-3
"Monroe, LA",33740.0,2019-04-01,-34,0,-34
"Monroe, LA",33740.0,2019-05-01,-3,0,-3
"Monroe, LA",33740.0,2019-06-01,43,0,43
"Monroe, LA",33740.0,2019-07-01,-26,0,-26
"Monroe, LA",33740.0,2019-08-01,-48,0,-48
"Monroe, LA",33740.0,2019-09-01,38,0,38
"Monroe, LA",33740.0,2019-10-01,19,0,19
"Monroe, LA",33740.0,2019-11-01,0,0,0
"Monroe, LA",33740.0,2019-12-01,-20,0,-20
"Monroe, LA",33740.0,2020-01-01,-120,0,-120
"Monroe, LA",33740.0,2020-02-01,-2,0,-2
"Monroe, LA",33740.0,2020-03-01,-10,0,-10
"Monroe, LA",33740.0,2020-04-01,-21,0,-21
"Monroe, LA",33740.0,2020-05-01,-11,0,-11
"Monroe, LA",33740.0,2020-06-01,-13,0,-13
"Monroe, LA",33740.0,2020-07-01,-21,0,-21
"Monroe, LA",33740.0,2020-08-01,-10,0,-10
"Monroe, LA",33740.0,2020-09-01,-29,0,-29
"Monroe, LA",33740.0,2020-10-01,-20,0,-20
"Monroe, LA",33740.0,2020-11-01,-15,0,-15
"Monroe, LA",33740.0,2020-12-01,-27,0,-27
"Fort Morgan, CO",22820.0,2019-01-01,-6,0,-6
"Fort Morgan, CO",22820.0,2019-02-01,0,0,0
"Fort Morgan, CO",22820.0,2019-03-01,20,0,20
"Fort Morgan, CO",22820.0,2019-04-01,0,0,0
"Fort Morgan, CO",22820.0,2019-05-01,5,0,5
"Fort Morgan, CO",22820.0,2019-06-01,16,0,16
"Fort Morgan, CO",22820.0,2019-07-01,-6,0,-6
"Fort Morgan, CO",22820.0,2019-08-01,-7,0,-7
"Fort Morgan, CO",22820.0,2019-09-01,10,0,10
"Fort Morgan, CO",22820.0,2019-10-01,-4,0,-4
"Fort Morgan, CO",22820.0,2019-11-01,2,0,2
"Fort Morgan, CO",22820.0,2019-12-01,15,0,15
"Fort Morgan, CO",22820.0,2020-01-01,22,0,22
"Fort Morgan, CO",22820.0,2020-02-01,5,0,5
"Fort Morgan, CO",22820.0,2020-03-01,-1,0,-1
"Fort Morgan, CO",22820.0,2020-04-01,33,0,33
"Fort Morgan, CO",22820.0,2020-05-01,14,0,14
"Fort Morgan, CO",22820.0,2020-06-01,47,0,47
"Fort Morgan, CO",22820.0,2020-07-01,6,0,6
"Fort Morgan, CO",22820.0,2020-08-01,21,0,21
"Fort Morgan, CO",22820.0,2020-09-01,-9,0,-9
"Fort Morgan, CO",22820.0,2020-10-01,30,0,30
"Fort Morgan, CO",22820.0,2020-11-01,27,0,27
"Fort Morgan, CO",22820.0,2020-12-01,20,0,20
"Jacksonville, IL",27300.0,2019-01-01,-12,0,-12
"Jacksonville, IL",27300.0,2019-02-01,-13,0,-13
"Jacksonville, IL",27300.0,2019-03-01,-21,0,-21
"Jacksonville, IL",27300.0,2019-04-01,-19,0,-19
"Jacksonville, IL",27300.0,2019-05-01,11,0,11
"Jacksonville, IL",27300.0,2019-06-01,-35,0,-35
"Jacksonville, IL",27300.0,2019-07-01,-19,0,-19
"Jacksonville, IL",27300.0,2019-08-01,1,0,1
"Jacksonville, IL",27300.0,2019-09-01,-3,0,-3
"Jacksonville, IL",27300.0,2019-10-01,-12,0,-12
"Jacksonville, IL",27300.0,2019-11-01,-4,0,-4
"Jacksonville, IL",27300.0,2019-12-01,-16,0,-16
"Jacksonville, IL",27300.0,2020-01-01,10,0,10
"Jacksonville, IL",27300.0,2020-02-01,13,0,13
"Jacksonville, IL",27300.0,2020-03-01,35,0,35
"Jacksonville, IL",27300.0,2020-04-01,26,0,26
"Jacksonville, IL",27300.0,2020-05-01,-5,0,-5
"Jacksonville, IL",27300.0,2020-06-01,21,0,21
"Jacksonville, IL",27300.0,2020-07-01,1,0,1
"Jacksonville, IL",27300.0,2020-08-01,-2,0,-2
"Jacksonville, IL",27300.0,2020-09-01,5,0,5
"Jacksonville, IL",27300.0,2020-10-01,8,0,8
"Jacksonville, IL",27300.0,2020-11-01,-11,0,-11
"Jacksonville, IL",27300.0,2020-12-01,7,0,7
"Hermiston-Pendleton, OR",25840.0,2019-01-01,-2,0,-2
"Hermiston-Pendleton, OR",25840.0,2019-02-01,-12,0,-12
"Hermiston-Pendleton, OR",25840.0,2019-03-01,-5,0,-5
"Hermiston-Pendleton, OR",25840.0,2019-04-01,8,0,8
"Hermiston-Pendleton, OR",25840.0,2019-05-01,-6,0,-6
"Hermiston-Pendleton, OR",25840.0,2019-06-01,19,0,19
"Hermiston-Pendleton, OR",25840.0,2019-07-01,-11,0,-11
"Hermiston-Pendleton, OR",25840.0,2019-08-01,-3,0,-3
"Hermiston-Pendleton, OR",25840.0,2019-09-01,-26,0,-26
"Hermiston-Pendleton, OR",25840.0,2019-10-01,-32,-30,-2
"Hermiston-Pendleton, OR",25840.0,2019-11-01,-30,0,-30
"Hermiston-Pendleton, OR",25840.0,2019-12-01,1,0,1
"Hermiston-Pendleton, OR",25840.0,2020-01-01,-6,0,-6
"Hermiston-Pendleton, OR",25840.0,2020-02-01,1,0,1
"Hermiston-Pendleton, OR",25840.0,2020-03-01,-24,0,-24
"Hermiston-Pendleton, OR",25840.0,2020-04-01,20,0,20
"Hermiston-Pendleton, OR",25840.0,2020-05-01,-24,0,-24
"Hermiston-Pendleton, OR",25840.0,2020-06-01,-12,0,-12
"Hermiston-Pendleton, OR",25840.0,2020-07-01,31,0,31
"Hermiston-Pendleton, OR",25840.0,2020-08-01,-33,0,-33
"Hermiston-Pendleton, OR",25840.0,2020-09-01,-19,0,-19
"Hermiston-Pendleton, OR",25840.0,2020-10-01,-23,-15,-8
"Hermiston-Pendleton, OR",25840.0,2020-11-01,-14,-15,1
"Hermiston-Pendleton, OR",25840.0,2020-12-01,-12,0,-12
"Austin, MN",12380.0,2019-01-01,-4,0,-4
"Austin, MN",12380.0,2019-02-01,11,0,11
"Austin, MN",12380.0,2019-03-01,-1,0,-1
"Austin, MN",12380.0,2019-04-01,1,12,-11
"Austin, MN",12380.0,2019-05-01,-19,0,-19
"Austin, MN",12380.0,2019-06-01,-8,0,-8
"Austin, MN",12380.0,2019-07-01,8,0,8
"Austin, MN",12380.0,2019-08-01,14,0,14
"Austin, MN",12380.0,2019-09-01,1,0,1
"Austin, MN",12380.0,2019-10-01,-50,-24,-26
"Austin, MN",12380.0,2019-11-01,-39,-53,14
"Austin, MN",12380.0,2019-12-01,-49,-33,-16
"Austin, MN",12380.0,2020-01-01,-31,-13,-18
"Austin, MN",12380.0,2020-02-01,7,0,7
"Austin, MN",12380.0,2020-03-01,-7,0,-7
"Austin, MN",12380.0,2020-04-01,28,0,28
"Austin, MN",12380.0,2020-05-01,11,0,11
"Austin, MN",12380.0,2020-06-01,-18,0,-18
"Austin, MN",12380.0,2020-07-01,0,0,0
"Austin, MN",12380.0,2020-08-01,0,0,0
"Austin, MN",12380.0,2020-09-01,-27,0,-27
"Austin, MN",12380.0,2020-10-01,-37,-15,-22
"Austin, MN",12380.0,2020-11-01,-5,-26,21
"Austin, MN",12380.0,2020-12-01,1,-14,15
"Central City, KY",16420.0,2019-01-01,14,0,14
"Central City, KY",16420.0,2019-02-01,0,0,0
"Central City, KY",16420.0,2019-03-01,5,0,5
"Central City, KY",16420.0,2019-04-01,0,0,0
"Central City, KY",16420.0,2019-05-01,0,0,0
"Central City, KY",16420.0,2019-06-01,-22,0,-22
"Central City, KY",16420.0,2019-07-01,9,0,9
"Central City, KY",16420.0,2019-08-01,-12,0,-12
"Central City, KY",16420.0,2019-09-01,0,0,0
"Central City, KY",16420.0,2019-10-01,-11,0,-11
"Central City, KY",16420.0,2019-11-01,-16,0,-16
"Central City, KY",16420.0,2019-12-01,-12,0,-12
"Central City, KY",16420.0,2020-01-01,-13,0,-13
"Central City, KY",16420.0,2020-02-01,0,0,0
"Central City, KY",16420.0,2020-03-01,-15,0,-15
"Central City, KY",16420.0,2020-04-01,-5,0,-5
"Central City, KY",16420.0,2020-05-01,0,0,0
"Central City, KY",16420.0,2020-06-01,0,0,0
"Central City, KY",16420.0,2020-07-01,0,0,0
"Central City, KY",16420.0,2020-08-01,12,0,12
"Central City, KY",16420.0,2020-09-01,0,0,0
"Central City, KY",16420.0,2020-10-01,-11,0,-11
"Central City, KY",16420.0,2020-11-01,-15,0,-15
"Central City, KY",16420.0,2020-12-01,0,0,0
"Dalton, GA",19140.0,2019-01-01,-52,0,-52
"Dalton, GA",19140.0,2019-02-01,2,0,2
"Dalton, GA",19140.0,2019-03-01,16,0,16
"Dalton, GA",19140.0,2019-04-01,-20,0,-20
"Dalton, GA",19140.0,2019-05-01,-25,0,-25
"Dalton, GA",19140.0,2019-06-01,0,0,0
"Dalton, GA",19140.0,2019-07-01,-47,0,-47
"Dalton, GA",19140.0,2019-08-01,4,0,4
"Dalton, GA",19140.0,2019-09-01,-2,0,-2
"Dalton, GA",19140.0,2019-10-01,-6,0,-6
"Dalton, GA",19140.0,2019-11-01,-13,0,-13
"Dalton, GA",19140.0,2019-12-01,-51,0,-51
"Dalton, GA",19140.0,2020-01-01,-19,0,-19
"Dalton, GA",19140.0,2020-02-01,-18,0,-18
"Dalton, GA",19140.0,2020-03-01,-20,0,-20
"Dalton, GA",19140.0,2020-04-01,19,0,19
"Dalton, GA",19140.0,2020-05-01,2,0,2
"Dalton, GA",19140.0,2020-06-01,-3,0,-3
"Dalton, GA",19140.0,2020-07-01,2,0,2
"Dalton, GA",19140.0,2020-08-01,2,0,2
"Dalton, GA",19140.0,2020-09-01,5,0,5
"Dalton, GA",19140.0,2020-10-01,-48,0,-48
"Dalton, GA",19140.0,2020-11-01,-5,0,-5
"Dalton, GA",19140.0,2020-12-01,-19,0,-19
"Muscatine, IA",34700.0,2019-01-01,-34,-11,-23
"Muscatine, IA",34700.0,2019-02-01,6,0,6
"Muscatine, IA",34700.0,2019-03-01,-23,0,-23
"Muscatine, IA",34700.0,2019-04-01,-20,0,-20
"Muscatine, IA",34700.0,2019-05-01,-15,0,-15
"Muscatine, IA",34700.0,2019-06-01,-9,0,-9
"Muscatine, IA",34700.0,2019-07-01,1,0,1
"Muscatine, IA",34700.0,2019-08-01,15,0,15
"Muscatine, IA",34700.0,2019-09-01,-37,0,-37
"Muscatine, IA",34700.0,2019-10-01,-42,0,-42
"Muscatine, IA",34700.0,2019-11-01,-12,0,-12
"Muscatine, IA",34700.0,2019-12-01,-42,-11,-31
"Muscatine, IA",34700.0,2020-01-01,-13,0,-13
"Muscatine, IA",34700.0,2020-02-01,-3,0,-3
"Muscatine, IA",34700.0,2020-03-01,-15,0,-15
"Muscatine, IA",34700.0,2020-04-01,-50,0,-50
"Muscatine, IA",34700.0,2020-05-01,16,0,16
"Muscatine, IA",34700.0,2020-06-01,-13,0,-13
"Muscatine, IA",34700.0,2020-07-01,52,0,52
"Muscatine, IA",34700.0,2020-08-01,-18,0,-18
"Muscatine, IA",34700.0,2020-09-01,-45,0,-45
"Muscatine, IA",34700.0,2020-10-01,-5,0,-5
"Muscatine, IA",34700.0,2020-11-01,0,0,0
"Muscatine, IA",34700.0,2020-12-01,-53,0,-53
"Muskegon, MI",34740.0,2019-01-01,-156,-163,7
"Muskegon, MI",34740.0,2019-02-01,30,0,30
"Muskegon, MI",34740.0,2019-03-01,86,0,86
"Muskegon, MI",34740.0,2019-04-01,398,200,198
"Muskegon, MI",34740.0,2019-05-01,240,156,84
"Muskegon, MI",34740.0,2019-06-01,15,17,-2
"Muskegon, MI",34740.0,2019-07-01,26,0,26
"Muskegon, MI",34740.0,2019-08-01,58,0,58
"Muskegon, MI",34740.0,2019-09-01,-34,0,-34
"Muskegon, MI",34740.0,2019-10-01,-213,-243,30
"Muskegon, MI",34740.0,2019-11-01,-147,-174,27
"Muskegon, MI",34740.0,2019-12-01,-315,-294,-21
"Muskegon, MI",34740.0,2020-01-01,-63,-164,101
"Muskegon, MI",34740.0,2020-02-01,-15,0,-15
"Muskegon, MI",34740.0,2020-03-01,163,13,150
"Muskegon, MI",34740.0,2020-04-01,130,61,69
"Muskegon, MI",34740.0,2020-05-01,143,107,36
"Muskegon, MI",34740.0,2020-06-01,65,33,32
"Muskegon, MI",34740.0,2020-07-01,83,16,67
"Muskegon, MI",34740.0,2020-08-01,51,0,51
"Muskegon, MI",34740.0,2020-09-01,7,0,7
"Muskegon, MI",34740.0,2020-10-01,-161,-160,-1
"Muskegon, MI",34740.0,2020-11-01,-147,-198,51
"Muskegon, MI",34740.0,2020-12-01,-116,-179,63
"Zanesville, OH",49780.0,2019-01-01,-11,0,-11
"Zanesville, OH",49780.0,2019-02-01,-20,0,-20
"Zanesville, OH",49780.0,2019-03-01,21,0,21
"Zanesville, OH",49780.0,2019-04-01,27,0,27
"Zanesville, OH",49780.0,2019-05-01,-47,0,-47
"Zanesville, OH",49780.0,2019-06-01,38,0,38
"Zanesville, OH",49780.0,2019-07-01,-30,0,-30
"Zanesville, OH",49780.0,2019-08-01,22,0,22
"Zanesville, OH",49780.0,2019-09-01,14,0,14
"Zanesville, OH",49780.0,2019-10-01,-20,0,-20
"Zanesville, OH",49780.0,2019-11-01,1,0,1
"Zanesville, OH",49780.0,2019-12-01,-17,0,-17
"Zanesville, OH",49780.0,2020-01-01,38,0,38
"Zanesville, OH",49780.0,2020-02-01,1,0,1
"Zanesville, OH",49780.0,2020-03-01,28,0,28
"Zanesville, OH",49780.0,2020-04-01,59,0,59
"Zanesville, OH",49780.0,2020-05-01,-8,0,-8
"Zanesville, OH",49780.0,2020-06-01,8,0,8
"Zanesville, OH",49780.0,2020-07-01,23,0,23
"Zanesville, OH",49780.0,2020-08-01,-6,0,-6
"Zanesville, OH",49780.0,2020-09-01,51,0,51
"Zanesville, OH",49780.0,2020-10-01,-13,0,-13
"Zanesville, OH",49780.0,2020-11-01,40,0,40
"Zanesville, OH",49780.0,2020-12-01,33,0,33
"Muskogee, OK",34780.0,2019-01-01,-44,0,-44
"Muskogee, OK",34780.0,2019-02-01,12,0,12
"Muskogee, OK",34780.0,2019-03-01,12,0,12
"Muskogee, OK",34780.0,2019-04-01,-17,0,-17
"Muskogee, OK",34780.0,2019-05-01,-37,0,-37
"Muskogee, OK",34780.0,2019-06-01,-34,0,-34
"Muskogee, OK",34780.0,2019-07-01,-24,0,-24
"Muskogee, OK",34780.0,2019-08-01,2,0,2
"Muskogee, OK",34780.0,2019-09-01,-8,0,-8
"Muskogee, OK",34780.0,2019-10-01,1,0,1
"Muskogee, OK",34780.0,2019-11-01,-9,0,-9
"Muskogee, OK",34780.0,2019-12-01,-36,0,-36
"Muskogee, OK",34780.0,2020-01-01,25,0,25
"Muskogee, OK",34780.0,2020-02-01,24,0,24
"Muskogee, OK",34780.0,2020-03-01,9,0,9
"Muskogee, OK",34780.0,2020-04-01,4,0,4
"Muskogee, OK",34780.0,2020-05-01,-1,0,-1
"Muskogee, OK",34780.0,2020-06-01,-51,0,-51
"Muskogee, OK",34780.0,2020-07-01,-42,0,-42
"Muskogee, OK",34780.0,2020-08-01,38,0,38
"Muskogee, OK",34780.0,2020-09-01,-5,0,-5
"Muskogee, OK",34780.0,2020-10-01,1,0,1
"Muskogee, OK",34780.0,2020-11-01,1,0,1
"Muskogee, OK",34780.0,2020-12-01,-11,0,-11
"Nacogdoches, TX",34860.0,2019-01-01,-58,0,-58
"Nacogdoches, TX",34860.0,2019-02-01,-3,0,-3
"Nacogdoches, TX",34860.0,2019-03-01,-50,0,-50
"Nacogdoches, TX",34860.0,2019-04-01,4,0,4
"Nacogdoches, TX",34860.0,2019-05-01,-22,0,-22
"Nacogdoches, TX",34860.0,2019-06-01,-47,0,-47
"Nacogdoches, TX",34860.0,2019-07-01,-32,0,-32
"Nacogdoches, TX",34860.0,2019-08-01,4,0,4
"Nacogdoches, TX",34860.0,2019-09-01,-18,0,-18
"Nacogdoches, TX",34860.0,2019-10-01,22,0,22
"Nacogdoches, TX",34860.0,2019-11-01,-27,0,-27
"Nacogdoches, TX",34860.0,2019-12-01,-24,0,-24
"Nacogdoches, TX",34860.0,2020-01-01,-18,0,-18
"Nacogdoches, TX",34860.0,2020-02-01,10,0,10
"Nacogdoches, TX",34860.0,2020-03-01,4,0,4
"Nacogdoches, TX",34860.0,2020-04-01,-15,0,-15
"Nacogdoches, TX",34860.0,2020-05-01,-10,0,-10
"Nacogdoches, TX",34860.0,2020-06-01,-31,0,-31
"Nacogdoches, TX",34860.0,2020-07-01,-10,0,-10
"Nacogdoches, TX",34860.0,2020-08-01,1,0,1
"Nacogdoches, TX",34860.0,2020-09-01,-7,0,-7
"Nacogdoches, TX",34860.0,2020-10-01,-15,0,-15
"Nacogdoches, TX",34860.0,2020-11-01,-14,0,-14
"Nacogdoches, TX",34860.0,2020-12-01,-15,0,-15
"Napa, CA",34900.0,2019-01-01,-4,0,-4
"Napa, CA",34900.0,2019-02-01,38,0,38
"Napa, CA",34900.0,2019-03-01,-30,0,-30
"Napa, CA",34900.0,2019-04-01,85,0,85
"Napa, CA",34900.0,2019-05-01,-1,0,-1
"Napa, CA",34900.0,2019-06-01,52,0,52
"Napa, CA",34900.0,2019-07-01,-20,0,-20
"Napa, CA",34900.0,2019-08-01,-10,0,-10
"Napa, CA",34900.0,2019-09-01,-19,0,-19
"Napa, CA",34900.0,2019-10-01,88,0,88
"Napa, CA",34900.0,2019-11-01,16,0,16
"Napa, CA",34900.0,2019-12-01,-10,0,-10
"Napa, CA",34900.0,2020-01-01,9,0,9
"Napa, CA",34900.0,2020-02-01,27,0,27
"Napa, CA",34900.0,2020-03-01,78,36,42
"Napa, CA",34900.0,2020-04-01,105,32,73
"Napa, CA",34900.0,2020-05-01,103,25,78
"Napa, CA",34900.0,2020-06-01,132,16,116
"Napa, CA",34900.0,2020-07-01,154,11,143
"Napa, CA",34900.0,2020-08-01,200,22,178
"Napa, CA",34900.0,2020-09-01,72,0,72
"Napa, CA",34900.0,2020-10-01,-13,12,-25
"Napa, CA",34900.0,2020-11-01,26,0,26
"Napa, CA",34900.0,2020-12-01,40,14,26
"Natchitoches, LA",35060.0,2019-01-01,-13,0,-13
"Natchitoches, LA",35060.0,2019-02-01,-12,0,-12
"Natchitoches, LA",35060.0,2019-03-01,-16,0,-16
"Natchitoches, LA",35060.0,2019-04-01,0,0,0
"Natchitoches, LA",35060.0,2019-05-01,0,0,0
"Natchitoches, LA",35060.0,2019-06-01,0,0,0
"Natchitoches, LA",35060.0,2019-07-01,16,0,16
"Natchitoches, LA",35060.0,2019-08-01,0,0,0
"Natchitoches, LA",35060.0,2019-09-01,-26,0,-26
"Natchitoches, LA",35060.0,2019-10-01,-16,0,-16
"Natchitoches, LA",35060.0,2019-11-01,0,0,0
"Natchitoches, LA",35060.0,2019-12-01,0,0,0
"Natchitoches, LA",35060.0,2020-01-01,-11,0,-11
"Natchitoches, LA",35060.0,2020-02-01,-12,0,-12
"Natchitoches, LA",35060.0,2020-03-01,-18,0,-18
"Natchitoches, LA",35060.0,2020-04-01,-12,0,-12
"Natchitoches, LA",35060.0,2020-05-01,16,0,16
"Natchitoches, LA",35060.0,2020-06-01,-20,0,-20
"Natchitoches, LA",35060.0,2020-07-01,13,0,13
"Natchitoches, LA",35060.0,2020-08-01,-25,0,-25
"Natchitoches, LA",35060.0,2020-09-01,0,0,0
"Natchitoches, LA",35060.0,2020-10-01,-11,0,-11
"Natchitoches, LA",35060.0,2020-11-01,0,0,0
"Natchitoches, LA",35060.0,2020-12-01,0,0,0
"Casper, WY",16220.0,2019-01-01,0,-22,22
"Casper, WY",16220.0,2019-02-01,0,0,0
"Casper, WY",16220.0,2019-03-01,37,0,37
"Casper, WY",16220.0,2019-04-01,40,9,31
"Casper, WY",16220.0,2019-05-01,81,31,50
"Casper, WY",16220.0,2019-06-01,27,14,13
"Casper, WY",16220.0,2019-07-01,53,0,53
"Casper, WY",16220.0,2019-08-01,3,0,3
"Casper, WY",16220.0,2019-09-01,17,0,17
"Casper, WY",16220.0,2019-10-01,-64,-92,28
"Casper, WY",16220.0,2019-11-01,-31,-38,7
"Casper, WY",16220.0,2019-12-01,-11,-11,0
"Casper, WY",16220.0,2020-01-01,-27,-15,-12
"Casper, WY",16220.0,2020-02-01,0,0,0
"Casper, WY",16220.0,2020-03-01,26,0,26
"Casper, WY",16220.0,2020-04-01,28,0,28
"Casper, WY",16220.0,2020-05-01,44,42,2
"Casper, WY",16220.0,2020-06-01,15,15,0
"Casper, WY",16220.0,2020-07-01,9,0,9
"Casper, WY",16220.0,2020-08-01,26,0,26
"Casper, WY",16220.0,2020-09-01,-14,0,-14
"Casper, WY",16220.0,2020-10-01,-74,-51,-23
"Casper, WY",16220.0,2020-11-01,-24,-36,12
"Casper, WY",16220.0,2020-12-01,0,0,0
"Show Low, AZ",43320.0,2019-01-01,-42,-70,28
"Show Low, AZ",43320.0,2019-02-01,41,-31,72
"Show Low, AZ",43320.0,2019-03-01,24,-37,61
"Show Low, AZ",43320.0,2019-04-01,577,448,129
"Show Low, AZ",43320.0,2019-05-01,2005,1889,116
"Show Low, AZ",43320.0,2019-06-01,1034,922,112
"Show Low, AZ",43320.0,2019-07-01,294,216,78
"Show Low, AZ",43320.0,2019-08-01,20,40,-20
"Show Low, AZ",43320.0,2019-09-01,-612,-376,-236
"Show Low, AZ",43320.0,2019-10-01,-1734,-1382,-352
"Show Low, AZ",43320.0,2019-11-01,-319,-314,-5
"Show Low, AZ",43320.0,2019-12-01,-93,-125,32
"Show Low, AZ",43320.0,2020-01-01,1,-57,58
"Show Low, AZ",43320.0,2020-02-01,-32,-36,4
"Show Low, AZ",43320.0,2020-03-01,122,27,95
"Show Low, AZ",43320.0,2020-04-01,614,463,151
"Show Low, AZ",43320.0,2020-05-01,1836,1658,178
"Show Low, AZ",43320.0,2020-06-01,933,813,120
"Show Low, AZ",43320.0,2020-07-01,314,270,44
"Show Low, AZ",43320.0,2020-08-01,79,110,-31
"Show Low, AZ",43320.0,2020-09-01,-349,-256,-93
"Show Low, AZ",43320.0,2020-10-01,-1473,-1198,-275
"Show Low, AZ",43320.0,2020-11-01,-288,-400,112
"Show Low, AZ",43320.0,2020-12-01,-50,-139,89
"Corsicana, TX",18620.0,2019-01-01,10,0,10
"Corsicana, TX",18620.0,2019-02-01,31,0,31
"Corsicana, TX",18620.0,2019-03-01,17,0,17
"Corsicana, TX",18620.0,2019-04-01,26,0,26
"Corsicana, TX",18620.0,2019-05-01,27,0,27
"Corsicana, TX",18620.0,2019-06-01,2,0,2
"Corsicana, TX",18620.0,2019-07-01,-19,0,-19
"Corsicana, TX",18620.0,2019-08-01,12,0,12
"Corsicana, TX",18620.0,2019-09-01,8,0,8
"Corsicana, TX",18620.0,2019-10-01,38,0,38
"Corsicana, TX",18620.0,2019-11-01,45,0,45
"Corsicana, TX",18620.0,2019-12-01,43,0,43
"Corsicana, TX",18620.0,2020-01-01,15,0,15
"Corsicana, TX",18620.0,2020-02-01,19,0,19
"Corsicana, TX",18620.0,2020-03-01,26,0,26
"Corsicana, TX",18620.0,2020-04-01,35,0,35
"Corsicana, TX",18620.0,2020-05-01,35,0,35
"Corsicana, TX",18620.0,2020-06-01,39,0,39
"Corsicana, TX",18620.0,2020-07-01,6,0,6
"Corsicana, TX",18620.0,2020-08-01,49,0,49
"Corsicana, TX",18620.0,2020-09-01,37,0,37
"Corsicana, TX",18620.0,2020-10-01,38,0,38
"Corsicana, TX",18620.0,2020-11-01,49,0,49
"Corsicana, TX",18620.0,2020-12-01,35,0,35
"Bardstown, KY",12680.0,2019-01-01,-1,0,-1
"Bardstown, KY",12680.0,2019-02-01,-9,0,-9
"Bardstown, KY",12680.0,2019-03-01,-14,0,-14
"Bardstown, KY",12680.0,2019-04-01,25,0,25
"Bardstown, KY",12680.0,2019-05-01,-3,0,-3
"Bardstown, KY",12680.0,2019-06-01,18,0,18
"Bardstown, KY",12680.0,2019-07-01,61,0,61
"Bardstown, KY",12680.0,2019-08-01,28,0,28
"Bardstown, KY",12680.0,2019-09-01,-5,0,-5
"Bardstown, KY",12680.0,2019-10-01,33,0,33
"Bardstown, KY",12680.0,2019-11-01,28,0,28
"Bardstown, KY",12680.0,2019-12-01,-11,0,-11
"Bardstown, KY",12680.0,2020-01-01,-2,0,-2
"Bardstown, KY",12680.0,2020-02-01,27,0,27
"Bardstown, KY",12680.0,2020-03-01,2,0,2
"Bardstown, KY",12680.0,2020-04-01,20,0,20
"Bardstown, KY",12680.0,2020-05-01,37,0,37
"Bardstown, KY",12680.0,2020-06-01,-10,0,-10
"Bardstown, KY",12680.0,2020-07-01,22,0,22
"Bardstown, KY",12680.0,2020-08-01,66,0,66
"Bardstown, KY",12680.0,2020-09-01,12,0,12
"Bardstown, KY",12680.0,2020-10-01,-10,0,-10
"Bardstown, KY",12680.0,2020-11-01,45,0,45
"Bardstown, KY",12680.0,2020-12-01,13,0,13
"Truckee-Grass Valley, CA",46020.0,2019-01-01,100,0,100
"Truckee-Grass Valley, CA",46020.0,2019-02-01,118,0,118
"Truckee-Grass Valley, CA",46020.0,2019-03-01,110,0,110
"Truckee-Grass Valley, CA",46020.0,2019-04-01,101,0,101
"Truckee-Grass Valley, CA",46020.0,2019-05-01,169,45,124
"Truckee-Grass Valley, CA",46020.0,2019-06-01,135,14,121
"Truckee-Grass Valley, CA",46020.0,2019-07-01,121,0,121
"Truckee-Grass Valley, CA",46020.0,2019-08-01,35,0,35
"Truckee-Grass Valley, CA",46020.0,2019-09-01,82,0,82
"Truckee-Grass Valley, CA",46020.0,2019-10-01,30,-30,60
"Truckee-Grass Valley, CA",46020.0,2019-11-01,41,0,41
"Truckee-Grass Valley, CA",46020.0,2019-12-01,35,-23,58
"Truckee-Grass Valley, CA",46020.0,2020-01-01,71,0,71
"Truckee-Grass Valley, CA",46020.0,2020-02-01,-14,0,-14
"Truckee-Grass Valley, CA",46020.0,2020-03-01,187,69,118
"Truckee-Grass Valley, CA",46020.0,2020-04-01,272,76,196
"Truckee-Grass Valley, CA",46020.0,2020-05-01,281,50,231
"Truckee-Grass Valley, CA",46020.0,2020-06-01,289,62,227
"Truckee-Grass Valley, CA",46020.0,2020-07-01,311,32,279
"Truckee-Grass Valley, CA",46020.0,2020-08-01,270,45,225
"Truckee-Grass Valley, CA",46020.0,2020-09-01,232,7,225
"Truckee-Grass Valley, CA",46020.0,2020-10-01,218,-8,226
"Truckee-Grass Valley, CA",46020.0,2020-11-01,197,23,174
"Truckee-Grass Valley, CA",46020.0,2020-12-01,220,52,168
"Wilmington, NC",48900.0,2019-01-01,-138,0,-138
"Wilmington, NC",48900.0,2019-02-01,-126,0,-126
"Wilmington, NC",48900.0,2019-03-01,-81,13,-94
"Wilmington, NC",48900.0,2019-04-01,-41,0,-41
"Wilmington, NC",48900.0,2019-05-01,-70,0,-70
"Wilmington, NC",48900.0,2019-06-01,110,0,110
"Wilmington, NC",48900.0,2019-07-01,-73,0,-73
"Wilmington, NC",48900.0,2019-08-01,-22,0,-22
"Wilmington, NC",48900.0,2019-09-01,-1,0,-1
"Wilmington, NC",48900.0,2019-10-01,-57,0,-57
"Wilmington, NC",48900.0,2019-11-01,-84,0,-84
"Wilmington, NC",48900.0,2019-12-01,-34,0,-34
"Wilmington, NC",48900.0,2020-01-01,-67,-11,-56
"Wilmington, NC",48900.0,2020-02-01,-32,0,-32
"Wilmington, NC",48900.0,2020-03-01,-114,40,-154
"Wilmington, NC",48900.0,2020-04-01,-29,41,-70
"Wilmington, NC",48900.0,2020-05-01,-59,34,-93
"Wilmington, NC",48900.0,2020-06-01,11,24,-13
"Wilmington, NC",48900.0,2020-07-01,-38,0,-38
"Wilmington, NC",48900.0,2020-08-01,57,0,57
"Wilmington, NC",48900.0,2020-09-01,45,0,45
"Wilmington, NC",48900.0,2020-10-01,21,0,21
"Wilmington, NC",48900.0,2020-11-01,-62,-11,-51
"Wilmington, NC",48900.0,2020-12-01,20,0,20
"New Haven-Milford, CT",35300.0,2019-01-01,-781,-748,-33
"New Haven-Milford, CT",35300.0,2019-02-01,17,-119,136
"New Haven-Milford, CT",35300.0,2019-03-01,132,-2,134
"New Haven-Milford, CT",35300.0,2019-04-01,839,547,292
"New Haven-Milford, CT",35300.0,2019-05-01,891,961,-70
"New Haven-Milford, CT",35300.0,2019-06-01,16,338,-322
"New Haven-Milford, CT",35300.0,2019-07-01,-114,43,-157
"New Haven-Milford, CT",35300.0,2019-08-01,-48,-15,-33
"New Haven-Milford, CT",35300.0,2019-09-01,-283,-138,-145
"New Haven-Milford, CT",35300.0,2019-10-01,-577,-427,-150
"New Haven-Milford, CT",35300.0,2019-11-01,-355,-232,-123
"New Haven-Milford, CT",35300.0,2019-12-01,-630,-589,-41
"New Haven-Milford, CT",35300.0,2020-01-01,-674,-695,21
"New Haven-Milford, CT",35300.0,2020-02-01,-95,-76,-19
"New Haven-Milford, CT",35300.0,2020-03-01,580,231,349
"New Haven-Milford, CT",35300.0,2020-04-01,521,299,222
"New Haven-Milford, CT",35300.0,2020-05-01,780,538,242
"New Haven-Milford, CT",35300.0,2020-06-01,775,723,52
"New Haven-Milford, CT",35300.0,2020-07-01,119,232,-113
"New Haven-Milford, CT",35300.0,2020-08-01,331,161,170
"New Haven-Milford, CT",35300.0,2020-09-01,129,36,93
"New Haven-Milford, CT",35300.0,2020-10-01,-186,-281,95
"New Haven-Milford, CT",35300.0,2020-11-01,-50,-119,69
"New Haven-Milford, CT",35300.0,2020-12-01,-282,-409,127
"Norwich-New London, CT",35980.0,2019-01-01,-363,-304,-59
"Norwich-New London, CT",35980.0,2019-02-01,70,0,70
"Norwich-New London, CT",35980.0,2019-03-01,56,-15,71
"Norwich-New London, CT",35980.0,2019-04-01,417,276,141
"Norwich-New London, CT",35980.0,2019-05-01,835,719,116
"Norwich-New London, CT",35980.0,2019-06-01,277,241,36
"Norwich-New London, CT",35980.0,2019-07-01,104,33,71
"Norwich-New London, CT",35980.0,2019-08-01,70,0,70
"Norwich-New London, CT",35980.0,2019-09-01,-87,-82,-5
"Norwich-New London, CT",35980.0,2019-10-01,-415,-389,-26
"Norwich-New London, CT",35980.0,2019-11-01,-141,-170,29
"Norwich-New London, CT",35980.0,2019-12-01,-168,-236,68
"Norwich-New London, CT",35980.0,2020-01-01,-269,-263,-6
"Norwich-New London, CT",35980.0,2020-02-01,-32,0,-32
"Norwich-New London, CT",35980.0,2020-03-01,198,156,42
"Norwich-New London, CT",35980.0,2020-04-01,182,89,93
"Norwich-New London, CT",35980.0,2020-05-01,694,471,223
"Norwich-New London, CT",35980.0,2020-06-01,667,497,170
"Norwich-New London, CT",35980.0,2020-07-01,149,65,84
"Norwich-New London, CT",35980.0,2020-08-01,254,24,230
"Norwich-New London, CT",35980.0,2020-09-01,230,13,217
"Norwich-New London, CT",35980.0,2020-10-01,-147,-270,123
"Norwich-New London, CT",35980.0,2020-11-01,12,-141,153
"Norwich-New London, CT",35980.0,2020-12-01,-107,-205,98
"Newberry, SC",35140.0,2019-01-01,24,0,24
"Newberry, SC",35140.0,2019-02-01,16,0,16
"Newberry, SC",35140.0,2019-03-01,-32,0,-32
"Newberry, SC",35140.0,2019-04-01,-21,0,-21
"Newberry, SC",35140.0,2019-05-01,10,0,10
"Newberry, SC",35140.0,2019-06-01,-4,0,-4
"Newberry, SC",35140.0,2019-07-01,12,0,12
"Newberry, SC",35140.0,2019-08-01,12,0,12
"Newberry, SC",35140.0,2019-09-01,26,0,26
"Newberry, SC",35140.0,2019-10-01,-15,0,-15
"Newberry, SC",35140.0,2019-11-01,11,0,11
"Newberry, SC",35140.0,2019-12-01,-1,0,-1
"Newberry, SC",35140.0,2020-01-01,9,0,9
"Newberry, SC",35140.0,2020-02-01,18,0,18
"Newberry, SC",35140.0,2020-03-01,17,0,17
"Newberry, SC",35140.0,2020-04-01,16,0,16
"Newberry, SC",35140.0,2020-05-01,4,0,4
"Newberry, SC",35140.0,2020-06-01,16,0,16
"Newberry, SC",35140.0,2020-07-01,23,0,23
"Newberry, SC",35140.0,2020-08-01,22,0,22
"Newberry, SC",35140.0,2020-09-01,24,0,24
"Newberry, SC",35140.0,2020-10-01,23,0,23
"Newberry, SC",35140.0,2020-11-01,41,0,41
"Newberry, SC",35140.0,2020-12-01,37,0,37
"Kendallville, IN",28340.0,2019-01-01,-12,-12,0
"Kendallville, IN",28340.0,2019-02-01,2,0,2
"Kendallville, IN",28340.0,2019-03-01,-3,0,-3
"Kendallville, IN",28340.0,2019-04-01,11,0,11
"Kendallville, IN",28340.0,2019-05-01,0,0,0
"Kendallville, IN",28340.0,2019-06-01,-58,0,-58
"Kendallville, IN",28340.0,2019-07-01,-10,0,-10
"Kendallville, IN",28340.0,2019-08-01,16,0,16
"Kendallville, IN",28340.0,2019-09-01,31,0,31
"Kendallville, IN",28340.0,2019-10-01,-54,0,-54
"Kendallville, IN",28340.0,2019-11-01,-1,0,-1
"Kendallville, IN",28340.0,2019-12-01,12,0,12
"Kendallville, IN",28340.0,2020-01-01,37,0,37
"Kendallville, IN",28340.0,2020-02-01,1,0,1
"Kendallville, IN",28340.0,2020-03-01,44,0,44
"Kendallville, IN",28340.0,2020-04-01,-4,0,-4
"Kendallville, IN",28340.0,2020-05-01,2,0,2
"Kendallville, IN",28340.0,2020-06-01,56,0,56
"Kendallville, IN",28340.0,2020-07-01,-31,0,-31
"Kendallville, IN",28340.0,2020-08-01,-18,0,-18
"Kendallville, IN",28340.0,2020-09-01,-7,0,-7
"Kendallville, IN",28340.0,2020-10-01,-16,0,-16
"Kendallville, IN",28340.0,2020-11-01,-1,0,-1
"Kendallville, IN",28340.0,2020-12-01,24,0,24
"Worthington, MN",49380.0,2019-01-01,0,0,0
"Worthington, MN",49380.0,2019-02-01,0,0,0
"Worthington, MN",49380.0,2019-03-01,0,0,0
"Worthington, MN",49380.0,2019-04-01,13,13,0
"Worthington, MN",49380.0,2019-05-01,0,0,0
"Worthington, MN",49380.0,2019-06-01,0,0,0
"Worthington, MN",49380.0,2019-07-01,-17,0,-17
"Worthington, MN",49380.0,2019-08-01,-11,0,-11
"Worthington, MN",49380.0,2019-09-01,0,0,0
"Worthington, MN",49380.0,2019-10-01,-24,-24,0
"Worthington, MN",49380.0,2019-11-01,-24,-24,0
"Worthington, MN",49380.0,2019-12-01,-19,-19,0
"Worthington, MN",49380.0,2020-01-01,0,0,0
"Worthington, MN",49380.0,2020-02-01,0,0,0
"Worthington, MN",49380.0,2020-03-01,-12,0,-12
"Worthington, MN",49380.0,2020-04-01,0,0,0
"Worthington, MN",49380.0,2020-05-01,0,0,0
"Worthington, MN",49380.0,2020-06-01,0,0,0
"Worthington, MN",49380.0,2020-07-01,-13,0,-13
"Worthington, MN",49380.0,2020-08-01,0,0,0
"Worthington, MN",49380.0,2020-09-01,-11,0,-11
"Worthington, MN",49380.0,2020-10-01,-19,-19,0
"Worthington, MN",49380.0,2020-11-01,-18,-18,0
"Worthington, MN",49380.0,2020-12-01,0,-14,14
"Maryville, MO",32340.0,2019-01-01,0,0,0
"Maryville, MO",32340.0,2019-02-01,0,0,0
"Maryville, MO",32340.0,2019-03-01,0,0,0
"Maryville, MO",32340.0,2019-04-01,0,0,0
"Maryville, MO",32340.0,2019-05-01,-85,0,-85
"Maryville, MO",32340.0,2019-06-01,0,0,0
"Maryville, MO",32340.0,2019-07-01,0,0,0
"Maryville, MO",32340.0,2019-08-01,0,0,0
"Maryville, MO",32340.0,2019-09-01,0,0,0
"Maryville, MO",32340.0,2019-10-01,0,0,0
"Maryville, MO",32340.0,2019-11-01,0,0,0
"Maryville, MO",32340.0,2019-12-01,0,0,0
"Maryville, MO",32340.0,2020-01-01,-12,0,-12
"Maryville, MO",32340.0,2020-02-01,11,0,11
"Maryville, MO",32340.0,2020-03-01,0,0,0
"Maryville, MO",32340.0,2020-04-01,-12,0,-12
"Maryville, MO",32340.0,2020-05-01,-31,0,-31
"Maryville, MO",32340.0,2020-06-01,0,0,0
"Maryville, MO",32340.0,2020-07-01,0,0,0
"Maryville, MO",32340.0,2020-08-01,0,0,0
"Maryville, MO",32340.0,2020-09-01,0,0,0
"Maryville, MO",32340.0,2020-10-01,0,0,0
"Maryville, MO",32340.0,2020-11-01,0,0,0
"Maryville, MO",32340.0,2020-12-01,0,0,0
"Sweetwater, TX",45020.0,2019-01-01,0,0,0
"Sweetwater, TX",45020.0,2019-02-01,0,0,0
"Sweetwater, TX",45020.0,2019-03-01,0,0,0
"Sweetwater, TX",45020.0,2019-04-01,0,0,0
"Sweetwater, TX",45020.0,2019-05-01,-17,0,-17
"Sweetwater, TX",45020.0,2019-06-01,12,0,12
"Sweetwater, TX",45020.0,2019-07-01,0,0,0
"Sweetwater, TX",45020.0,2019-08-01,-13,0,-13
"Sweetwater, TX",45020.0,2019-09-01,0,0,0
"Sweetwater, TX",45020.0,2019-10-01,0,0,0
"Sweetwater, TX",45020.0,2019-11-01,0,0,0
"Sweetwater, TX",45020.0,2019-12-01,0,0,0
"Sweetwater, TX",45020.0,2020-01-01,0,0,0
"Sweetwater, TX",45020.0,2020-02-01,0,0,0
"Sweetwater, TX",45020.0,2020-03-01,0,0,0
"Sweetwater, TX",45020.0,2020-04-01,13,0,13
"Sweetwater, TX",45020.0,2020-05-01,1,0,1
"Sweetwater, TX",45020.0,2020-06-01,0,0,0
"Sweetwater, TX",45020.0,2020-07-01,-4,0,-4
"Sweetwater, TX",45020.0,2020-08-01,11,0,11
"Sweetwater, TX",45020.0,2020-09-01,11,0,11
"Sweetwater, TX",45020.0,2020-10-01,0,0,0
"Sweetwater, TX",45020.0,2020-11-01,0,0,0
"Sweetwater, TX",45020.0,2020-12-01,-12,0,-12
"Sunbury, PA",44980.0,2019-01-01,67,0,67
"Sunbury, PA",44980.0,2019-02-01,24,0,24
"Sunbury, PA",44980.0,2019-03-01,15,0,15
"Sunbury, PA",44980.0,2019-04-01,27,0,27
"Sunbury, PA",44980.0,2019-05-01,8,0,8
"Sunbury, PA",44980.0,2019-06-01,22,0,22
"Sunbury, PA",44980.0,2019-07-01,45,0,45
"Sunbury, PA",44980.0,2019-08-01,-23,0,-23
"Sunbury, PA",44980.0,2019-09-01,-55,0,-55
"Sunbury, PA",44980.0,2019-10-01,-10,0,-10
"Sunbury, PA",44980.0,2019-11-01,-38,0,-38
"Sunbury, PA",44980.0,2019-12-01,-28,0,-28
"Sunbury, PA",44980.0,2020-01-01,45,0,45
"Sunbury, PA",44980.0,2020-02-01,7,0,7
"Sunbury, PA",44980.0,2020-03-01,45,0,45
"Sunbury, PA",44980.0,2020-04-01,-34,0,-34
"Sunbury, PA",44980.0,2020-05-01,23,0,23
"Sunbury, PA",44980.0,2020-06-01,-8,0,-8
"Sunbury, PA",44980.0,2020-07-01,22,0,22
"Sunbury, PA",44980.0,2020-08-01,-6,0,-6
"Sunbury, PA",44980.0,2020-09-01,35,0,35
"Sunbury, PA",44980.0,2020-10-01,7,0,7
"Sunbury, PA",44980.0,2020-11-01,14,0,14
"Sunbury, PA",44980.0,2020-12-01,-54,0,-54
"Corpus Christi, TX",18580.0,2019-01-01,-91,0,-91
"Corpus Christi, TX",18580.0,2019-02-01,-150,0,-150
"Corpus Christi, TX",18580.0,2019-03-01,-54,0,-54
"Corpus Christi, TX",18580.0,2019-04-01,-40,0,-40
"Corpus Christi, TX",18580.0,2019-05-01,-132,0,-132
"Corpus Christi, TX",18580.0,2019-06-01,-121,0,-121
"Corpus Christi, TX",18580.0,2019-07-01,-36,0,-36
"Corpus Christi, TX",18580.0,2019-08-01,-132,0,-132
"Corpus Christi, TX",18580.0,2019-09-01,-66,0,-66
"Corpus Christi, TX",18580.0,2019-10-01,-29,0,-29
"Corpus Christi, TX",18580.0,2019-11-01,-64,0,-64
"Corpus Christi, TX",18580.0,2019-12-01,-129,0,-129
"Corpus Christi, TX",18580.0,2020-01-01,-85,0,-85
"Corpus Christi, TX",18580.0,2020-02-01,-122,0,-122
"Corpus Christi, TX",18580.0,2020-03-01,-59,0,-59
"Corpus Christi, TX",18580.0,2020-04-01,24,-13,37
"Corpus Christi, TX",18580.0,2020-05-01,-95,0,-95
"Corpus Christi, TX",18580.0,2020-06-01,56,0,56
"Corpus Christi, TX",18580.0,2020-07-01,-109,0,-109
"Corpus Christi, TX",18580.0,2020-08-01,8,0,8
"Corpus Christi, TX",18580.0,2020-09-01,-67,0,-67
"Corpus Christi, TX",18580.0,2020-10-01,-57,0,-57
"Corpus Christi, TX",18580.0,2020-11-01,-111,0,-111
"Corpus Christi, TX",18580.0,2020-12-01,-43,0,-43
"Pahrump, NV",37220.0,2019-01-01,61,0,61
"Pahrump, NV",37220.0,2019-02-01,84,0,84
"Pahrump, NV",37220.0,2019-03-01,74,0,74
"Pahrump, NV",37220.0,2019-04-01,40,0,40
"Pahrump, NV",37220.0,2019-05-01,49,0,49
"Pahrump, NV",37220.0,2019-06-01,32,-15,47
"Pahrump, NV",37220.0,2019-07-01,78,0,78
"Pahrump, NV",37220.0,2019-08-01,94,0,94
"Pahrump, NV",37220.0,2019-09-01,62,0,62
"Pahrump, NV",37220.0,2019-10-01,48,0,48
"Pahrump, NV",37220.0,2019-11-01,26,-11,37
"Pahrump, NV",37220.0,2019-12-01,30,-13,43
"Pahrump, NV",37220.0,2020-01-01,54,0,54
"Pahrump, NV",37220.0,2020-02-01,74,0,74
"Pahrump, NV",37220.0,2020-03-01,101,0,101
"Pahrump, NV",37220.0,2020-04-01,80,0,80
"Pahrump, NV",37220.0,2020-05-01,68,0,68
"Pahrump, NV",37220.0,2020-06-01,100,0,100
"Pahrump, NV",37220.0,2020-07-01,50,0,50
"Pahrump, NV",37220.0,2020-08-01,116,0,116
"Pahrump, NV",37220.0,2020-09-01,67,0,67
"Pahrump, NV",37220.0,2020-10-01,55,0,55
"Pahrump, NV",37220.0,2020-11-01,58,0,58
"Pahrump, NV",37220.0,2020-12-01,104,0,104
"Union City, TN",46460.0,2019-01-01,-27,0,-27
"Union City, TN",46460.0,2019-02-01,0,0,0
"Union City, TN",46460.0,2019-03-01,-23,0,-23
"Union City, TN",46460.0,2019-04-01,9,0,9
"Union City, TN",46460.0,2019-05-01,37,0,37
"Union City, TN",46460.0,2019-06-01,12,0,12
"Union City, TN",46460.0,2019-07-01,19,0,19
"Union City, TN",46460.0,2019-08-01,5,0,5
"Union City, TN",46460.0,2019-09-01,-12,0,-12
"Union City, TN",46460.0,2019-10-01,-17,0,-17
"Union City, TN",46460.0,2019-11-01,13,0,13
"Union City, TN",46460.0,2019-12-01,17,0,17
"Union City, TN",46460.0,2020-01-01,-3,0,-3
"Union City, TN",46460.0,2020-02-01,3,0,3
"Union City, TN",46460.0,2020-03-01,31,0,31
"Union City, TN",46460.0,2020-04-01,2,0,2
"Union City, TN",46460.0,2020-05-01,-6,0,-6
"Union City, TN",46460.0,2020-06-01,-11,0,-11
"Union City, TN",46460.0,2020-07-01,-6,0,-6
"Union City, TN",46460.0,2020-08-01,-15,0,-15
"Union City, TN",46460.0,2020-09-01,10,0,10
"Union City, TN",46460.0,2020-10-01,5,0,5
"Union City, TN",46460.0,2020-11-01,1,0,1
"Union City, TN",46460.0,2020-12-01,20,0,20
"Seneca, SC",42860.0,2019-01-01,7,0,7
"Seneca, SC",42860.0,2019-02-01,9,0,9
"Seneca, SC",42860.0,2019-03-01,3,0,3
"Seneca, SC",42860.0,2019-04-01,-8,0,-8
"Seneca, SC",42860.0,2019-05-01,10,0,10
"Seneca, SC",42860.0,2019-06-01,-22,0,-22
"Seneca, SC",42860.0,2019-07-01,-14,0,-14
"Seneca, SC",42860.0,2019-08-01,-15,0,-15
"Seneca, SC",42860.0,2019-09-01,14,0,14
"Seneca, SC",42860.0,2019-10-01,-17,0,-17
"Seneca, SC",42860.0,2019-11-01,-27,0,-27
"Seneca, SC",42860.0,2019-12-01,-23,0,-23
"Seneca, SC",42860.0,2020-01-01,-8,0,-8
"Seneca, SC",42860.0,2020-02-01,4,0,4
"Seneca, SC",42860.0,2020-03-01,8,0,8
"Seneca, SC",42860.0,2020-04-01,-12,0,-12
"Seneca, SC",42860.0,2020-05-01,3,0,3
"Seneca, SC",42860.0,2020-06-01,-1,0,-1
"Seneca, SC",42860.0,2020-07-01,-14,0,-14
"Seneca, SC",42860.0,2020-08-01,15,0,15
"Seneca, SC",42860.0,2020-09-01,-41,0,-41
"Seneca, SC",42860.0,2020-10-01,-8,0,-8
"Seneca, SC",42860.0,2020-11-01,-8,0,-8
"Seneca, SC",42860.0,2020-12-01,-36,0,-36
"Rochelle, IL",40300.0,2019-01-01,-4,0,-4
"Rochelle, IL",40300.0,2019-02-01,-15,0,-15
"Rochelle, IL",40300.0,2019-03-01,17,0,17
"Rochelle, IL",40300.0,2019-04-01,28,0,28
"Rochelle, IL",40300.0,2019-05-01,30,0,30
"Rochelle, IL",40300.0,2019-06-01,41,0,41
"Rochelle, IL",40300.0,2019-07-01,36,0,36
"Rochelle, IL",40300.0,2019-08-01,52,0,52
"Rochelle, IL",40300.0,2019-09-01,-26,0,-26
"Rochelle, IL",40300.0,2019-10-01,16,-12,28
"Rochelle, IL",40300.0,2019-11-01,33,0,33
"Rochelle, IL",40300.0,2019-12-01,11,-12,23
"Rochelle, IL",40300.0,2020-01-01,11,-23,34
"Rochelle, IL",40300.0,2020-02-01,26,0,26
"Rochelle, IL",40300.0,2020-03-01,-9,0,-9
"Rochelle, IL",40300.0,2020-04-01,-22,0,-22
"Rochelle, IL",40300.0,2020-05-01,14,0,14
"Rochelle, IL",40300.0,2020-06-01,29,0,29
"Rochelle, IL",40300.0,2020-07-01,33,0,33
"Rochelle, IL",40300.0,2020-08-01,3,0,3
"Rochelle, IL",40300.0,2020-09-01,23,0,23
"Rochelle, IL",40300.0,2020-10-01,33,0,33
"Rochelle, IL",40300.0,2020-11-01,-56,0,-56
"Rochelle, IL",40300.0,2020-12-01,16,0,16
"Crestview-Fort Walton Beach-Destin, FL",18880.0,2019-01-01,314,147,167
"Crestview-Fort Walton Beach-Destin, FL",18880.0,2019-02-01,171,0,171
"Crestview-Fort Walton Beach-Destin, FL",18880.0,2019-03-01,36,0,36
"Crestview-Fort Walton Beach-Destin, FL",18880.0,2019-04-01,140,22,118
"Crestview-Fort Walton Beach-Destin, FL",18880.0,2019-05-01,72,82,-10
"Crestview-Fort Walton Beach-Destin, FL",18880.0,2019-06-01,-8,14,-22
"Crestview-Fort Walton Beach-Destin, FL",18880.0,2019-07-01,9,0,9
"Crestview-Fort Walton Beach-Destin, FL",18880.0,2019-08-01,97,0,97
"Crestview-Fort Walton Beach-Destin, FL",18880.0,2019-09-01,72,0,72
"Crestview-Fort Walton Beach-Destin, FL",18880.0,2019-10-01,4,0,4
"Crestview-Fort Walton Beach-Destin, FL",18880.0,2019-11-01,36,0,36
"Crestview-Fort Walton Beach-Destin, FL",18880.0,2019-12-01,369,258,111
"Crestview-Fort Walton Beach-Destin, FL",18880.0,2020-01-01,211,161,50
"Crestview-Fort Walton Beach-Destin, FL",18880.0,2020-02-01,79,0,79
"Crestview-Fort Walton Beach-Destin, FL",18880.0,2020-03-01,22,0,22
"Crestview-Fort Walton Beach-Destin, FL",18880.0,2020-04-01,109,12,97
"Crestview-Fort Walton Beach-Destin, FL",18880.0,2020-05-01,-25,25,-50
"Crestview-Fort Walton Beach-Destin, FL",18880.0,2020-06-01,87,0,87
"Crestview-Fort Walton Beach-Destin, FL",18880.0,2020-07-01,-40,0,-40
"Crestview-Fort Walton Beach-Destin, FL",18880.0,2020-08-01,-18,-12,-6
"Crestview-Fort Walton Beach-Destin, FL",18880.0,2020-09-01,40,-12,52
"Crestview-Fort Walton Beach-Destin, FL",18880.0,2020-10-01,14,0,14
"Crestview-Fort Walton Beach-Destin, FL",18880.0,2020-11-01,25,0,25
"Crestview-Fort Walton Beach-Destin, FL",18880.0,2020-12-01,141,100,41
"Okeechobee, FL",36380.0,2019-01-01,20,0,20
"Okeechobee, FL",36380.0,2019-02-01,19,0,19
"Okeechobee, FL",36380.0,2019-03-01,16,0,16
"Okeechobee, FL",36380.0,2019-04-01,6,0,6
"Okeechobee, FL",36380.0,2019-05-01,7,0,7
"Okeechobee, FL",36380.0,2019-06-01,38,0,38
"Okeechobee, FL",36380.0,2019-07-01,38,0,38
"Okeechobee, FL",36380.0,2019-08-01,33,0,33
"Okeechobee, FL",36380.0,2019-09-01,1,0,1
"Okeechobee, FL",36380.0,2019-10-01,17,0,17
"Okeechobee, FL",36380.0,2019-11-01,27,0,27
"Okeechobee, FL",36380.0,2019-12-01,31,17,14
"Okeechobee, FL",36380.0,2020-01-01,1,0,1
"Okeechobee, FL",36380.0,2020-02-01,-7,0,-7
"Okeechobee, FL",36380.0,2020-03-01,8,0,8
"Okeechobee, FL",36380.0,2020-04-01,5,0,5
"Okeechobee, FL",36380.0,2020-05-01,32,0,32
"Okeechobee, FL",36380.0,2020-06-01,24,0,24
"Okeechobee, FL",36380.0,2020-07-01,40,0,40
"Okeechobee, FL",36380.0,2020-08-01,52,0,52
"Okeechobee, FL",36380.0,2020-09-01,31,0,31
"Okeechobee, FL",36380.0,2020-10-01,31,0,31
"Okeechobee, FL",36380.0,2020-11-01,38,0,38
"Okeechobee, FL",36380.0,2020-12-01,47,0,47
"Starkville, MS",44260.0,2019-01-01,-11,0,-11
"Starkville, MS",44260.0,2019-02-01,14,0,14
"Starkville, MS",44260.0,2019-03-01,-13,0,-13
"Starkville, MS",44260.0,2019-04-01,-57,0,-57
"Starkville, MS",44260.0,2019-05-01,-210,0,-210
"Starkville, MS",44260.0,2019-06-01,-39,0,-39
"Starkville, MS",44260.0,2019-07-01,-93,0,-93
"Starkville, MS",44260.0,2019-08-01,-18,0,-18
"Starkville, MS",44260.0,2019-09-01,-14,0,-14
"Starkville, MS",44260.0,2019-10-01,19,0,19
"Starkville, MS",44260.0,2019-11-01,0,0,0
"Starkville, MS",44260.0,2019-12-01,11,0,11
"Starkville, MS",44260.0,2020-01-01,-13,0,-13
"Starkville, MS",44260.0,2020-02-01,0,0,0
"Starkville, MS",44260.0,2020-03-01,-11,0,-11
"Starkville, MS",44260.0,2020-04-01,-36,0,-36
"Starkville, MS",44260.0,2020-05-01,-12,0,-12
"Starkville, MS",44260.0,2020-06-01,-21,0,-21
"Starkville, MS",44260.0,2020-07-01,-146,0,-146
"Starkville, MS",44260.0,2020-08-01,19,0,19
"Starkville, MS",44260.0,2020-09-01,-3,0,-3
"Starkville, MS",44260.0,2020-10-01,-13,0,-13
"Starkville, MS",44260.0,2020-11-01,0,0,0
"Starkville, MS",44260.0,2020-12-01,-1,0,-1
"Jacksonville, NC",27340.0,2019-01-01,35,0,35
"Jacksonville, NC",27340.0,2019-02-01,3,0,3
"Jacksonville, NC",27340.0,2019-03-01,-63,0,-63
"Jacksonville, NC",27340.0,2019-04-01,-63,0,-63
"Jacksonville, NC",27340.0,2019-05-01,20,0,20
"Jacksonville, NC",27340.0,2019-06-01,-150,0,-150
"Jacksonville, NC",27340.0,2019-07-01,-21,0,-21
"Jacksonville, NC",27340.0,2019-08-01,-68,0,-68
"Jacksonville, NC",27340.0,2019-09-01,-31,0,-31
"Jacksonville, NC",27340.0,2019-10-01,-35,0,-35
"Jacksonville, NC",27340.0,2019-11-01,14,0,14
"Jacksonville, NC",27340.0,2019-12-01,-9,0,-9
"Jacksonville, NC",27340.0,2020-01-01,74,0,74
"Jacksonville, NC",27340.0,2020-02-01,23,0,23
"Jacksonville, NC",27340.0,2020-03-01,11,0,11
"Jacksonville, NC",27340.0,2020-04-01,54,15,39
"Jacksonville, NC",27340.0,2020-05-01,45,0,45
"Jacksonville, NC",27340.0,2020-06-01,-11,0,-11
"Jacksonville, NC",27340.0,2020-07-01,-91,0,-91
"Jacksonville, NC",27340.0,2020-08-01,-31,0,-31
"Jacksonville, NC",27340.0,2020-09-01,-77,0,-77
"Jacksonville, NC",27340.0,2020-10-01,38,0,38
"Jacksonville, NC",27340.0,2020-11-01,75,0,75
"Jacksonville, NC",27340.0,2020-12-01,-58,0,-58
"Orangeburg, SC",36700.0,2019-01-01,18,0,18
"Orangeburg, SC",36700.0,2019-02-01,9,0,9
"Orangeburg, SC",36700.0,2019-03-01,25,0,25
"Orangeburg, SC",36700.0,2019-04-01,13,0,13
"Orangeburg, SC",36700.0,2019-05-01,21,0,21
"Orangeburg, SC",36700.0,2019-06-01,-5,0,-5
"Orangeburg, SC",36700.0,2019-07-01,-13,0,-13
"Orangeburg, SC",36700.0,2019-08-01,-9,0,-9
"Orangeburg, SC",36700.0,2019-09-01,31,0,31
"Orangeburg, SC",36700.0,2019-10-01,-8,0,-8
"Orangeburg, SC",36700.0,2019-11-01,33,0,33
"Orangeburg, SC",36700.0,2019-12-01,-6,0,-6
"Orangeburg, SC",36700.0,2020-01-01,13,0,13
"Orangeburg, SC",36700.0,2020-02-01,9,0,9
"Orangeburg, SC",36700.0,2020-03-01,23,0,23
"Orangeburg, SC",36700.0,2020-04-01,9,0,9
"Orangeburg, SC",36700.0,2020-05-01,25,0,25
"Orangeburg, SC",36700.0,2020-06-01,41,0,41
"Orangeburg, SC",36700.0,2020-07-01,44,0,44
"Orangeburg, SC",36700.0,2020-08-01,35,0,35
"Orangeburg, SC",36700.0,2020-09-01,43,0,43
"Orangeburg, SC",36700.0,2020-10-01,-5,0,-5
"Orangeburg, SC",36700.0,2020-11-01,-51,0,-51
"Orangeburg, SC",36700.0,2020-12-01,24,0,24
"Alamogordo, NM",10460.0,2019-01-01,25,0,25
"Alamogordo, NM",10460.0,2019-02-01,47,0,47
"Alamogordo, NM",10460.0,2019-03-01,28,0,28
"Alamogordo, NM",10460.0,2019-04-01,40,0,40
"Alamogordo, NM",10460.0,2019-05-01,31,0,31
"Alamogordo, NM",10460.0,2019-06-01,28,0,28
"Alamogordo, NM",10460.0,2019-07-01,17,0,17
"Alamogordo, NM",10460.0,2019-08-01,53,0,53
"Alamogordo, NM",10460.0,2019-09-01,38,0,38
"Alamogordo, NM",10460.0,2019-10-01,48,0,48
"Alamogordo, NM",10460.0,2019-11-01,23,0,23
"Alamogordo, NM",10460.0,2019-12-01,92,0,92
"Alamogordo, NM",10460.0,2020-01-01,31,0,31
"Alamogordo, NM",10460.0,2020-02-01,17,0,17
"Alamogordo, NM",10460.0,2020-03-01,70,0,70
"Alamogordo, NM",10460.0,2020-04-01,46,0,46
"Alamogordo, NM",10460.0,2020-05-01,52,0,52
"Alamogordo, NM",10460.0,2020-06-01,71,0,71
"Alamogordo, NM",10460.0,2020-07-01,41,0,41
"Alamogordo, NM",10460.0,2020-08-01,51,0,51
"Alamogordo, NM",10460.0,2020-09-01,68,0,68
"Alamogordo, NM",10460.0,2020-10-01,11,-24,35
"Alamogordo, NM",10460.0,2020-11-01,48,0,48
"Alamogordo, NM",10460.0,2020-12-01,17,0,17
"Oneonta, NY",36580.0,2019-01-01,-23,-28,5
"Oneonta, NY",36580.0,2019-02-01,8,0,8
"Oneonta, NY",36580.0,2019-03-01,2,0,2
"Oneonta, NY",36580.0,2019-04-01,28,39,-11
"Oneonta, NY",36580.0,2019-05-01,18,56,-38
"Oneonta, NY",36580.0,2019-06-01,-37,0,-37
"Oneonta, NY",36580.0,2019-07-01,12,0,12
"Oneonta, NY",36580.0,2019-08-01,-31,0,-31
"Oneonta, NY",36580.0,2019-09-01,-21,0,-21
"Oneonta, NY",36580.0,2019-10-01,-3,-32,29
"Oneonta, NY",36580.0,2019-11-01,-15,-11,-4
"Oneonta, NY",36580.0,2019-12-01,-20,-31,11
"Oneonta, NY",36580.0,2020-01-01,-33,-28,-5
"Oneonta, NY",36580.0,2020-02-01,36,0,36
"Oneonta, NY",36580.0,2020-03-01,39,29,10
"Oneonta, NY",36580.0,2020-04-01,2,26,-24
"Oneonta, NY",36580.0,2020-05-01,12,13,-1
"Oneonta, NY",36580.0,2020-06-01,82,49,33
"Oneonta, NY",36580.0,2020-07-01,45,0,45
"Oneonta, NY",36580.0,2020-08-01,-5,0,-5
"Oneonta, NY",36580.0,2020-09-01,2,0,2
"Oneonta, NY",36580.0,2020-10-01,-50,-45,-5
"Oneonta, NY",36580.0,2020-11-01,-17,-13,-4
"Oneonta, NY",36580.0,2020-12-01,-3,0,-3
"Salina, KS",41460.0,2019-01-01,24,0,24
"Salina, KS",41460.0,2019-02-01,0,0,0
"Salina, KS",41460.0,2019-03-01,33,0,33
"Salina, KS",41460.0,2019-04-01,-30,0,-30
"Salina, KS",41460.0,2019-05-01,-18,0,-18
"Salina, KS",41460.0,2019-06-01,-14,0,-14
"Salina, KS",41460.0,2019-07-01,1,0,1
"Salina, KS",41460.0,2019-08-01,32,0,32
"Salina, KS",41460.0,2019-09-01,10,0,10
"Salina, KS",41460.0,2019-10-01,-6,0,-6
"Salina, KS",41460.0,2019-11-01,13,0,13
"Salina, KS",41460.0,2019-12-01,-18,0,-18
"Salina, KS",41460.0,2020-01-01,-4,0,-4
"Salina, KS",41460.0,2020-02-01,-27,0,-27
"Salina, KS",41460.0,2020-03-01,-9,0,-9
"Salina, KS",41460.0,2020-04-01,-5,0,-5
"Salina, KS",41460.0,2020-05-01,6,0,6
"Salina, KS",41460.0,2020-06-01,-3,0,-3
"Salina, KS",41460.0,2020-07-01,34,0,34
"Salina, KS",41460.0,2020-08-01,-51,0,-51
"Salina, KS",41460.0,2020-09-01,-5,0,-5
"Salina, KS",41460.0,2020-10-01,-15,0,-15
"Salina, KS",41460.0,2020-11-01,15,0,15
"Salina, KS",41460.0,2020-12-01,-14,0,-14
"Miami, OK",33060.0,2019-01-01,-1,0,-1
"Miami, OK",33060.0,2019-02-01,14,0,14
"Miami, OK",33060.0,2019-03-01,-20,0,-20
"Miami, OK",33060.0,2019-04-01,-5,0,-5
"Miami, OK",33060.0,2019-05-01,7,0,7
"Miami, OK",33060.0,2019-06-01,-11,0,-11
"Miami, OK",33060.0,2019-07-01,10,0,10
"Miami, OK",33060.0,2019-08-01,21,0,21
"Miami, OK",33060.0,2019-09-01,44,0,44
"Miami, OK",33060.0,2019-10-01,-4,0,-4
"Miami, OK",33060.0,2019-11-01,16,0,16
"Miami, OK",33060.0,2019-12-01,9,0,9
"Miami, OK",33060.0,2020-01-01,10,0,10
"Miami, OK",33060.0,2020-02-01,10,0,10
"Miami, OK",33060.0,2020-03-01,-11,0,-11
"Miami, OK",33060.0,2020-04-01,53,0,53
"Miami, OK",33060.0,2020-05-01,1,0,1
"Miami, OK",33060.0,2020-06-01,27,0,27
"Miami, OK",33060.0,2020-07-01,34,0,34
"Miami, OK",33060.0,2020-08-01,34,0,34
"Miami, OK",33060.0,2020-09-01,11,0,11
"Miami, OK",33060.0,2020-10-01,-8,0,-8
"Miami, OK",33060.0,2020-11-01,17,0,17
"Miami, OK",33060.0,2020-12-01,21,0,21
"Fergus Falls, MN",22260.0,2019-01-01,-86,-79,-7
"Fergus Falls, MN",22260.0,2019-02-01,-11,0,-11
"Fergus Falls, MN",22260.0,2019-03-01,41,-15,56
"Fergus Falls, MN",22260.0,2019-04-01,280,135,145
"Fergus Falls, MN",22260.0,2019-05-01,330,274,56
"Fergus Falls, MN",22260.0,2019-06-01,77,58,19
"Fergus Falls, MN",22260.0,2019-07-01,43,0,43
"Fergus Falls, MN",22260.0,2019-08-01,5,0,5
"Fergus Falls, MN",22260.0,2019-09-01,-29,-47,18
"Fergus Falls, MN",22260.0,2019-10-01,-340,-312,-28
"Fergus Falls, MN",22260.0,2019-11-01,-224,-209,-15
"Fergus Falls, MN",22260.0,2019-12-01,-161,-208,47
"Fergus Falls, MN",22260.0,2020-01-01,-147,-134,-13
"Fergus Falls, MN",22260.0,2020-02-01,-6,0,-6
"Fergus Falls, MN",22260.0,2020-03-01,66,40,26
"Fergus Falls, MN",22260.0,2020-04-01,205,101,104
"Fergus Falls, MN",22260.0,2020-05-01,252,214,38
"Fergus Falls, MN",22260.0,2020-06-01,148,71,77
"Fergus Falls, MN",22260.0,2020-07-01,31,11,20
"Fergus Falls, MN",22260.0,2020-08-01,28,0,28
"Fergus Falls, MN",22260.0,2020-09-01,-60,-66,6
"Fergus Falls, MN",22260.0,2020-10-01,-305,-254,-51
"Fergus Falls, MN",22260.0,2020-11-01,-230,-205,-25
"Fergus Falls, MN",22260.0,2020-12-01,-100,-121,21
"Mineral Wells, TX",33420.0,2019-01-01,-6,0,-6
"Mineral Wells, TX",33420.0,2019-02-01,32,0,32
"Mineral Wells, TX",33420.0,2019-03-01,11,0,11
"Mineral Wells, TX",33420.0,2019-04-01,9,0,9
"Mineral Wells, TX",33420.0,2019-05-01,10,0,10
"Mineral Wells, TX",33420.0,2019-06-01,17,0,17
"Mineral Wells, TX",33420.0,2019-07-01,34,0,34
"Mineral Wells, TX",33420.0,2019-08-01,0,0,0
"Mineral Wells, TX",33420.0,2019-09-01,18,0,18
"Mineral Wells, TX",33420.0,2019-10-01,-14,0,-14
"Mineral Wells, TX",33420.0,2019-11-01,-31,0,-31
"Mineral Wells, TX",33420.0,2019-12-01,-17,0,-17
"Mineral Wells, TX",33420.0,2020-01-01,-10,0,-10
"Mineral Wells, TX",33420.0,2020-02-01,11,0,11
"Mineral Wells, TX",33420.0,2020-03-01,5,0,5
"Mineral Wells, TX",33420.0,2020-04-01,0,0,0
"Mineral Wells, TX",33420.0,2020-05-01,-14,0,-14
"Mineral Wells, TX",33420.0,2020-06-01,23,0,23
"Mineral Wells, TX",33420.0,2020-07-01,32,0,32
"Mineral Wells, TX",33420.0,2020-08-01,14,0,14
"Mineral Wells, TX",33420.0,2020-09-01,12,0,12
"Mineral Wells, TX",33420.0,2020-10-01,28,0,28
"Mineral Wells, TX",33420.0,2020-11-01,4,0,4
"Mineral Wells, TX",33420.0,2020-12-01,-2,0,-2
"Elizabeth City, NC",21020.0,2019-01-01,5,0,5
"Elizabeth City, NC",21020.0,2019-02-01,0,0,0
"Elizabeth City, NC",21020.0,2019-03-01,-11,0,-11
"Elizabeth City, NC",21020.0,2019-04-01,50,0,50
"Elizabeth City, NC",21020.0,2019-05-01,32,0,32
"Elizabeth City, NC",21020.0,2019-06-01,13,0,13
"Elizabeth City, NC",21020.0,2019-07-01,-26,0,-26
"Elizabeth City, NC",21020.0,2019-08-01,2,0,2
"Elizabeth City, NC",21020.0,2019-09-01,0,0,0
"Elizabeth City, NC",21020.0,2019-10-01,-11,0,-11
"Elizabeth City, NC",21020.0,2019-11-01,14,0,14
"Elizabeth City, NC",21020.0,2019-12-01,11,0,11
"Elizabeth City, NC",21020.0,2020-01-01,11,0,11
"Elizabeth City, NC",21020.0,2020-02-01,-11,0,-11
"Elizabeth City, NC",21020.0,2020-03-01,-13,0,-13
"Elizabeth City, NC",21020.0,2020-04-01,52,0,52
"Elizabeth City, NC",21020.0,2020-05-01,31,0,31
"Elizabeth City, NC",21020.0,2020-06-01,37,0,37
"Elizabeth City, NC",21020.0,2020-07-01,41,0,41
"Elizabeth City, NC",21020.0,2020-08-01,7,0,7
"Elizabeth City, NC",21020.0,2020-09-01,22,0,22
"Elizabeth City, NC",21020.0,2020-10-01,36,0,36
"Elizabeth City, NC",21020.0,2020-11-01,28,0,28
"Elizabeth City, NC",21020.0,2020-12-01,4,0,4
"Guayama, PR",25020.0,2019-01-01,0,0,0
"Guayama, PR",25020.0,2019-02-01,0,0,0
"Guayama, PR",25020.0,2019-12-01,0,0,0
"Guayama, PR",25020.0,2020-01-01,0,0,0
"Guayama, PR",25020.0,2020-02-01,0,0,0
"Guayama, PR",25020.0,2020-05-01,0,0,0
"Stillwater, OK",44660.0,2019-01-01,-55,0,-55
"Stillwater, OK",44660.0,2019-02-01,-20,0,-20
"Stillwater, OK",44660.0,2019-03-01,-64,0,-64
"Stillwater, OK",44660.0,2019-04-01,-27,0,-27
"Stillwater, OK",44660.0,2019-05-01,-326,0,-326
"Stillwater, OK",44660.0,2019-06-01,-125,0,-125
"Stillwater, OK",44660.0,2019-07-01,-126,0,-126
"Stillwater, OK",44660.0,2019-08-01,-37,0,-37
"Stillwater, OK",44660.0,2019-09-01,-9,0,-9
"Stillwater, OK",44660.0,2019-10-01,-14,0,-14
"Stillwater, OK",44660.0,2019-11-01,-17,0,-17
"Stillwater, OK",44660.0,2019-12-01,-46,0,-46
"Stillwater, OK",44660.0,2020-01-01,-2,0,-2
"Stillwater, OK",44660.0,2020-02-01,-36,0,-36
"Stillwater, OK",44660.0,2020-03-01,11,0,11
"Stillwater, OK",44660.0,2020-04-01,-73,0,-73
"Stillwater, OK",44660.0,2020-05-01,-201,0,-201
"Stillwater, OK",44660.0,2020-06-01,-84,0,-84
"Stillwater, OK",44660.0,2020-07-01,-72,0,-72
"Stillwater, OK",44660.0,2020-08-01,-27,0,-27
"Stillwater, OK",44660.0,2020-09-01,12,0,12
"Stillwater, OK",44660.0,2020-10-01,17,0,17
"Stillwater, OK",44660.0,2020-11-01,-19,0,-19
"Stillwater, OK",44660.0,2020-12-01,-64,0,-64
"Picayune, MS",38100.0,2019-01-01,20,0,20
"Picayune, MS",38100.0,2019-02-01,6,0,6
"Picayune, MS",38100.0,2019-03-01,-13,0,-13
"Picayune, MS",38100.0,2019-04-01,47,0,47
"Picayune, MS",38100.0,2019-05-01,23,0,23
"Picayune, MS",38100.0,2019-06-01,12,0,12
"Picayune, MS",38100.0,2019-07-01,7,0,7
"Picayune, MS",38100.0,2019-08-01,18,0,18
"Picayune, MS",38100.0,2019-09-01,25,0,25
"Picayune, MS",38100.0,2019-10-01,23,0,23
"Picayune, MS",38100.0,2019-11-01,10,0,10
"Picayune, MS",38100.0,2019-12-01,-18,0,-18
"Picayune, MS",38100.0,2020-01-01,27,0,27
"Picayune, MS",38100.0,2020-02-01,10,0,10
"Picayune, MS",38100.0,2020-03-01,9,0,9
"Picayune, MS",38100.0,2020-04-01,16,0,16
"Picayune, MS",38100.0,2020-05-01,37,0,37
"Picayune, MS",38100.0,2020-06-01,-3,0,-3
"Picayune, MS",38100.0,2020-07-01,36,0,36
"Picayune, MS",38100.0,2020-08-01,8,0,8
"Picayune, MS",38100.0,2020-09-01,3,0,3
"Picayune, MS",38100.0,2020-10-01,6,0,6
"Picayune, MS",38100.0,2020-11-01,-18,0,-18
"Picayune, MS",38100.0,2020-12-01,12,0,12
"Bangor, ME",12620.0,2019-01-01,-39,-74,35
"Bangor, ME",12620.0,2019-02-01,38,0,38
"Bangor, ME",12620.0,2019-03-01,-52,0,-52
"Bangor, ME",12620.0,2019-04-01,153,132,21
"Bangor, ME",12620.0,2019-05-01,165,288,-123
"Bangor, ME",12620.0,2019-06-01,23,59,-36
"Bangor, ME",12620.0,2019-07-01,-51,0,-51
"Bangor, ME",12620.0,2019-08-01,-38,0,-38
"Bangor, ME",12620.0,2019-09-01,-37,-12,-25
"Bangor, ME",12620.0,2019-10-01,-284,-261,-23
"Bangor, ME",12620.0,2019-11-01,-99,-134,35
"Bangor, ME",12620.0,2019-12-01,-157,-147,-10
"Bangor, ME",12620.0,2020-01-01,-39,-48,9
"Bangor, ME",12620.0,2020-02-01,19,0,19
"Bangor, ME",12620.0,2020-03-01,19,22,-3
"Bangor, ME",12620.0,2020-04-01,95,72,23
"Bangor, ME",12620.0,2020-05-01,164,195,-31
"Bangor, ME",12620.0,2020-06-01,66,59,7
"Bangor, ME",12620.0,2020-07-01,-34,11,-45
"Bangor, ME",12620.0,2020-08-01,-58,0,-58
"Bangor, ME",12620.0,2020-09-01,45,0,45
"Bangor, ME",12620.0,2020-10-01,-206,-188,-18
"Bangor, ME",12620.0,2020-11-01,-112,-91,-21
"Bangor, ME",12620.0,2020-12-01,-23,-47,24
"Sedalia, MO",42740.0,2019-01-01,-4,0,-4
"Sedalia, MO",42740.0,2019-02-01,-40,0,-40
"Sedalia, MO",42740.0,2019-03-01,-36,0,-36
"Sedalia, MO",42740.0,2019-04-01,-4,0,-4
"Sedalia, MO",42740.0,2019-05-01,-39,0,-39
"Sedalia, MO",42740.0,2019-06-01,-45,0,-45
"Sedalia, MO",42740.0,2019-07-01,-26,0,-26
"Sedalia, MO",42740.0,2019-08-01,-15,0,-15
"Sedalia, MO",42740.0,2019-09-01,12,0,12
"Sedalia, MO",42740.0,2019-10-01,-22,0,-22
"Sedalia, MO",42740.0,2019-11-01,11,0,11
"Sedalia, MO",42740.0,2019-12-01,14,0,14
"Sedalia, MO",42740.0,2020-01-01,-28,0,-28
"Sedalia, MO",42740.0,2020-02-01,15,0,15
"Sedalia, MO",42740.0,2020-03-01,-32,0,-32
"Sedalia, MO",42740.0,2020-04-01,-6,0,-6
"Sedalia, MO",42740.0,2020-05-01,-49,0,-49
"Sedalia, MO",42740.0,2020-06-01,10,0,10
"Sedalia, MO",42740.0,2020-07-01,-50,0,-50
"Sedalia, MO",42740.0,2020-08-01,9,0,9
"Sedalia, MO",42740.0,2020-09-01,22,0,22
"Sedalia, MO",42740.0,2020-10-01,-33,0,-33
"Sedalia, MO",42740.0,2020-11-01,2,0,2
"Sedalia, MO",42740.0,2020-12-01,-2,0,-2
"Rolla, MO",40620.0,2019-01-01,29,0,29
"Rolla, MO",40620.0,2019-02-01,2,0,2
"Rolla, MO",40620.0,2019-03-01,-32,0,-32
"Rolla, MO",40620.0,2019-04-01,19,0,19
"Rolla, MO",40620.0,2019-05-01,-22,0,-22
"Rolla, MO",40620.0,2019-06-01,37,0,37
"Rolla, MO",40620.0,2019-07-01,-12,0,-12
"Rolla, MO",40620.0,2019-08-01,54,0,54
"Rolla, MO",40620.0,2019-09-01,11,0,11
"Rolla, MO",40620.0,2019-10-01,31,0,31
"Rolla, MO",40620.0,2019-11-01,11,0,11
"Rolla, MO",40620.0,2019-12-01,-1,0,-1
"Rolla, MO",40620.0,2020-01-01,-3,0,-3
"Rolla, MO",40620.0,2020-02-01,0,0,0
"Rolla, MO",40620.0,2020-03-01,-25,0,-25
"Rolla, MO",40620.0,2020-04-01,26,0,26
"Rolla, MO",40620.0,2020-05-01,17,0,17
"Rolla, MO",40620.0,2020-06-01,5,0,5
"Rolla, MO",40620.0,2020-07-01,11,0,11
"Rolla, MO",40620.0,2020-08-01,43,0,43
"Rolla, MO",40620.0,2020-09-01,21,0,21
"Rolla, MO",40620.0,2020-10-01,33,0,33
"Rolla, MO",40620.0,2020-11-01,35,0,35
"Rolla, MO",40620.0,2020-12-01,0,0,0
"Helena-West Helena, AR",25760.0,2019-01-01,0,0,0
"Helena-West Helena, AR",25760.0,2019-02-01,-11,0,-11
"Helena-West Helena, AR",25760.0,2019-03-01,0,0,0
"Helena-West Helena, AR",25760.0,2019-04-01,0,0,0
"Helena-West Helena, AR",25760.0,2019-05-01,-11,0,-11
"Helena-West Helena, AR",25760.0,2019-06-01,0,0,0
"Helena-West Helena, AR",25760.0,2019-07-01,0,0,0
"Helena-West Helena, AR",25760.0,2019-08-01,0,0,0
"Helena-West Helena, AR",25760.0,2019-09-01,-16,0,-16
"Helena-West Helena, AR",25760.0,2019-10-01,0,0,0
"Helena-West Helena, AR",25760.0,2019-11-01,0,0,0
"Helena-West Helena, AR",25760.0,2019-12-01,0,0,0
"Helena-West Helena, AR",25760.0,2020-01-01,0,0,0
"Helena-West Helena, AR",25760.0,2020-02-01,0,0,0
"Helena-West Helena, AR",25760.0,2020-03-01,0,0,0
"Helena-West Helena, AR",25760.0,2020-04-01,-11,0,-11
"Helena-West Helena, AR",25760.0,2020-05-01,0,0,0
"Helena-West Helena, AR",25760.0,2020-06-01,0,0,0
"Helena-West Helena, AR",25760.0,2020-07-01,0,0,0
"Helena-West Helena, AR",25760.0,2020-08-01,0,0,0
"Helena-West Helena, AR",25760.0,2020-09-01,0,0,0
"Helena-West Helena, AR",25760.0,2020-10-01,0,0,0
"Helena-West Helena, AR",25760.0,2020-11-01,0,0,0
"Helena-West Helena, AR",25760.0,2020-12-01,0,0,0
"Waycross, GA",48180.0,2019-01-01,31,0,31
"Waycross, GA",48180.0,2019-02-01,-16,0,-16
"Waycross, GA",48180.0,2019-03-01,0,0,0
"Waycross, GA",48180.0,2019-04-01,0,0,0
"Waycross, GA",48180.0,2019-05-01,0,0,0
"Waycross, GA",48180.0,2019-06-01,0,0,0
"Waycross, GA",48180.0,2019-07-01,0,0,0
"Waycross, GA",48180.0,2019-08-01,11,0,11
"Waycross, GA",48180.0,2019-09-01,24,0,24
"Waycross, GA",48180.0,2019-10-01,14,0,14
"Waycross, GA",48180.0,2019-11-01,0,0,0
"Waycross, GA",48180.0,2019-12-01,0,0,0
"Waycross, GA",48180.0,2020-01-01,0,0,0
"Waycross, GA",48180.0,2020-02-01,0,0,0
"Waycross, GA",48180.0,2020-03-01,0,0,0
"Waycross, GA",48180.0,2020-04-01,-5,0,-5
"Waycross, GA",48180.0,2020-05-01,-2,0,-2
"Waycross, GA",48180.0,2020-06-01,0,0,0
"Waycross, GA",48180.0,2020-07-01,-11,0,-11
"Waycross, GA",48180.0,2020-08-01,-12,0,-12
"Waycross, GA",48180.0,2020-09-01,0,0,0
"Waycross, GA",48180.0,2020-10-01,0,0,0
"Waycross, GA",48180.0,2020-11-01,0,0,0
"Waycross, GA",48180.0,2020-12-01,0,0,0
"Troy, AL",45980.0,2019-01-01,22,0,22
"Troy, AL",45980.0,2019-02-01,-12,0,-12
"Troy, AL",45980.0,2019-03-01,-17,0,-17
"Troy, AL",45980.0,2019-04-01,0,0,0
"Troy, AL",45980.0,2019-05-01,-30,0,-30
"Troy, AL",45980.0,2019-06-01,-36,0,-36
"Troy, AL",45980.0,2019-07-01,-37,0,-37
"Troy, AL",45980.0,2019-08-01,18,0,18
"Troy, AL",45980.0,2019-09-01,-27,0,-27
"Troy, AL",45980.0,2019-10-01,5,0,5
"Troy, AL",45980.0,2019-11-01,0,0,0
"Troy, AL",45980.0,2019-12-01,0,0,0
"Troy, AL",45980.0,2020-01-01,0,0,0
"Troy, AL",45980.0,2020-02-01,0,0,0
"Troy, AL",45980.0,2020-03-01,0,0,0
"Troy, AL",45980.0,2020-04-01,-42,0,-42
"Troy, AL",45980.0,2020-05-01,3,0,3
"Troy, AL",45980.0,2020-06-01,-16,0,-16
"Troy, AL",45980.0,2020-07-01,-3,0,-3
"Troy, AL",45980.0,2020-08-01,-17,0,-17
"Troy, AL",45980.0,2020-09-01,0,0,0
"Troy, AL",45980.0,2020-10-01,-36,0,-36
"Troy, AL",45980.0,2020-11-01,11,0,11
"Troy, AL",45980.0,2020-12-01,24,0,24
"McComb, MS",32620.0,2019-01-01,29,0,29
"McComb, MS",32620.0,2019-02-01,-21,0,-21
"McComb, MS",32620.0,2019-03-01,-13,0,-13
"McComb, MS",32620.0,2019-04-01,-13,0,-13
"McComb, MS",32620.0,2019-05-01,13,0,13
"McComb, MS",32620.0,2019-06-01,11,0,11
"McComb, MS",32620.0,2019-07-01,-18,0,-18
"McComb, MS",32620.0,2019-08-01,20,0,20
"McComb, MS",32620.0,2019-09-01,-36,0,-36
"McComb, MS",32620.0,2019-10-01,2,0,2
"McComb, MS",32620.0,2019-11-01,12,0,12
"McComb, MS",32620.0,2019-12-01,0,0,0
"McComb, MS",32620.0,2020-01-01,-11,0,-11
"McComb, MS",32620.0,2020-02-01,0,0,0
"McComb, MS",32620.0,2020-03-01,33,0,33
"McComb, MS",32620.0,2020-04-01,-27,0,-27
"McComb, MS",32620.0,2020-05-01,0,0,0
"McComb, MS",32620.0,2020-06-01,-15,0,-15
"McComb, MS",32620.0,2020-07-01,0,0,0
"McComb, MS",32620.0,2020-08-01,-15,0,-15
"McComb, MS",32620.0,2020-09-01,0,0,0
"McComb, MS",32620.0,2020-10-01,1,0,1
"McComb, MS",32620.0,2020-11-01,-11,0,-11
"McComb, MS",32620.0,2020-12-01,-25,0,-25
"Tucson, AZ",46060.0,2019-01-01,1682,1581,101
"Tucson, AZ",46060.0,2019-02-01,461,252,209
"Tucson, AZ",46060.0,2019-03-01,23,36,-13
"Tucson, AZ",46060.0,2019-04-01,-2435,-2122,-313
"Tucson, AZ",46060.0,2019-05-01,-3779,-3879,100
"Tucson, AZ",46060.0,2019-06-01,-873,-1145,272
"Tucson, AZ",46060.0,2019-07-01,223,-173,396
"Tucson, AZ",46060.0,2019-08-01,456,-97,553
"Tucson, AZ",46060.0,2019-09-01,908,283,625
"Tucson, AZ",46060.0,2019-10-01,3841,3074,767
"Tucson, AZ",46060.0,2019-11-01,2026,1645,381
"Tucson, AZ",46060.0,2019-12-01,2090,1840,250
"Tucson, AZ",46060.0,2020-01-01,1637,1515,122
"Tucson, AZ",46060.0,2020-02-01,409,243,166
"Tucson, AZ",46060.0,2020-03-01,82,96,-14
"Tucson, AZ",46060.0,2020-04-01,-146,-254,108
"Tucson, AZ",46060.0,2020-05-01,-2816,-2651,-165
"Tucson, AZ",46060.0,2020-06-01,-1208,-1347,139
"Tucson, AZ",46060.0,2020-07-01,-36,-249,213
"Tucson, AZ",46060.0,2020-08-01,254,-9,263
"Tucson, AZ",46060.0,2020-09-01,835,220,615
"Tucson, AZ",46060.0,2020-10-01,3800,3078,722
"Tucson, AZ",46060.0,2020-11-01,2197,1908,289
"Tucson, AZ",46060.0,2020-12-01,1467,1406,61
"Greenville, NC",24780.0,2019-01-01,51,0,51
"Greenville, NC",24780.0,2019-02-01,10,0,10
"Greenville, NC",24780.0,2019-03-01,17,0,17
"Greenville, NC",24780.0,2019-04-01,-26,0,-26
"Greenville, NC",24780.0,2019-05-01,-158,-12,-146
"Greenville, NC",24780.0,2019-06-01,-143,0,-143
"Greenville, NC",24780.0,2019-07-01,-99,0,-99
"Greenville, NC",24780.0,2019-08-01,27,0,27
"Greenville, NC",24780.0,2019-09-01,-42,0,-42
"Greenville, NC",24780.0,2019-10-01,-69,0,-69
"Greenville, NC",24780.0,2019-11-01,31,0,31
"Greenville, NC",24780.0,2019-12-01,4,0,4
"Greenville, NC",24780.0,2020-01-01,39,0,39
"Greenville, NC",24780.0,2020-02-01,-57,0,-57
"Greenville, NC",24780.0,2020-03-01,-44,0,-44
"Greenville, NC",24780.0,2020-04-01,-83,-12,-71
"Greenville, NC",24780.0,2020-05-01,-55,0,-55
"Greenville, NC",24780.0,2020-06-01,-120,0,-120
"Greenville, NC",24780.0,2020-07-01,-177,0,-177
"Greenville, NC",24780.0,2020-08-01,63,0,63
"Greenville, NC",24780.0,2020-09-01,-10,0,-10
"Greenville, NC",24780.0,2020-10-01,-36,0,-36
"Greenville, NC",24780.0,2020-11-01,-32,0,-32
"Greenville, NC",24780.0,2020-12-01,-4,0,-4
"McAlester, OK",32540.0,2019-01-01,-11,0,-11
"McAlester, OK",32540.0,2019-02-01,0,0,0
"McAlester, OK",32540.0,2019-03-01,0,0,0
"McAlester, OK",32540.0,2019-04-01,0,0,0
"McAlester, OK",32540.0,2019-05-01,0,0,0
"McAlester, OK",32540.0,2019-06-01,0,0,0
"McAlester, OK",32540.0,2019-07-01,0,0,0
"McAlester, OK",32540.0,2019-08-01,0,0,0
"McAlester, OK",32540.0,2019-09-01,0,0,0
"McAlester, OK",32540.0,2019-10-01,11,0,11
"McAlester, OK",32540.0,2019-11-01,0,0,0
"McAlester, OK",32540.0,2019-12-01,0,0,0
"McAlester, OK",32540.0,2020-01-01,23,0,23
"McAlester, OK",32540.0,2020-02-01,2,0,2
"McAlester, OK",32540.0,2020-03-01,-14,0,-14
"McAlester, OK",32540.0,2020-04-01,-12,0,-12
"McAlester, OK",32540.0,2020-05-01,0,0,0
"McAlester, OK",32540.0,2020-06-01,-12,0,-12
"McAlester, OK",32540.0,2020-07-01,24,0,24
"McAlester, OK",32540.0,2020-08-01,-2,0,-2
"McAlester, OK",32540.0,2020-09-01,11,0,11
"McAlester, OK",32540.0,2020-10-01,11,0,11
"McAlester, OK",32540.0,2020-11-01,-13,0,-13
"McAlester, OK",32540.0,2020-12-01,12,0,12
"Columbus, NE",18100.0,2019-01-01,-2,-15,13
"Columbus, NE",18100.0,2019-02-01,0,0,0
"Columbus, NE",18100.0,2019-03-01,12,0,12
"Columbus, NE",18100.0,2019-04-01,9,13,-4
"Columbus, NE",18100.0,2019-05-01,9,0,9
"Columbus, NE",18100.0,2019-06-01,-13,0,-13
"Columbus, NE",18100.0,2019-07-01,-38,0,-38
"Columbus, NE",18100.0,2019-08-01,-43,0,-43
"Columbus, NE",18100.0,2019-09-01,0,0,0
"Columbus, NE",18100.0,2019-10-01,21,0,21
"Columbus, NE",18100.0,2019-11-01,-28,0,-28
"Columbus, NE",18100.0,2019-12-01,-16,-16,0
"Columbus, NE",18100.0,2020-01-01,-24,-13,-11
"Columbus, NE",18100.0,2020-02-01,0,0,0
"Columbus, NE",18100.0,2020-03-01,-19,0,-19
"Columbus, NE",18100.0,2020-04-01,-7,0,-7
"Columbus, NE",18100.0,2020-05-01,9,0,9
"Columbus, NE",18100.0,2020-06-01,12,0,12
"Columbus, NE",18100.0,2020-07-01,18,0,18
"Columbus, NE",18100.0,2020-08-01,-16,0,-16
"Columbus, NE",18100.0,2020-09-01,11,0,11
"Columbus, NE",18100.0,2020-10-01,-27,-11,-16
"Columbus, NE",18100.0,2020-11-01,-13,0,-13
"Columbus, NE",18100.0,2020-12-01,-1,0,-1
"Lakeland-Winter Haven, FL",29460.0,2019-01-01,1802,1097,705
"Lakeland-Winter Haven, FL",29460.0,2019-02-01,659,12,647
"Lakeland-Winter Haven, FL",29460.0,2019-03-01,528,28,500
"Lakeland-Winter Haven, FL",29460.0,2019-04-01,-2087,-1961,-126
"Lakeland-Winter Haven, FL",29460.0,2019-05-01,-839,-1531,692
"Lakeland-Winter Haven, FL",29460.0,2019-06-01,908,-102,1010
"Lakeland-Winter Haven, FL",29460.0,2019-07-01,1156,12,1144
"Lakeland-Winter Haven, FL",29460.0,2019-08-01,802,-11,813
"Lakeland-Winter Haven, FL",29460.0,2019-09-01,732,62,670
"Lakeland-Winter Haven, FL",29460.0,2019-10-01,2666,2017,649
"Lakeland-Winter Haven, FL",29460.0,2019-11-01,2107,1546,561
"Lakeland-Winter Haven, FL",29460.0,2019-12-01,2511,1933,578
"Lakeland-Winter Haven, FL",29460.0,2020-01-01,1551,890,661
"Lakeland-Winter Haven, FL",29460.0,2020-02-01,679,63,616
"Lakeland-Winter Haven, FL",29460.0,2020-03-01,571,-52,623
"Lakeland-Winter Haven, FL",29460.0,2020-04-01,505,-189,694
"Lakeland-Winter Haven, FL",29460.0,2020-05-01,-215,-955,740
"Lakeland-Winter Haven, FL",29460.0,2020-06-01,495,-527,1022
"Lakeland-Winter Haven, FL",29460.0,2020-07-01,1310,1,1309
"Lakeland-Winter Haven, FL",29460.0,2020-08-01,1132,46,1086
"Lakeland-Winter Haven, FL",29460.0,2020-09-01,966,37,929
"Lakeland-Winter Haven, FL",29460.0,2020-10-01,2587,1500,1087
"Lakeland-Winter Haven, FL",29460.0,2020-11-01,2114,1256,858
"Lakeland-Winter Haven, FL",29460.0,2020-12-01,2404,1142,1262
"Cedartown, GA",16340.0,2019-01-01,89,0,89
"Cedartown, GA",16340.0,2019-02-01,-3,0,-3
"Cedartown, GA",16340.0,2019-03-01,37,0,37
"Cedartown, GA",16340.0,2019-04-01,24,0,24
"Cedartown, GA",16340.0,2019-05-01,65,0,65
"Cedartown, GA",16340.0,2019-06-01,31,0,31
"Cedartown, GA",16340.0,2019-07-01,18,0,18
"Cedartown, GA",16340.0,2019-08-01,24,0,24
"Cedartown, GA",16340.0,2019-09-01,31,0,31
"Cedartown, GA",16340.0,2019-10-01,31,0,31
"Cedartown, GA",16340.0,2019-11-01,12,0,12
"Cedartown, GA",16340.0,2019-12-01,4,0,4
"Cedartown, GA",16340.0,2020-01-01,15,0,15
"Cedartown, GA",16340.0,2020-02-01,23,0,23
"Cedartown, GA",16340.0,2020-03-01,16,0,16
"Cedartown, GA",16340.0,2020-04-01,13,0,13
"Cedartown, GA",16340.0,2020-05-01,42,0,42
"Cedartown, GA",16340.0,2020-06-01,-31,0,-31
"Cedartown, GA",16340.0,2020-07-01,21,0,21
"Cedartown, GA",16340.0,2020-08-01,59,0,59
"Cedartown, GA",16340.0,2020-09-01,23,0,23
"Cedartown, GA",16340.0,2020-10-01,-42,0,-42
"Cedartown, GA",16340.0,2020-11-01,42,0,42
"Cedartown, GA",16340.0,2020-12-01,51,0,51
"Ponce, PR",38660.0,2019-01-01,0,0,0
"Ponce, PR",38660.0,2019-02-01,0,0,0
"Ponce, PR",38660.0,2019-03-01,0,0,0
"Ponce, PR",38660.0,2019-04-01,0,0,0
"Ponce, PR",38660.0,2019-05-01,0,0,0
"Ponce, PR",38660.0,2019-06-01,0,0,0
"Ponce, PR",38660.0,2019-07-01,0,0,0
"Ponce, PR",38660.0,2019-08-01,0,0,0
"Ponce, PR",38660.0,2019-09-01,0,0,0
"Ponce, PR",38660.0,2019-10-01,0,0,0
"Ponce, PR",38660.0,2019-11-01,0,0,0
"Ponce, PR",38660.0,2019-12-01,0,0,0
"Ponce, PR",38660.0,2020-01-01,0,0,0
"Ponce, PR",38660.0,2020-02-01,0,0,0
"Ponce, PR",38660.0,2020-03-01,0,0,0
"Ponce, PR",38660.0,2020-04-01,0,0,0
"Ponce, PR",38660.0,2020-05-01,0,0,0
"Ponce, PR",38660.0,2020-06-01,0,0,0
"Ponce, PR",38660.0,2020-07-01,0,0,0
"Ponce, PR",38660.0,2020-08-01,0,0,0
"Ponce, PR",38660.0,2020-09-01,0,0,0
"Ponce, PR",38660.0,2020-10-01,0,0,0
"Ponce, PR",38660.0,2020-11-01,0,0,0
"Ponce, PR",38660.0,2020-12-01,0,0,0
"Ada, OK",10220.0,2019-01-01,-29,0,-29
"Ada, OK",10220.0,2019-02-01,12,0,12
"Ada, OK",10220.0,2019-03-01,-22,0,-22
"Ada, OK",10220.0,2019-04-01,-31,0,-31
"Ada, OK",10220.0,2019-05-01,-5,0,-5
"Ada, OK",10220.0,2019-06-01,22,0,22
"Ada, OK",10220.0,2019-07-01,-29,0,-29
"Ada, OK",10220.0,2019-08-01,-12,0,-12
"Ada, OK",10220.0,2019-09-01,6,0,6
"Ada, OK",10220.0,2019-10-01,11,0,11
"Ada, OK",10220.0,2019-11-01,15,0,15
"Ada, OK",10220.0,2019-12-01,0,0,0
"Ada, OK",10220.0,2020-01-01,-12,0,-12
"Ada, OK",10220.0,2020-02-01,0,0,0
"Ada, OK",10220.0,2020-03-01,0,0,0
"Ada, OK",10220.0,2020-04-01,-6,0,-6
"Ada, OK",10220.0,2020-05-01,-21,0,-21
"Ada, OK",10220.0,2020-06-01,-18,0,-18
"Ada, OK",10220.0,2020-07-01,-31,0,-31
"Ada, OK",10220.0,2020-08-01,-37,0,-37
"Ada, OK",10220.0,2020-09-01,0,0,0
"Ada, OK",10220.0,2020-10-01,-26,0,-26
"Ada, OK",10220.0,2020-11-01,-13,0,-13
"Ada, OK",10220.0,2020-12-01,0,0,0
"Russellville, AR",40780.0,2019-01-01,-4,0,-4
"Russellville, AR",40780.0,2019-02-01,5,0,5
"Russellville, AR",40780.0,2019-03-01,-2,0,-2
"Russellville, AR",40780.0,2019-04-01,2,0,2
"Russellville, AR",40780.0,2019-05-01,-33,0,-33
"Russellville, AR",40780.0,2019-06-01,22,0,22
"Russellville, AR",40780.0,2019-07-01,2,0,2
"Russellville, AR",40780.0,2019-08-01,-68,0,-68
"Russellville, AR",40780.0,2019-09-01,-20,0,-20
"Russellville, AR",40780.0,2019-10-01,-1,0,-1
"Russellville, AR",40780.0,2019-11-01,-27,0,-27
"Russellville, AR",40780.0,2019-12-01,-2,0,-2
"Russellville, AR",40780.0,2020-01-01,-36,0,-36
"Russellville, AR",40780.0,2020-02-01,-16,0,-16
"Russellville, AR",40780.0,2020-03-01,-2,0,-2
"Russellville, AR",40780.0,2020-04-01,-15,0,-15
"Russellville, AR",40780.0,2020-05-01,-28,0,-28
"Russellville, AR",40780.0,2020-06-01,-27,0,-27
"Russellville, AR",40780.0,2020-07-01,-55,0,-55
"Russellville, AR",40780.0,2020-08-01,-9,0,-9
"Russellville, AR",40780.0,2020-09-01,11,0,11
"Russellville, AR",40780.0,2020-10-01,-16,0,-16
"Russellville, AR",40780.0,2020-11-01,-1,0,-1
"Russellville, AR",40780.0,2020-12-01,24,0,24
"Akron, OH",10420.0,2019-01-01,-581,-554,-27
"Akron, OH",10420.0,2019-02-01,67,-21,88
"Akron, OH",10420.0,2019-03-01,113,0,113
"Akron, OH",10420.0,2019-04-01,555,363,192
"Akron, OH",10420.0,2019-05-01,489,448,41
"Akron, OH",10420.0,2019-06-01,110,66,44
"Akron, OH",10420.0,2019-07-01,-21,13,-34
"Akron, OH",10420.0,2019-08-01,70,-11,81
"Akron, OH",10420.0,2019-09-01,-21,3,-24
"Akron, OH",10420.0,2019-10-01,-334,-359,25
"Akron, OH",10420.0,2019-11-01,-78,-218,140
"Akron, OH",10420.0,2019-12-01,-348,-461,113
"Akron, OH",10420.0,2020-01-01,-399,-422,23
"Akron, OH",10420.0,2020-02-01,-23,-50,27
"Akron, OH",10420.0,2020-03-01,259,78,181
"Akron, OH",10420.0,2020-04-01,212,147,65
"Akron, OH",10420.0,2020-05-01,360,310,50
"Akron, OH",10420.0,2020-06-01,80,173,-93
"Akron, OH",10420.0,2020-07-01,4,14,-10
"Akron, OH",10420.0,2020-08-01,21,16,5
"Akron, OH",10420.0,2020-09-01,27,7,20
"Akron, OH",10420.0,2020-10-01,-250,-352,102
"Akron, OH",10420.0,2020-11-01,-302,-268,-34
"Akron, OH",10420.0,2020-12-01,-415,-390,-25
"Stevens Point, WI",44620.0,2019-01-01,-20,-17,-3
"Stevens Point, WI",44620.0,2019-02-01,39,0,39
"Stevens Point, WI",44620.0,2019-03-01,0,0,0
"Stevens Point, WI",44620.0,2019-04-01,2,16,-14
"Stevens Point, WI",44620.0,2019-05-01,-103,0,-103
"Stevens Point, WI",44620.0,2019-06-01,-49,0,-49
"Stevens Point, WI",44620.0,2019-07-01,-53,0,-53
"Stevens Point, WI",44620.0,2019-08-01,-29,0,-29
"Stevens Point, WI",44620.0,2019-09-01,-11,0,-11
"Stevens Point, WI",44620.0,2019-10-01,-1,-11,10
"Stevens Point, WI",44620.0,2019-11-01,12,-17,29
"Stevens Point, WI",44620.0,2019-12-01,-27,-36,9
"Stevens Point, WI",44620.0,2020-01-01,-6,0,-6
"Stevens Point, WI",44620.0,2020-02-01,-32,0,-32
"Stevens Point, WI",44620.0,2020-03-01,9,0,9
"Stevens Point, WI",44620.0,2020-04-01,-20,0,-20
"Stevens Point, WI",44620.0,2020-05-01,-54,0,-54
"Stevens Point, WI",44620.0,2020-06-01,0,0,0
"Stevens Point, WI",44620.0,2020-07-01,-56,0,-56
"Stevens Point, WI",44620.0,2020-08-01,-50,0,-50
"Stevens Point, WI",44620.0,2020-09-01,-4,0,-4
"Stevens Point, WI",44620.0,2020-10-01,59,0,59
"Stevens Point, WI",44620.0,2020-11-01,-9,-13,4
"Stevens Point, WI",44620.0,2020-12-01,17,0,17
"Shawnee, OK",43060.0,2019-01-01,9,0,9
"Shawnee, OK",43060.0,2019-02-01,-10,0,-10
"Shawnee, OK",43060.0,2019-03-01,12,0,12
"Shawnee, OK",43060.0,2019-04-01,60,0,60
"Shawnee, OK",43060.0,2019-05-01,30,0,30
"Shawnee, OK",43060.0,2019-06-01,2,0,2
"Shawnee, OK",43060.0,2019-07-01,-28,0,-28
"Shawnee, OK",43060.0,2019-08-01,16,0,16
"Shawnee, OK",43060.0,2019-09-01,-4,0,-4
"Shawnee, OK",43060.0,2019-10-01,-28,0,-28
"Shawnee, OK",43060.0,2019-11-01,17,0,17
"Shawnee, OK",43060.0,2019-12-01,22,0,22
"Shawnee, OK",43060.0,2020-01-01,50,0,50
"Shawnee, OK",43060.0,2020-02-01,27,0,27
"Shawnee, OK",43060.0,2020-03-01,27,0,27
"Shawnee, OK",43060.0,2020-04-01,21,0,21
"Shawnee, OK",43060.0,2020-05-01,-23,0,-23
"Shawnee, OK",43060.0,2020-06-01,18,0,18
"Shawnee, OK",43060.0,2020-07-01,44,0,44
"Shawnee, OK",43060.0,2020-08-01,24,0,24
"Shawnee, OK",43060.0,2020-09-01,-10,0,-10
"Shawnee, OK",43060.0,2020-10-01,-20,0,-20
"Shawnee, OK",43060.0,2020-11-01,-36,0,-36
"Shawnee, OK",43060.0,2020-12-01,36,0,36
"Pueblo, CO",39380.0,2019-01-01,88,0,88
"Pueblo, CO",39380.0,2019-02-01,58,0,58
"Pueblo, CO",39380.0,2019-03-01,101,0,101
"Pueblo, CO",39380.0,2019-04-01,102,0,102
"Pueblo, CO",39380.0,2019-05-01,71,0,71
"Pueblo, CO",39380.0,2019-06-01,105,0,105
"Pueblo, CO",39380.0,2019-07-01,27,0,27
"Pueblo, CO",39380.0,2019-08-01,70,0,70
"Pueblo, CO",39380.0,2019-09-01,88,0,88
"Pueblo, CO",39380.0,2019-10-01,23,-23,46
"Pueblo, CO",39380.0,2019-11-01,89,0,89
"Pueblo, CO",39380.0,2019-12-01,21,0,21
"Pueblo, CO",39380.0,2020-01-01,51,0,51
"Pueblo, CO",39380.0,2020-02-01,-22,0,-22
"Pueblo, CO",39380.0,2020-03-01,72,-11,83
"Pueblo, CO",39380.0,2020-04-01,116,14,102
"Pueblo, CO",39380.0,2020-05-01,77,11,66
"Pueblo, CO",39380.0,2020-06-01,101,0,101
"Pueblo, CO",39380.0,2020-07-01,62,0,62
"Pueblo, CO",39380.0,2020-08-01,26,0,26
"Pueblo, CO",39380.0,2020-09-01,44,0,44
"Pueblo, CO",39380.0,2020-10-01,-3,-21,18
"Pueblo, CO",39380.0,2020-11-01,3,-23,26
"Pueblo, CO",39380.0,2020-12-01,93,-12,105
"Somerset, KY",43700.0,2019-01-01,8,0,8
"Somerset, KY",43700.0,2019-02-01,-12,0,-12
"Somerset, KY",43700.0,2019-03-01,11,0,11
"Somerset, KY",43700.0,2019-04-01,23,0,23
"Somerset, KY",43700.0,2019-05-01,33,0,33
"Somerset, KY",43700.0,2019-06-01,-14,0,-14
"Somerset, KY",43700.0,2019-07-01,24,0,24
"Somerset, KY",43700.0,2019-08-01,27,0,27
"Somerset, KY",43700.0,2019-09-01,-11,0,-11
"Somerset, KY",43700.0,2019-10-01,4,0,4
"Somerset, KY",43700.0,2019-11-01,-12,-12,0
"Somerset, KY",43700.0,2019-12-01,12,0,12
"Somerset, KY",43700.0,2020-01-01,-31,0,-31
"Somerset, KY",43700.0,2020-02-01,31,0,31
"Somerset, KY",43700.0,2020-03-01,13,0,13
"Somerset, KY",43700.0,2020-04-01,22,0,22
"Somerset, KY",43700.0,2020-05-01,-5,0,-5
"Somerset, KY",43700.0,2020-06-01,5,0,5
"Somerset, KY",43700.0,2020-07-01,22,0,22
"Somerset, KY",43700.0,2020-08-01,-20,0,-20
"Somerset, KY",43700.0,2020-09-01,13,0,13
"Somerset, KY",43700.0,2020-10-01,-2,0,-2
"Somerset, KY",43700.0,2020-11-01,5,0,5
"Somerset, KY",43700.0,2020-12-01,-36,-12,-24
"Fort Leonard Wood, MO",22780.0,2019-01-01,-35,0,-35
"Fort Leonard Wood, MO",22780.0,2019-02-01,-10,0,-10
"Fort Leonard Wood, MO",22780.0,2019-03-01,45,0,45
"Fort Leonard Wood, MO",22780.0,2019-04-01,9,0,9
"Fort Leonard Wood, MO",22780.0,2019-05-01,-59,0,-59
"Fort Leonard Wood, MO",22780.0,2019-06-01,-8,0,-8
"Fort Leonard Wood, MO",22780.0,2019-07-01,-15,0,-15
"Fort Leonard Wood, MO",22780.0,2019-08-01,-18,0,-18
"Fort Leonard Wood, MO",22780.0,2019-09-01,2,0,2
"Fort Leonard Wood, MO",22780.0,2019-10-01,8,0,8
"Fort Leonard Wood, MO",22780.0,2019-11-01,0,0,0
"Fort Leonard Wood, MO",22780.0,2019-12-01,-36,0,-36
"Fort Leonard Wood, MO",22780.0,2020-01-01,-11,0,-11
"Fort Leonard Wood, MO",22780.0,2020-02-01,14,0,14
"Fort Leonard Wood, MO",22780.0,2020-03-01,29,0,29
"Fort Leonard Wood, MO",22780.0,2020-04-01,-10,0,-10
"Fort Leonard Wood, MO",22780.0,2020-05-01,-21,0,-21
"Fort Leonard Wood, MO",22780.0,2020-06-01,-47,0,-47
"Fort Leonard Wood, MO",22780.0,2020-07-01,-26,0,-26
"Fort Leonard Wood, MO",22780.0,2020-08-01,-23,0,-23
"Fort Leonard Wood, MO",22780.0,2020-09-01,11,0,11
"Fort Leonard Wood, MO",22780.0,2020-10-01,-11,0,-11
"Fort Leonard Wood, MO",22780.0,2020-11-01,-25,0,-25
"Fort Leonard Wood, MO",22780.0,2020-12-01,-15,0,-15
"Palatka, FL",37260.0,2019-01-01,33,0,33
"Palatka, FL",37260.0,2019-02-01,-5,0,-5
"Palatka, FL",37260.0,2019-03-01,-17,0,-17
"Palatka, FL",37260.0,2019-04-01,50,0,50
"Palatka, FL",37260.0,2019-05-01,31,0,31
"Palatka, FL",37260.0,2019-06-01,-3,0,-3
"Palatka, FL",37260.0,2019-07-01,67,0,67
"Palatka, FL",37260.0,2019-08-01,2,0,2
"Palatka, FL",37260.0,2019-09-01,17,0,17
"Palatka, FL",37260.0,2019-10-01,33,0,33
"Palatka, FL",37260.0,2019-11-01,25,0,25
"Palatka, FL",37260.0,2019-12-01,21,0,21
"Palatka, FL",37260.0,2020-01-01,9,0,9
"Palatka, FL",37260.0,2020-02-01,0,0,0
"Palatka, FL",37260.0,2020-03-01,44,0,44
"Palatka, FL",37260.0,2020-04-01,18,0,18
"Palatka, FL",37260.0,2020-05-01,19,0,19
"Palatka, FL",37260.0,2020-06-01,1,0,1
"Palatka, FL",37260.0,2020-07-01,66,0,66
"Palatka, FL",37260.0,2020-08-01,3,0,3
"Palatka, FL",37260.0,2020-09-01,23,0,23
"Palatka, FL",37260.0,2020-10-01,3,0,3
"Palatka, FL",37260.0,2020-11-01,35,0,35
"Palatka, FL",37260.0,2020-12-01,49,0,49
"Racine, WI",39540.0,2019-01-01,-87,-139,52
"Racine, WI",39540.0,2019-02-01,36,0,36
"Racine, WI",39540.0,2019-03-01,59,0,59
"Racine, WI",39540.0,2019-04-01,143,64,79
"Racine, WI",39540.0,2019-05-01,273,155,118
"Racine, WI",39540.0,2019-06-01,58,0,58
"Racine, WI",39540.0,2019-07-01,94,0,94
"Racine, WI",39540.0,2019-08-01,87,0,87
"Racine, WI",39540.0,2019-09-01,41,-3,44
"Racine, WI",39540.0,2019-10-01,-58,-120,62
"Racine, WI",39540.0,2019-11-01,-58,-50,-8
"Racine, WI",39540.0,2019-12-01,-112,-117,5
"Racine, WI",39540.0,2020-01-01,-136,-131,-5
"Racine, WI",39540.0,2020-02-01,66,0,66
"Racine, WI",39540.0,2020-03-01,112,14,98
"Racine, WI",39540.0,2020-04-01,186,24,162
"Racine, WI",39540.0,2020-05-01,239,114,125
"Racine, WI",39540.0,2020-06-01,174,48,126
"Racine, WI",39540.0,2020-07-01,67,22,45
"Racine, WI",39540.0,2020-08-01,82,0,82
"Racine, WI",39540.0,2020-09-01,66,0,66
"Racine, WI",39540.0,2020-10-01,-22,-102,80
"Racine, WI",39540.0,2020-11-01,1,-52,53
"Racine, WI",39540.0,2020-12-01,-19,-108,89
"Moberly, MO",33620.0,2019-01-01,-7,0,-7
"Moberly, MO",33620.0,2019-02-01,0,0,0
"Moberly, MO",33620.0,2019-03-01,-9,0,-9
"Moberly, MO",33620.0,2019-04-01,-3,0,-3
"Moberly, MO",33620.0,2019-05-01,-9,0,-9
"Moberly, MO",33620.0,2019-06-01,6,0,6
"Moberly, MO",33620.0,2019-07-01,-21,0,-21
"Moberly, MO",33620.0,2019-08-01,-16,0,-16
"Moberly, MO",33620.0,2019-09-01,-27,0,-27
"Moberly, MO",33620.0,2019-10-01,-12,0,-12
"Moberly, MO",33620.0,2019-11-01,-18,0,-18
"Moberly, MO",33620.0,2019-12-01,-1,0,-1
"Moberly, MO",33620.0,2020-01-01,-5,0,-5
"Moberly, MO",33620.0,2020-02-01,7,0,7
"Moberly, MO",33620.0,2020-03-01,12,0,12
"Moberly, MO",33620.0,2020-04-01,5,0,5
"Moberly, MO",33620.0,2020-05-01,12,0,12
"Moberly, MO",33620.0,2020-06-01,4,0,4
"Moberly, MO",33620.0,2020-07-01,6,0,6
"Moberly, MO",33620.0,2020-08-01,-16,0,-16
"Moberly, MO",33620.0,2020-09-01,-15,0,-15
"Moberly, MO",33620.0,2020-10-01,0,0,0
"Moberly, MO",33620.0,2020-11-01,-10,0,-10
"Moberly, MO",33620.0,2020-12-01,9,0,9
"Elkins, WV",21180.0,2019-01-01,16,0,16
"Elkins, WV",21180.0,2019-02-01,0,0,0
"Elkins, WV",21180.0,2019-03-01,-16,0,-16
"Elkins, WV",21180.0,2019-04-01,0,0,0
"Elkins, WV",21180.0,2019-05-01,0,0,0
"Elkins, WV",21180.0,2019-06-01,0,0,0
"Elkins, WV",21180.0,2019-07-01,-11,0,-11
"Elkins, WV",21180.0,2019-08-01,7,0,7
"Elkins, WV",21180.0,2019-09-01,-2,0,-2
"Elkins, WV",21180.0,2019-10-01,-3,0,-3
"Elkins, WV",21180.0,2019-11-01,20,0,20
"Elkins, WV",21180.0,2019-12-01,12,0,12
"Elkins, WV",21180.0,2020-01-01,-12,0,-12
"Elkins, WV",21180.0,2020-02-01,0,0,0
"Elkins, WV",21180.0,2020-03-01,-17,0,-17
"Elkins, WV",21180.0,2020-04-01,0,0,0
"Elkins, WV",21180.0,2020-05-01,0,0,0
"Elkins, WV",21180.0,2020-06-01,11,0,11
"Elkins, WV",21180.0,2020-07-01,11,0,11
"Elkins, WV",21180.0,2020-08-01,-1,0,-1
"Elkins, WV",21180.0,2020-09-01,11,0,11
"Elkins, WV",21180.0,2020-10-01,0,0,0
"Elkins, WV",21180.0,2020-11-01,11,0,11
"Elkins, WV",21180.0,2020-12-01,0,0,0
"Pecos, TX",37780.0,2019-01-01,0,0,0
"Pecos, TX",37780.0,2019-02-01,0,0,0
"Pecos, TX",37780.0,2019-03-01,0,0,0
"Pecos, TX",37780.0,2019-04-01,0,0,0
"Pecos, TX",37780.0,2019-05-01,0,0,0
"Pecos, TX",37780.0,2019-06-01,0,0,0
"Pecos, TX",37780.0,2019-07-01,0,0,0
"Pecos, TX",37780.0,2019-08-01,0,0,0
"Pecos, TX",37780.0,2019-09-01,0,0,0
"Pecos, TX",37780.0,2019-10-01,0,0,0
"Pecos, TX",37780.0,2019-11-01,0,0,0
"Pecos, TX",37780.0,2019-12-01,0,0,0
"Pecos, TX",37780.0,2020-01-01,0,0,0
"Pecos, TX",37780.0,2020-02-01,0,0,0
"Pecos, TX",37780.0,2020-03-01,0,0,0
"Pecos, TX",37780.0,2020-04-01,0,0,0
"Pecos, TX",37780.0,2020-05-01,0,0,0
"Pecos, TX",37780.0,2020-06-01,0,0,0
"Pecos, TX",37780.0,2020-07-01,0,0,0
"Pecos, TX",37780.0,2020-08-01,0,0,0
"Pecos, TX",37780.0,2020-09-01,0,0,0
"Pecos, TX",37780.0,2020-10-01,0,0,0
"Pecos, TX",37780.0,2020-11-01,0,0,0
"Pecos, TX",37780.0,2020-12-01,0,0,0
"Hutchinson, KS",26740.0,2019-01-01,15,0,15
"Hutchinson, KS",26740.0,2019-02-01,5,0,5
"Hutchinson, KS",26740.0,2019-03-01,10,0,10
"Hutchinson, KS",26740.0,2019-04-01,25,0,25
"Hutchinson, KS",26740.0,2019-05-01,2,0,2
"Hutchinson, KS",26740.0,2019-06-01,-24,0,-24
"Hutchinson, KS",26740.0,2019-07-01,-26,0,-26
"Hutchinson, KS",26740.0,2019-08-01,-20,0,-20
"Hutchinson, KS",26740.0,2019-09-01,-8,0,-8
"Hutchinson, KS",26740.0,2019-10-01,17,0,17
"Hutchinson, KS",26740.0,2019-11-01,1,0,1
"Hutchinson, KS",26740.0,2019-12-01,-16,0,-16
"Hutchinson, KS",26740.0,2020-01-01,-19,0,-19
"Hutchinson, KS",26740.0,2020-02-01,22,0,22
"Hutchinson, KS",26740.0,2020-03-01,-54,0,-54
"Hutchinson, KS",26740.0,2020-04-01,-41,0,-41
"Hutchinson, KS",26740.0,2020-05-01,-9,0,-9
"Hutchinson, KS",26740.0,2020-06-01,13,0,13
"Hutchinson, KS",26740.0,2020-07-01,-30,0,-30
"Hutchinson, KS",26740.0,2020-08-01,-23,0,-23
"Hutchinson, KS",26740.0,2020-09-01,-16,0,-16
"Hutchinson, KS",26740.0,2020-10-01,6,0,6
"Hutchinson, KS",26740.0,2020-11-01,34,0,34
"Hutchinson, KS",26740.0,2020-12-01,-26,0,-26
"Dayton, TN",19420.0,2019-01-01,-3,0,-3
"Dayton, TN",19420.0,2019-02-01,-9,0,-9
"Dayton, TN",19420.0,2019-03-01,23,0,23
"Dayton, TN",19420.0,2019-04-01,4,0,4
"Dayton, TN",19420.0,2019-05-01,-12,0,-12
"Dayton, TN",19420.0,2019-06-01,-10,0,-10
"Dayton, TN",19420.0,2019-07-01,-5,0,-5
"Dayton, TN",19420.0,2019-08-01,20,0,20
"Dayton, TN",19420.0,2019-09-01,-1,0,-1
"Dayton, TN",19420.0,2019-10-01,-1,0,-1
"Dayton, TN",19420.0,2019-11-01,6,0,6
"Dayton, TN",19420.0,2019-12-01,2,0,2
"Dayton, TN",19420.0,2020-01-01,-5,0,-5
"Dayton, TN",19420.0,2020-02-01,-8,0,-8
"Dayton, TN",19420.0,2020-03-01,15,0,15
"Dayton, TN",19420.0,2020-04-01,22,0,22
"Dayton, TN",19420.0,2020-05-01,2,0,2
"Dayton, TN",19420.0,2020-06-01,13,0,13
"Dayton, TN",19420.0,2020-07-01,11,0,11
"Dayton, TN",19420.0,2020-08-01,18,0,18
"Dayton, TN",19420.0,2020-09-01,-3,0,-3
"Dayton, TN",19420.0,2020-10-01,6,0,6
"Dayton, TN",19420.0,2020-11-01,19,0,19
"Dayton, TN",19420.0,2020-12-01,5,0,5
"Faribault-Northfield, MN",22060.0,2019-01-01,-58,-31,-27
"Faribault-Northfield, MN",22060.0,2019-02-01,13,0,13
"Faribault-Northfield, MN",22060.0,2019-03-01,-26,0,-26
"Faribault-Northfield, MN",22060.0,2019-04-01,76,17,59
"Faribault-Northfield, MN",22060.0,2019-05-01,93,29,64
"Faribault-Northfield, MN",22060.0,2019-06-01,23,0,23
"Faribault-Northfield, MN",22060.0,2019-07-01,8,0,8
"Faribault-Northfield, MN",22060.0,2019-08-01,21,0,21
"Faribault-Northfield, MN",22060.0,2019-09-01,37,0,37
"Faribault-Northfield, MN",22060.0,2019-10-01,-18,-46,28
"Faribault-Northfield, MN",22060.0,2019-11-01,-51,-49,-2
"Faribault-Northfield, MN",22060.0,2019-12-01,-47,-74,27
"Faribault-Northfield, MN",22060.0,2020-01-01,-16,-37,21
"Faribault-Northfield, MN",22060.0,2020-02-01,-10,0,-10
"Faribault-Northfield, MN",22060.0,2020-03-01,42,0,42
"Faribault-Northfield, MN",22060.0,2020-04-01,16,12,4
"Faribault-Northfield, MN",22060.0,2020-05-01,78,0,78
"Faribault-Northfield, MN",22060.0,2020-06-01,-71,0,-71
"Faribault-Northfield, MN",22060.0,2020-07-01,25,0,25
"Faribault-Northfield, MN",22060.0,2020-08-01,37,0,37
"Faribault-Northfield, MN",22060.0,2020-09-01,30,0,30
"Faribault-Northfield, MN",22060.0,2020-10-01,-16,-28,12
"Faribault-Northfield, MN",22060.0,2020-11-01,-20,-18,-2
"Faribault-Northfield, MN",22060.0,2020-12-01,-38,-35,-3
"Wahpeton, ND-MN",47420.0,2019-01-01,-19,-21,2
"Wahpeton, ND-MN",47420.0,2019-02-01,-12,0,-12
"Wahpeton, ND-MN",47420.0,2019-03-01,19,0,19
"Wahpeton, ND-MN",47420.0,2019-04-01,-13,0,-13
"Wahpeton, ND-MN",47420.0,2019-05-01,-5,0,-5
"Wahpeton, ND-MN",47420.0,2019-06-01,16,0,16
"Wahpeton, ND-MN",47420.0,2019-07-01,-4,0,-4
"Wahpeton, ND-MN",47420.0,2019-08-01,1,0,1
"Wahpeton, ND-MN",47420.0,2019-09-01,13,0,13
"Wahpeton, ND-MN",47420.0,2019-10-01,19,0,19
"Wahpeton, ND-MN",47420.0,2019-11-01,-23,-11,-12
"Wahpeton, ND-MN",47420.0,2019-12-01,-31,-18,-13
"Wahpeton, ND-MN",47420.0,2020-01-01,11,-13,24
"Wahpeton, ND-MN",47420.0,2020-02-01,-19,0,-19
"Wahpeton, ND-MN",47420.0,2020-03-01,13,0,13
"Wahpeton, ND-MN",47420.0,2020-04-01,0,0,0
"Wahpeton, ND-MN",47420.0,2020-05-01,4,0,4
"Wahpeton, ND-MN",47420.0,2020-06-01,-13,0,-13
"Wahpeton, ND-MN",47420.0,2020-07-01,6,0,6
"Wahpeton, ND-MN",47420.0,2020-08-01,6,0,6
"Wahpeton, ND-MN",47420.0,2020-09-01,-3,0,-3
"Wahpeton, ND-MN",47420.0,2020-10-01,0,0,0
"Wahpeton, ND-MN",47420.0,2020-11-01,3,-13,16
"Wahpeton, ND-MN",47420.0,2020-12-01,-6,-13,7
"Mansfield, OH",31900.0,2019-01-01,-4,0,-4
"Mansfield, OH",31900.0,2019-02-01,32,0,32
"Mansfield, OH",31900.0,2019-03-01,39,0,39
"Mansfield, OH",31900.0,2019-04-01,18,0,18
"Mansfield, OH",31900.0,2019-05-01,19,0,19
"Mansfield, OH",31900.0,2019-06-01,4,0,4
"Mansfield, OH",31900.0,2019-07-01,26,0,26
"Mansfield, OH",31900.0,2019-08-01,32,0,32
"Mansfield, OH",31900.0,2019-09-01,-11,0,-11
"Mansfield, OH",31900.0,2019-10-01,22,-13,35
"Mansfield, OH",31900.0,2019-11-01,33,-11,44
"Mansfield, OH",31900.0,2019-12-01,-23,-31,8
"Mansfield, OH",31900.0,2020-01-01,41,0,41
"Mansfield, OH",31900.0,2020-02-01,63,0,63
"Mansfield, OH",31900.0,2020-03-01,39,0,39
"Mansfield, OH",31900.0,2020-04-01,33,0,33
"Mansfield, OH",31900.0,2020-05-01,24,0,24
"Mansfield, OH",31900.0,2020-06-01,-16,0,-16
"Mansfield, OH",31900.0,2020-07-01,35,0,35
"Mansfield, OH",31900.0,2020-08-01,-22,0,-22
"Mansfield, OH",31900.0,2020-09-01,7,0,7
"Mansfield, OH",31900.0,2020-10-01,64,-12,76
"Mansfield, OH",31900.0,2020-11-01,18,-12,30
"Mansfield, OH",31900.0,2020-12-01,-18,-20,2
"Rockingham, NC",40460.0,2019-01-01,-13,0,-13
"Rockingham, NC",40460.0,2019-02-01,0,0,0
"Rockingham, NC",40460.0,2019-03-01,-13,0,-13
"Rockingham, NC",40460.0,2019-04-01,13,0,13
"Rockingham, NC",40460.0,2019-05-01,-12,0,-12
"Rockingham, NC",40460.0,2019-06-01,11,0,11
"Rockingham, NC",40460.0,2019-07-01,11,0,11
"Rockingham, NC",40460.0,2019-08-01,-2,0,-2
"Rockingham, NC",40460.0,2019-09-01,-11,0,-11
"Rockingham, NC",40460.0,2019-10-01,-14,0,-14
"Rockingham, NC",40460.0,2019-11-01,-15,0,-15
"Rockingham, NC",40460.0,2019-12-01,-11,0,-11
"Rockingham, NC",40460.0,2020-01-01,3,0,3
"Rockingham, NC",40460.0,2020-02-01,-13,0,-13
"Rockingham, NC",40460.0,2020-03-01,-1,0,-1
"Rockingham, NC",40460.0,2020-04-01,-15,0,-15
"Rockingham, NC",40460.0,2020-05-01,-5,0,-5
"Rockingham, NC",40460.0,2020-06-01,0,0,0
"Rockingham, NC",40460.0,2020-07-01,25,0,25
"Rockingham, NC",40460.0,2020-08-01,-12,0,-12
"Rockingham, NC",40460.0,2020-09-01,0,0,0
"Rockingham, NC",40460.0,2020-10-01,-11,0,-11
"Rockingham, NC",40460.0,2020-11-01,12,0,12
"Rockingham, NC",40460.0,2020-12-01,-13,0,-13
"Española, NM",21580.0,2019-01-01,6,0,6
"Española, NM",21580.0,2019-02-01,-17,0,-17
"Española, NM",21580.0,2019-03-01,-15,0,-15
"Española, NM",21580.0,2019-04-01,8,0,8
"Española, NM",21580.0,2019-05-01,22,0,22
"Española, NM",21580.0,2019-06-01,15,0,15
"Española, NM",21580.0,2019-07-01,33,0,33
"Española, NM",21580.0,2019-08-01,-8,0,-8
"Española, NM",21580.0,2019-09-01,-15,0,-15
"Española, NM",21580.0,2019-10-01,26,11,15
"Española, NM",21580.0,2019-11-01,-1,0,-1
"Española, NM",21580.0,2019-12-01,-1,0,-1
"Española, NM",21580.0,2020-01-01,10,0,10
"Española, NM",21580.0,2020-02-01,3,0,3
"Española, NM",21580.0,2020-03-01,18,0,18
"Española, NM",21580.0,2020-04-01,20,0,20
"Española, NM",21580.0,2020-05-01,4,0,4
"Española, NM",21580.0,2020-06-01,27,0,27
"Española, NM",21580.0,2020-07-01,-5,0,-5
"Española, NM",21580.0,2020-08-01,36,0,36
"Española, NM",21580.0,2020-09-01,18,0,18
"Española, NM",21580.0,2020-10-01,12,0,12
"Española, NM",21580.0,2020-11-01,36,0,36
"Española, NM",21580.0,2020-12-01,-16,0,-16
"Riverside-San Bernardino-Ontario, CA",40140.0,2019-01-01,3528,2065,1463
"Riverside-San Bernardino-Ontario, CA",40140.0,2019-02-01,1386,308,1078
"Riverside-San Bernardino-Ontario, CA",40140.0,2019-03-01,1002,77,925
"Riverside-San Bernardino-Ontario, CA",40140.0,2019-04-01,-944,-1400,456
"Riverside-San Bernardino-Ontario, CA",40140.0,2019-05-01,-1457,-2456,999
"Riverside-San Bernardino-Ontario, CA",40140.0,2019-06-01,825,-1048,1873
"Riverside-San Bernardino-Ontario, CA",40140.0,2019-07-01,1650,-237,1887
"Riverside-San Bernardino-Ontario, CA",40140.0,2019-08-01,1522,-45,1567
"Riverside-San Bernardino-Ontario, CA",40140.0,2019-09-01,1691,178,1513
"Riverside-San Bernardino-Ontario, CA",40140.0,2019-10-01,5097,3229,1868
"Riverside-San Bernardino-Ontario, CA",40140.0,2019-11-01,3525,2019,1506
"Riverside-San Bernardino-Ontario, CA",40140.0,2019-12-01,3277,1873,1404
"Riverside-San Bernardino-Ontario, CA",40140.0,2020-01-01,3328,1941,1387
"Riverside-San Bernardino-Ontario, CA",40140.0,2020-02-01,1533,338,1195
"Riverside-San Bernardino-Ontario, CA",40140.0,2020-03-01,1821,493,1328
"Riverside-San Bernardino-Ontario, CA",40140.0,2020-04-01,2692,481,2211
"Riverside-San Bernardino-Ontario, CA",40140.0,2020-05-01,851,-1318,2169
"Riverside-San Bernardino-Ontario, CA",40140.0,2020-06-01,1450,-841,2291
"Riverside-San Bernardino-Ontario, CA",40140.0,2020-07-01,2640,-138,2778
"Riverside-San Bernardino-Ontario, CA",40140.0,2020-08-01,2467,49,2418
"Riverside-San Bernardino-Ontario, CA",40140.0,2020-09-01,2706,388,2318
"Riverside-San Bernardino-Ontario, CA",40140.0,2020-10-01,5262,3110,2152
"Riverside-San Bernardino-Ontario, CA",40140.0,2020-11-01,4906,2601,2305
"Riverside-San Bernardino-Ontario, CA",40140.0,2020-12-01,3895,1779,2116
"Lumberton, NC",31300.0,2019-01-01,-34,0,-34
"Lumberton, NC",31300.0,2019-02-01,-8,0,-8
"Lumberton, NC",31300.0,2019-03-01,3,0,3
"Lumberton, NC",31300.0,2019-04-01,17,0,17
"Lumberton, NC",31300.0,2019-05-01,-44,0,-44
"Lumberton, NC",31300.0,2019-06-01,-29,0,-29
"Lumberton, NC",31300.0,2019-07-01,14,0,14
"Lumberton, NC",31300.0,2019-08-01,-14,0,-14
"Lumberton, NC",31300.0,2019-09-01,17,0,17
"Lumberton, NC",31300.0,2019-10-01,2,0,2
"Lumberton, NC",31300.0,2019-11-01,-5,0,-5
"Lumberton, NC",31300.0,2019-12-01,11,0,11
"Lumberton, NC",31300.0,2020-01-01,-54,0,-54
"Lumberton, NC",31300.0,2020-02-01,-2,0,-2
"Lumberton, NC",31300.0,2020-03-01,29,12,17
"Lumberton, NC",31300.0,2020-04-01,60,0,60
"Lumberton, NC",31300.0,2020-05-01,2,0,2
"Lumberton, NC",31300.0,2020-06-01,-27,0,-27
"Lumberton, NC",31300.0,2020-07-01,-4,0,-4
"Lumberton, NC",31300.0,2020-08-01,7,0,7
"Lumberton, NC",31300.0,2020-09-01,-3,0,-3
"Lumberton, NC",31300.0,2020-10-01,13,0,13
"Lumberton, NC",31300.0,2020-11-01,38,0,38
"Lumberton, NC",31300.0,2020-12-01,-28,0,-28
"Janesville-Beloit, WI",27500.0,2019-01-01,-75,-61,-14
"Janesville-Beloit, WI",27500.0,2019-02-01,12,0,12
"Janesville-Beloit, WI",27500.0,2019-03-01,24,0,24
"Janesville-Beloit, WI",27500.0,2019-04-01,162,55,107
"Janesville-Beloit, WI",27500.0,2019-05-01,106,42,64
"Janesville-Beloit, WI",27500.0,2019-06-01,118,0,118
"Janesville-Beloit, WI",27500.0,2019-07-01,109,0,109
"Janesville-Beloit, WI",27500.0,2019-08-01,42,0,42
"Janesville-Beloit, WI",27500.0,2019-09-01,44,0,44
"Janesville-Beloit, WI",27500.0,2019-10-01,-49,-60,11
"Janesville-Beloit, WI",27500.0,2019-11-01,-21,-27,6
"Janesville-Beloit, WI",27500.0,2019-12-01,-64,-102,38
"Janesville-Beloit, WI",27500.0,2020-01-01,-25,-50,25
"Janesville-Beloit, WI",27500.0,2020-02-01,35,0,35
"Janesville-Beloit, WI",27500.0,2020-03-01,63,0,63
"Janesville-Beloit, WI",27500.0,2020-04-01,107,16,91
"Janesville-Beloit, WI",27500.0,2020-05-01,198,46,152
"Janesville-Beloit, WI",27500.0,2020-06-01,78,0,78
"Janesville-Beloit, WI",27500.0,2020-07-01,88,0,88
"Janesville-Beloit, WI",27500.0,2020-08-01,48,0,48
"Janesville-Beloit, WI",27500.0,2020-09-01,81,0,81
"Janesville-Beloit, WI",27500.0,2020-10-01,-8,-57,49
"Janesville-Beloit, WI",27500.0,2020-11-01,-9,-49,40
"Janesville-Beloit, WI",27500.0,2020-12-01,-8,-55,47
"Portales, NM",38780.0,2019-01-01,-20,0,-20
"Portales, NM",38780.0,2019-02-01,-17,0,-17
"Portales, NM",38780.0,2019-03-01,-9,0,-9
"Portales, NM",38780.0,2019-04-01,-3,0,-3
"Portales, NM",38780.0,2019-05-01,-27,0,-27
"Portales, NM",38780.0,2019-06-01,1,0,1
"Portales, NM",38780.0,2019-07-01,-21,0,-21
"Portales, NM",38780.0,2019-08-01,4,0,4
"Portales, NM",38780.0,2019-09-01,20,0,20
"Portales, NM",38780.0,2019-10-01,-4,0,-4
"Portales, NM",38780.0,2019-11-01,-16,0,-16
"Portales, NM",38780.0,2019-12-01,-20,0,-20
"Portales, NM",38780.0,2020-01-01,-10,0,-10
"Portales, NM",38780.0,2020-02-01,-13,0,-13
"Portales, NM",38780.0,2020-03-01,-8,0,-8
"Portales, NM",38780.0,2020-04-01,28,0,28
"Portales, NM",38780.0,2020-05-01,-15,0,-15
"Portales, NM",38780.0,2020-06-01,-5,0,-5
"Portales, NM",38780.0,2020-07-01,-27,0,-27
"Portales, NM",38780.0,2020-08-01,1,0,1
"Portales, NM",38780.0,2020-09-01,-15,0,-15
"Portales, NM",38780.0,2020-10-01,-18,0,-18
"Portales, NM",38780.0,2020-11-01,-22,0,-22
"Portales, NM",38780.0,2020-12-01,0,0,0
"Chillicothe, OH",17060.0,2019-01-01,6,0,6
"Chillicothe, OH",17060.0,2019-02-01,9,0,9
"Chillicothe, OH",17060.0,2019-03-01,-16,0,-16
"Chillicothe, OH",17060.0,2019-04-01,5,0,5
"Chillicothe, OH",17060.0,2019-05-01,27,0,27
"Chillicothe, OH",17060.0,2019-06-01,4,0,4
"Chillicothe, OH",17060.0,2019-07-01,-2,0,-2
"Chillicothe, OH",17060.0,2019-08-01,34,0,34
"Chillicothe, OH",17060.0,2019-09-01,28,0,28
"Chillicothe, OH",17060.0,2019-10-01,9,0,9
"Chillicothe, OH",17060.0,2019-11-01,-1,0,-1
"Chillicothe, OH",17060.0,2019-12-01,9,0,9
"Chillicothe, OH",17060.0,2020-01-01,-22,0,-22
"Chillicothe, OH",17060.0,2020-02-01,-54,0,-54
"Chillicothe, OH",17060.0,2020-03-01,30,0,30
"Chillicothe, OH",17060.0,2020-04-01,16,0,16
"Chillicothe, OH",17060.0,2020-05-01,20,0,20
"Chillicothe, OH",17060.0,2020-06-01,-30,0,-30
"Chillicothe, OH",17060.0,2020-07-01,26,0,26
"Chillicothe, OH",17060.0,2020-08-01,-21,0,-21
"Chillicothe, OH",17060.0,2020-09-01,12,0,12
"Chillicothe, OH",17060.0,2020-10-01,40,0,40
"Chillicothe, OH",17060.0,2020-11-01,24,0,24
"Chillicothe, OH",17060.0,2020-12-01,15,0,15
"Steamboat Springs, CO",44460.0,2019-01-01,0,0,0
"Steamboat Springs, CO",44460.0,2019-02-01,0,0,0
"Steamboat Springs, CO",44460.0,2019-03-01,-15,0,-15
"Steamboat Springs, CO",44460.0,2019-04-01,0,0,0
"Steamboat Springs, CO",44460.0,2019-05-01,30,44,-14
"Steamboat Springs, CO",44460.0,2019-06-01,52,25,27
"Steamboat Springs, CO",44460.0,2019-07-01,12,0,12
"Steamboat Springs, CO",44460.0,2019-08-01,20,0,20
"Steamboat Springs, CO",44460.0,2019-09-01,1,0,1
"Steamboat Springs, CO",44460.0,2019-10-01,-14,-14,0
"Steamboat Springs, CO",44460.0,2019-11-01,0,0,0
"Steamboat Springs, CO",44460.0,2019-12-01,0,0,0
"Steamboat Springs, CO",44460.0,2020-01-01,0,0,0
"Steamboat Springs, CO",44460.0,2020-02-01,-12,-12,0
"Steamboat Springs, CO",44460.0,2020-03-01,0,0,0
"Steamboat Springs, CO",44460.0,2020-04-01,11,0,11
"Steamboat Springs, CO",44460.0,2020-05-01,64,39,25
"Steamboat Springs, CO",44460.0,2020-06-01,66,19,47
"Steamboat Springs, CO",44460.0,2020-07-01,23,0,23
"Steamboat Springs, CO",44460.0,2020-08-01,25,0,25
"Steamboat Springs, CO",44460.0,2020-09-01,18,0,18
"Steamboat Springs, CO",44460.0,2020-10-01,-25,-47,22
"Steamboat Springs, CO",44460.0,2020-11-01,9,0,9
"Steamboat Springs, CO",44460.0,2020-12-01,14,0,14
"Forest City, NC",22580.0,2019-01-01,-29,0,-29
"Forest City, NC",22580.0,2019-02-01,2,0,2
"Forest City, NC",22580.0,2019-03-01,21,0,21
"Forest City, NC",22580.0,2019-04-01,-12,0,-12
"Forest City, NC",22580.0,2019-05-01,15,0,15
"Forest City, NC",22580.0,2019-06-01,-5,0,-5
"Forest City, NC",22580.0,2019-07-01,17,0,17
"Forest City, NC",22580.0,2019-08-01,14,0,14
"Forest City, NC",22580.0,2019-09-01,15,0,15
"Forest City, NC",22580.0,2019-10-01,11,0,11
"Forest City, NC",22580.0,2019-11-01,-12,0,-12
"Forest City, NC",22580.0,2019-12-01,18,0,18
"Forest City, NC",22580.0,2020-01-01,7,0,7
"Forest City, NC",22580.0,2020-02-01,-20,0,-20
"Forest City, NC",22580.0,2020-03-01,17,0,17
"Forest City, NC",22580.0,2020-04-01,-29,0,-29
"Forest City, NC",22580.0,2020-05-01,36,0,36
"Forest City, NC",22580.0,2020-06-01,-9,0,-9
"Forest City, NC",22580.0,2020-07-01,10,0,10
"Forest City, NC",22580.0,2020-08-01,28,0,28
"Forest City, NC",22580.0,2020-09-01,17,0,17
"Forest City, NC",22580.0,2020-10-01,0,0,0
"Forest City, NC",22580.0,2020-11-01,-31,0,-31
"Forest City, NC",22580.0,2020-12-01,-10,0,-10
"Rutland, VT",40860.0,2019-01-01,-37,0,-37
"Rutland, VT",40860.0,2019-02-01,-11,0,-11
"Rutland, VT",40860.0,2019-03-01,10,0,10
"Rutland, VT",40860.0,2019-04-01,-6,11,-17
"Rutland, VT",40860.0,2019-05-01,72,97,-25
"Rutland, VT",40860.0,2019-06-01,12,29,-17
"Rutland, VT",40860.0,2019-07-01,-13,0,-13
"Rutland, VT",40860.0,2019-08-01,34,0,34
"Rutland, VT",40860.0,2019-09-01,10,0,10
"Rutland, VT",40860.0,2019-10-01,-35,-74,39
"Rutland, VT",40860.0,2019-11-01,6,0,6
"Rutland, VT",40860.0,2019-12-01,1,0,1
"Rutland, VT",40860.0,2020-01-01,21,0,21
"Rutland, VT",40860.0,2020-02-01,-28,0,-28
"Rutland, VT",40860.0,2020-03-01,28,42,-14
"Rutland, VT",40860.0,2020-04-01,50,47,3
"Rutland, VT",40860.0,2020-05-01,66,50,16
"Rutland, VT",40860.0,2020-06-01,59,40,19
"Rutland, VT",40860.0,2020-07-01,-5,0,-5
"Rutland, VT",40860.0,2020-08-01,-53,0,-53
"Rutland, VT",40860.0,2020-09-01,-11,0,-11
"Rutland, VT",40860.0,2020-10-01,-33,-48,15
"Rutland, VT",40860.0,2020-11-01,-8,0,-8
"Rutland, VT",40860.0,2020-12-01,17,0,17
"San Germán, PR",41900.0,2019-01-01,0,0,0
"San Germán, PR",41900.0,2019-02-01,0,0,0
"San Germán, PR",41900.0,2019-03-01,0,0,0
"San Germán, PR",41900.0,2019-04-01,0,0,0
"San Germán, PR",41900.0,2019-05-01,-11,0,-11
"San Germán, PR",41900.0,2019-06-01,0,0,0
"San Germán, PR",41900.0,2019-07-01,0,0,0
"San Germán, PR",41900.0,2019-08-01,0,0,0
"San Germán, PR",41900.0,2019-10-01,0,0,0
"San Germán, PR",41900.0,2019-11-01,0,0,0
"San Germán, PR",41900.0,2019-12-01,0,0,0
"San Germán, PR",41900.0,2020-01-01,0,0,0
"San Germán, PR",41900.0,2020-02-01,0,0,0
"San Germán, PR",41900.0,2020-03-01,0,0,0
"San Germán, PR",41900.0,2020-05-01,0,0,0
"San Germán, PR",41900.0,2020-08-01,0,0,0
"San Germán, PR",41900.0,2020-09-01,0,0,0
"San Germán, PR",41900.0,2020-12-01,0,0,0
"Saginaw, MI",40980.0,2019-01-01,-91,-120,29
"Saginaw, MI",40980.0,2019-02-01,19,0,19
"Saginaw, MI",40980.0,2019-03-01,-23,0,-23
"Saginaw, MI",40980.0,2019-04-01,66,44,22
"Saginaw, MI",40980.0,2019-05-01,30,32,-2
"Saginaw, MI",40980.0,2019-06-01,-44,-18,-26
"Saginaw, MI",40980.0,2019-07-01,19,0,19
"Saginaw, MI",40980.0,2019-08-01,-32,0,-32
"Saginaw, MI",40980.0,2019-09-01,72,0,72
"Saginaw, MI",40980.0,2019-10-01,-97,-104,7
"Saginaw, MI",40980.0,2019-11-01,-88,-105,17
"Saginaw, MI",40980.0,2019-12-01,-146,-188,42
"Saginaw, MI",40980.0,2020-01-01,-99,-118,19
"Saginaw, MI",40980.0,2020-02-01,19,0,19
"Saginaw, MI",40980.0,2020-03-01,68,12,56
"Saginaw, MI",40980.0,2020-04-01,3,0,3
"Saginaw, MI",40980.0,2020-05-01,-54,28,-82
"Saginaw, MI",40980.0,2020-06-01,44,-11,55
"Saginaw, MI",40980.0,2020-07-01,12,0,12
"Saginaw, MI",40980.0,2020-08-01,114,0,114
"Saginaw, MI",40980.0,2020-09-01,-8,0,-8
"Saginaw, MI",40980.0,2020-10-01,-113,-78,-35
"Saginaw, MI",40980.0,2020-11-01,-49,-120,71
"Saginaw, MI",40980.0,2020-12-01,-147,-153,6
"Forrest City, AR",22620.0,2019-01-01,-11,0,-11
"Forrest City, AR",22620.0,2019-02-01,-12,0,-12
"Forrest City, AR",22620.0,2019-03-01,0,0,0
"Forrest City, AR",22620.0,2019-04-01,-27,0,-27
"Forrest City, AR",22620.0,2019-05-01,0,0,0
"Forrest City, AR",22620.0,2019-06-01,0,0,0
"Forrest City, AR",22620.0,2019-07-01,11,0,11
"Forrest City, AR",22620.0,2019-08-01,-32,0,-32
"Forrest City, AR",22620.0,2019-09-01,11,0,11
"Forrest City, AR",22620.0,2019-10-01,-2,0,-2
"Forrest City, AR",22620.0,2019-11-01,0,0,0
"Forrest City, AR",22620.0,2019-12-01,0,0,0
"Forrest City, AR",22620.0,2020-01-01,12,0,12
"Forrest City, AR",22620.0,2020-02-01,0,0,0
"Forrest City, AR",22620.0,2020-03-01,-36,0,-36
"Forrest City, AR",22620.0,2020-04-01,17,0,17
"Forrest City, AR",22620.0,2020-05-01,31,0,31
"Forrest City, AR",22620.0,2020-06-01,-14,0,-14
"Forrest City, AR",22620.0,2020-07-01,16,0,16
"Forrest City, AR",22620.0,2020-08-01,-11,0,-11
"Forrest City, AR",22620.0,2020-09-01,-12,0,-12
"Forrest City, AR",22620.0,2020-10-01,0,0,0
"Forrest City, AR",22620.0,2020-11-01,0,0,0
"Forrest City, AR",22620.0,2020-12-01,0,0,0
"Farmington, MO",22100.0,2019-01-01,11,0,11
"Farmington, MO",22100.0,2019-02-01,24,0,24
"Farmington, MO",22100.0,2019-03-01,3,0,3
"Farmington, MO",22100.0,2019-04-01,32,0,32
"Farmington, MO",22100.0,2019-05-01,29,0,29
"Farmington, MO",22100.0,2019-06-01,25,0,25
"Farmington, MO",22100.0,2019-07-01,38,0,38
"Farmington, MO",22100.0,2019-08-01,14,0,14
"Farmington, MO",22100.0,2019-09-01,-13,0,-13
"Farmington, MO",22100.0,2019-10-01,25,0,25
"Farmington, MO",22100.0,2019-11-01,12,0,12
"Farmington, MO",22100.0,2019-12-01,47,0,47
"Farmington, MO",22100.0,2020-01-01,3,0,3
"Farmington, MO",22100.0,2020-02-01,-12,0,-12
"Farmington, MO",22100.0,2020-03-01,41,0,41
"Farmington, MO",22100.0,2020-04-01,39,0,39
"Farmington, MO",22100.0,2020-05-01,-7,0,-7
"Farmington, MO",22100.0,2020-06-01,27,0,27
"Farmington, MO",22100.0,2020-07-01,22,0,22
"Farmington, MO",22100.0,2020-08-01,37,0,37
"Farmington, MO",22100.0,2020-09-01,16,0,16
"Farmington, MO",22100.0,2020-10-01,44,0,44
"Farmington, MO",22100.0,2020-11-01,40,0,40
"Farmington, MO",22100.0,2020-12-01,36,0,36
"Sturgis, MI",44780.0,2019-01-01,-24,0,-24
"Sturgis, MI",44780.0,2019-02-01,25,0,25
"Sturgis, MI",44780.0,2019-03-01,7,0,7
"Sturgis, MI",44780.0,2019-04-01,36,11,25
"Sturgis, MI",44780.0,2019-05-01,-7,14,-21
"Sturgis, MI",44780.0,2019-06-01,8,0,8
"Sturgis, MI",44780.0,2019-07-01,12,0,12
"Sturgis, MI",44780.0,2019-08-01,-23,0,-23
"Sturgis, MI",44780.0,2019-09-01,-9,0,-9
"Sturgis, MI",44780.0,2019-10-01,-58,-33,-25
"Sturgis, MI",44780.0,2019-11-01,-61,-36,-25
"Sturgis, MI",44780.0,2019-12-01,-51,-53,2
"Sturgis, MI",44780.0,2020-01-01,8,0,8
"Sturgis, MI",44780.0,2020-02-01,0,0,0
"Sturgis, MI",44780.0,2020-03-01,56,0,56
"Sturgis, MI",44780.0,2020-04-01,18,0,18
"Sturgis, MI",44780.0,2020-05-01,8,0,8
"Sturgis, MI",44780.0,2020-06-01,-3,0,-3
"Sturgis, MI",44780.0,2020-07-01,18,0,18
"Sturgis, MI",44780.0,2020-08-01,8,0,8
"Sturgis, MI",44780.0,2020-09-01,-17,0,-17
"Sturgis, MI",44780.0,2020-10-01,-11,-42,31
"Sturgis, MI",44780.0,2020-11-01,-14,-40,26
"Sturgis, MI",44780.0,2020-12-01,24,-18,42
"Opelousas, LA",36660.0,2019-01-01,9,0,9
"Opelousas, LA",36660.0,2019-02-01,17,0,17
"Opelousas, LA",36660.0,2019-03-01,-25,0,-25
"Opelousas, LA",36660.0,2019-04-01,9,0,9
"Opelousas, LA",36660.0,2019-05-01,-15,0,-15
"Opelousas, LA",36660.0,2019-06-01,50,0,50
"Opelousas, LA",36660.0,2019-07-01,40,0,40
"Opelousas, LA",36660.0,2019-08-01,-18,0,-18
"Opelousas, LA",36660.0,2019-09-01,7,0,7
"Opelousas, LA",36660.0,2019-10-01,-11,0,-11
"Opelousas, LA",36660.0,2019-11-01,21,0,21
"Opelousas, LA",36660.0,2019-12-01,20,0,20
"Opelousas, LA",36660.0,2020-01-01,-47,0,-47
"Opelousas, LA",36660.0,2020-02-01,-6,0,-6
"Opelousas, LA",36660.0,2020-03-01,-33,0,-33
"Opelousas, LA",36660.0,2020-04-01,25,0,25
"Opelousas, LA",36660.0,2020-05-01,32,0,32
"Opelousas, LA",36660.0,2020-06-01,20,0,20
"Opelousas, LA",36660.0,2020-07-01,8,0,8
"Opelousas, LA",36660.0,2020-08-01,31,11,20
"Opelousas, LA",36660.0,2020-09-01,83,27,56
"Opelousas, LA",36660.0,2020-10-01,4,0,4
"Opelousas, LA",36660.0,2020-11-01,-22,0,-22
"Opelousas, LA",36660.0,2020-12-01,40,0,40
"Ogdensburg-Massena, NY",36300.0,2019-01-01,-62,-42,-20
"Ogdensburg-Massena, NY",36300.0,2019-02-01,-6,-11,5
"Ogdensburg-Massena, NY",36300.0,2019-03-01,-4,0,-4
"Ogdensburg-Massena, NY",36300.0,2019-04-01,163,125,38
"Ogdensburg-Massena, NY",36300.0,2019-05-01,222,214,8
"Ogdensburg-Massena, NY",36300.0,2019-06-01,12,30,-18
"Ogdensburg-Massena, NY",36300.0,2019-07-01,-24,0,-24
"Ogdensburg-Massena, NY",36300.0,2019-08-01,-8,0,-8
"Ogdensburg-Massena, NY",36300.0,2019-09-01,0,0,0
"Ogdensburg-Massena, NY",36300.0,2019-10-01,-237,-226,-11
"Ogdensburg-Massena, NY",36300.0,2019-11-01,-155,-155,0
"Ogdensburg-Massena, NY",36300.0,2019-12-01,-178,-185,7
"Ogdensburg-Massena, NY",36300.0,2020-01-01,-77,-50,-27
"Ogdensburg-Massena, NY",36300.0,2020-02-01,5,0,5
"Ogdensburg-Massena, NY",36300.0,2020-03-01,-5,0,-5
"Ogdensburg-Massena, NY",36300.0,2020-04-01,47,31,16
"Ogdensburg-Massena, NY",36300.0,2020-05-01,110,111,-1
"Ogdensburg-Massena, NY",36300.0,2020-06-01,60,57,3
"Ogdensburg-Massena, NY",36300.0,2020-07-01,-20,11,-31
"Ogdensburg-Massena, NY",36300.0,2020-08-01,3,0,3
"Ogdensburg-Massena, NY",36300.0,2020-09-01,-1,0,-1
"Ogdensburg-Massena, NY",36300.0,2020-10-01,-173,-154,-19
"Ogdensburg-Massena, NY",36300.0,2020-11-01,-130,-132,2
"Ogdensburg-Massena, NY",36300.0,2020-12-01,-52,-48,-4
"Morgan City, LA",34020.0,2019-01-01,-23,0,-23
"Morgan City, LA",34020.0,2019-02-01,-2,0,-2
"Morgan City, LA",34020.0,2019-03-01,-40,0,-40
"Morgan City, LA",34020.0,2019-04-01,0,0,0
"Morgan City, LA",34020.0,2019-05-01,-11,0,-11
"Morgan City, LA",34020.0,2019-06-01,-13,0,-13
"Morgan City, LA",34020.0,2019-07-01,14,0,14
"Morgan City, LA",34020.0,2019-08-01,-12,0,-12
"Morgan City, LA",34020.0,2019-09-01,-27,0,-27
"Morgan City, LA",34020.0,2019-10-01,0,0,0
"Morgan City, LA",34020.0,2019-11-01,-4,0,-4
"Morgan City, LA",34020.0,2019-12-01,26,0,26
"Morgan City, LA",34020.0,2020-01-01,4,0,4
"Morgan City, LA",34020.0,2020-02-01,-23,0,-23
"Morgan City, LA",34020.0,2020-03-01,24,14,10
"Morgan City, LA",34020.0,2020-04-01,27,0,27
"Morgan City, LA",34020.0,2020-05-01,-28,0,-28
"Morgan City, LA",34020.0,2020-06-01,-25,0,-25
"Morgan City, LA",34020.0,2020-07-01,-1,0,-1
"Morgan City, LA",34020.0,2020-08-01,-23,0,-23
"Morgan City, LA",34020.0,2020-09-01,-13,0,-13
"Morgan City, LA",34020.0,2020-10-01,-11,0,-11
"Morgan City, LA",34020.0,2020-11-01,-24,0,-24
"Morgan City, LA",34020.0,2020-12-01,-21,0,-21
"California-Lexington Park, MD",15680.0,2019-01-01,16,0,16
"California-Lexington Park, MD",15680.0,2019-02-01,28,0,28
"California-Lexington Park, MD",15680.0,2019-03-01,11,0,11
"California-Lexington Park, MD",15680.0,2019-04-01,9,0,9
"California-Lexington Park, MD",15680.0,2019-05-01,44,0,44
"California-Lexington Park, MD",15680.0,2019-06-01,59,0,59
"California-Lexington Park, MD",15680.0,2019-07-01,77,0,77
"California-Lexington Park, MD",15680.0,2019-08-01,40,0,40
"California-Lexington Park, MD",15680.0,2019-09-01,29,0,29
"California-Lexington Park, MD",15680.0,2019-10-01,60,0,60
"California-Lexington Park, MD",15680.0,2019-11-01,24,0,24
"California-Lexington Park, MD",15680.0,2019-12-01,13,0,13
"California-Lexington Park, MD",15680.0,2020-01-01,23,0,23
"California-Lexington Park, MD",15680.0,2020-02-01,53,0,53
"California-Lexington Park, MD",15680.0,2020-03-01,-19,0,-19
"California-Lexington Park, MD",15680.0,2020-04-01,14,0,14
"California-Lexington Park, MD",15680.0,2020-05-01,14,0,14
"California-Lexington Park, MD",15680.0,2020-06-01,4,0,4
"California-Lexington Park, MD",15680.0,2020-07-01,18,0,18
"California-Lexington Park, MD",15680.0,2020-08-01,38,0,38
"California-Lexington Park, MD",15680.0,2020-09-01,75,0,75
"California-Lexington Park, MD",15680.0,2020-10-01,33,0,33
"California-Lexington Park, MD",15680.0,2020-11-01,87,0,87
"California-Lexington Park, MD",15680.0,2020-12-01,85,0,85
"Marshall, MO",32180.0,2019-01-01,0,0,0
"Marshall, MO",32180.0,2019-02-01,11,0,11
"Marshall, MO",32180.0,2019-03-01,0,0,0
"Marshall, MO",32180.0,2019-04-01,-11,0,-11
"Marshall, MO",32180.0,2019-05-01,0,0,0
"Marshall, MO",32180.0,2019-06-01,11,0,11
"Marshall, MO",32180.0,2019-07-01,0,0,0
"Marshall, MO",32180.0,2019-08-01,-15,0,-15
"Marshall, MO",32180.0,2019-09-01,11,0,11
"Marshall, MO",32180.0,2019-10-01,0,0,0
"Marshall, MO",32180.0,2019-11-01,0,0,0
"Marshall, MO",32180.0,2019-12-01,-11,0,-11
"Marshall, MO",32180.0,2020-01-01,0,0,0
"Marshall, MO",32180.0,2020-02-01,0,0,0
"Marshall, MO",32180.0,2020-03-01,0,0,0
"Marshall, MO",32180.0,2020-04-01,2,0,2
"Marshall, MO",32180.0,2020-05-01,0,0,0
"Marshall, MO",32180.0,2020-06-01,0,0,0
"Marshall, MO",32180.0,2020-07-01,14,0,14
"Marshall, MO",32180.0,2020-08-01,0,0,0
"Marshall, MO",32180.0,2020-09-01,11,0,11
"Marshall, MO",32180.0,2020-10-01,0,0,0
"Marshall, MO",32180.0,2020-11-01,-14,0,-14
"Marshall, MO",32180.0,2020-12-01,-12,0,-12
"Salt Lake City, UT",41620.0,2019-01-01,-222,-165,-57
"Salt Lake City, UT",41620.0,2019-02-01,-242,2,-244
"Salt Lake City, UT",41620.0,2019-03-01,-200,-11,-189
"Salt Lake City, UT",41620.0,2019-04-01,9,145,-136
"Salt Lake City, UT",41620.0,2019-05-01,206,224,-18
"Salt Lake City, UT",41620.0,2019-06-01,-146,75,-221
"Salt Lake City, UT",41620.0,2019-07-01,-375,44,-419
"Salt Lake City, UT",41620.0,2019-08-01,-431,-14,-417
"Salt Lake City, UT",41620.0,2019-09-01,-355,-11,-344
"Salt Lake City, UT",41620.0,2019-10-01,-459,-192,-267
"Salt Lake City, UT",41620.0,2019-11-01,-251,-151,-100
"Salt Lake City, UT",41620.0,2019-12-01,-27,-114,87
"Salt Lake City, UT",41620.0,2020-01-01,-188,-138,-50
"Salt Lake City, UT",41620.0,2020-02-01,-245,-3,-242
"Salt Lake City, UT",41620.0,2020-03-01,80,-18,98
"Salt Lake City, UT",41620.0,2020-04-01,-117,63,-180
"Salt Lake City, UT",41620.0,2020-05-01,-77,179,-256
"Salt Lake City, UT",41620.0,2020-06-01,-226,127,-353
"Salt Lake City, UT",41620.0,2020-07-01,-171,31,-202
"Salt Lake City, UT",41620.0,2020-08-01,-304,-37,-267
"Salt Lake City, UT",41620.0,2020-09-01,-212,2,-214
"Salt Lake City, UT",41620.0,2020-10-01,-460,-178,-282
"Salt Lake City, UT",41620.0,2020-11-01,-160,-175,15
"Salt Lake City, UT",41620.0,2020-12-01,-18,-170,152
"San Jose-Sunnyvale-Santa Clara, CA",41940.0,2019-01-01,-943,41,-984
"San Jose-Sunnyvale-Santa Clara, CA",41940.0,2019-02-01,-818,16,-834
"San Jose-Sunnyvale-Santa Clara, CA",41940.0,2019-03-01,-1152,24,-1176
"San Jose-Sunnyvale-Santa Clara, CA",41940.0,2019-04-01,-1492,-7,-1485
"San Jose-Sunnyvale-Santa Clara, CA",41940.0,2019-05-01,-754,122,-876
"San Jose-Sunnyvale-Santa Clara, CA",41940.0,2019-06-01,-1881,204,-2085
"San Jose-Sunnyvale-Santa Clara, CA",41940.0,2019-07-01,-1661,125,-1786
"San Jose-Sunnyvale-Santa Clara, CA",41940.0,2019-08-01,-1749,67,-1816
"San Jose-Sunnyvale-Santa Clara, CA",41940.0,2019-09-01,-1363,-18,-1345
"San Jose-Sunnyvale-Santa Clara, CA",41940.0,2019-10-01,-1137,20,-1157
"San Jose-Sunnyvale-Santa Clara, CA",41940.0,2019-11-01,-1194,-25,-1169
"San Jose-Sunnyvale-Santa Clara, CA",41940.0,2019-12-01,-923,-5,-918
"San Jose-Sunnyvale-Santa Clara, CA",41940.0,2020-01-01,-769,45,-814
"San Jose-Sunnyvale-Santa Clara, CA",41940.0,2020-02-01,-784,33,-817
"San Jose-Sunnyvale-Santa Clara, CA",41940.0,2020-03-01,-1827,-203,-1624
"San Jose-Sunnyvale-Santa Clara, CA",41940.0,2020-04-01,-1925,-196,-1729
"San Jose-Sunnyvale-Santa Clara, CA",41940.0,2020-05-01,-1625,55,-1680
"San Jose-Sunnyvale-Santa Clara, CA",41940.0,2020-06-01,-2436,-21,-2415
"San Jose-Sunnyvale-Santa Clara, CA",41940.0,2020-07-01,-2700,-59,-2641
"San Jose-Sunnyvale-Santa Clara, CA",41940.0,2020-08-01,-2586,258,-2844
"San Jose-Sunnyvale-Santa Clara, CA",41940.0,2020-09-01,-2661,7,-2668
"San Jose-Sunnyvale-Santa Clara, CA",41940.0,2020-10-01,-2648,-31,-2617
"San Jose-Sunnyvale-Santa Clara, CA",41940.0,2020-11-01,-2391,-99,-2292
"San Jose-Sunnyvale-Santa Clara, CA",41940.0,2020-12-01,-2324,-27,-2297
"San Diego-Chula Vista-Carlsbad, CA",41740.0,2019-01-01,-695,328,-1023
"San Diego-Chula Vista-Carlsbad, CA",41740.0,2019-02-01,-819,56,-875
"San Diego-Chula Vista-Carlsbad, CA",41740.0,2019-03-01,-889,1,-890
"San Diego-Chula Vista-Carlsbad, CA",41740.0,2019-04-01,-1095,-32,-1063
"San Diego-Chula Vista-Carlsbad, CA",41740.0,2019-05-01,-21,373,-394
"San Diego-Chula Vista-Carlsbad, CA",41740.0,2019-06-01,-464,368,-832
"San Diego-Chula Vista-Carlsbad, CA",41740.0,2019-07-01,-745,151,-896
"San Diego-Chula Vista-Carlsbad, CA",41740.0,2019-08-01,-903,11,-914
"San Diego-Chula Vista-Carlsbad, CA",41740.0,2019-09-01,-853,-78,-775
"San Diego-Chula Vista-Carlsbad, CA",41740.0,2019-10-01,-638,73,-711
"San Diego-Chula Vista-Carlsbad, CA",41740.0,2019-11-01,-660,96,-756
"San Diego-Chula Vista-Carlsbad, CA",41740.0,2019-12-01,-438,220,-658
"San Diego-Chula Vista-Carlsbad, CA",41740.0,2020-01-01,-292,251,-543
"San Diego-Chula Vista-Carlsbad, CA",41740.0,2020-02-01,-642,88,-730
"San Diego-Chula Vista-Carlsbad, CA",41740.0,2020-03-01,-887,207,-1094
"San Diego-Chula Vista-Carlsbad, CA",41740.0,2020-04-01,-937,217,-1154
"San Diego-Chula Vista-Carlsbad, CA",41740.0,2020-05-01,-270,273,-543
"San Diego-Chula Vista-Carlsbad, CA",41740.0,2020-06-01,10,514,-504
"San Diego-Chula Vista-Carlsbad, CA",41740.0,2020-07-01,-281,349,-630
"San Diego-Chula Vista-Carlsbad, CA",41740.0,2020-08-01,-430,133,-563
"San Diego-Chula Vista-Carlsbad, CA",41740.0,2020-09-01,-461,175,-636
"San Diego-Chula Vista-Carlsbad, CA",41740.0,2020-10-01,-59,304,-363
"San Diego-Chula Vista-Carlsbad, CA",41740.0,2020-11-01,-181,548,-729
"San Diego-Chula Vista-Carlsbad, CA",41740.0,2020-12-01,-424,414,-838
"Stockton, CA",44700.0,2019-01-01,242,-16,258
"Stockton, CA",44700.0,2019-02-01,267,-9,276
"Stockton, CA",44700.0,2019-03-01,337,0,337
"Stockton, CA",44700.0,2019-04-01,297,0,297
"Stockton, CA",44700.0,2019-05-01,259,-14,273
"Stockton, CA",44700.0,2019-06-01,452,1,451
"Stockton, CA",44700.0,2019-07-01,392,1,391
"Stockton, CA",44700.0,2019-08-01,129,-20,149
"Stockton, CA",44700.0,2019-09-01,330,0,330
"Stockton, CA",44700.0,2019-10-01,258,12,246
"Stockton, CA",44700.0,2019-11-01,216,0,216
"Stockton, CA",44700.0,2019-12-01,393,26,367
"Stockton, CA",44700.0,2020-01-01,392,15,377
"Stockton, CA",44700.0,2020-02-01,209,1,208
"Stockton, CA",44700.0,2020-03-01,337,8,329
"Stockton, CA",44700.0,2020-04-01,611,38,573
"Stockton, CA",44700.0,2020-05-01,516,33,483
"Stockton, CA",44700.0,2020-06-01,578,26,552
"Stockton, CA",44700.0,2020-07-01,496,25,471
"Stockton, CA",44700.0,2020-08-01,622,20,602
"Stockton, CA",44700.0,2020-09-01,474,30,444
"Stockton, CA",44700.0,2020-10-01,455,0,455
"Stockton, CA",44700.0,2020-11-01,514,28,486
"Stockton, CA",44700.0,2020-12-01,524,66,458
"Farmington, NM",22140.0,2019-01-01,-4,0,-4
"Farmington, NM",22140.0,2019-02-01,18,0,18
"Farmington, NM",22140.0,2019-03-01,-16,0,-16
"Farmington, NM",22140.0,2019-04-01,33,21,12
"Farmington, NM",22140.0,2019-05-01,26,17,9
"Farmington, NM",22140.0,2019-06-01,-21,0,-21
"Farmington, NM",22140.0,2019-07-01,-14,0,-14
"Farmington, NM",22140.0,2019-08-01,13,0,13
"Farmington, NM",22140.0,2019-09-01,31,0,31
"Farmington, NM",22140.0,2019-10-01,15,-22,37
"Farmington, NM",22140.0,2019-11-01,-24,-29,5
"Farmington, NM",22140.0,2019-12-01,7,0,7
"Farmington, NM",22140.0,2020-01-01,-24,0,-24
"Farmington, NM",22140.0,2020-02-01,5,0,5
"Farmington, NM",22140.0,2020-03-01,-25,0,-25
"Farmington, NM",22140.0,2020-04-01,22,0,22
"Farmington, NM",22140.0,2020-05-01,46,0,46
"Farmington, NM",22140.0,2020-06-01,26,0,26
"Farmington, NM",22140.0,2020-07-01,12,0,12
"Farmington, NM",22140.0,2020-08-01,-23,0,-23
"Farmington, NM",22140.0,2020-09-01,-18,0,-18
"Farmington, NM",22140.0,2020-10-01,20,-11,31
"Farmington, NM",22140.0,2020-11-01,-25,-15,-10
"Farmington, NM",22140.0,2020-12-01,-22,0,-22
"San Luis Obispo-Paso Robles, CA",42020.0,2019-01-01,85,0,85
"San Luis Obispo-Paso Robles, CA",42020.0,2019-02-01,-84,0,-84
"San Luis Obispo-Paso Robles, CA",42020.0,2019-03-01,118,0,118
"San Luis Obispo-Paso Robles, CA",42020.0,2019-04-01,2,11,-9
"San Luis Obispo-Paso Robles, CA",42020.0,2019-05-01,55,21,34
"San Luis Obispo-Paso Robles, CA",42020.0,2019-06-01,-147,41,-188
"San Luis Obispo-Paso Robles, CA",42020.0,2019-07-01,-22,1,-23
"San Luis Obispo-Paso Robles, CA",42020.0,2019-08-01,5,-11,16
"San Luis Obispo-Paso Robles, CA",42020.0,2019-09-01,57,0,57
"San Luis Obispo-Paso Robles, CA",42020.0,2019-10-01,61,-14,75
"San Luis Obispo-Paso Robles, CA",42020.0,2019-11-01,86,0,86
"San Luis Obispo-Paso Robles, CA",42020.0,2019-12-01,91,0,91
"San Luis Obispo-Paso Robles, CA",42020.0,2020-01-01,-12,-12,0
"San Luis Obispo-Paso Robles, CA",42020.0,2020-02-01,109,13,96
"San Luis Obispo-Paso Robles, CA",42020.0,2020-03-01,297,87,210
"San Luis Obispo-Paso Robles, CA",42020.0,2020-04-01,181,72,109
"San Luis Obispo-Paso Robles, CA",42020.0,2020-05-01,152,36,116
"San Luis Obispo-Paso Robles, CA",42020.0,2020-06-01,77,72,5
"San Luis Obispo-Paso Robles, CA",42020.0,2020-07-01,83,29,54
"San Luis Obispo-Paso Robles, CA",42020.0,2020-08-01,326,24,302
"San Luis Obispo-Paso Robles, CA",42020.0,2020-09-01,325,44,281
"San Luis Obispo-Paso Robles, CA",42020.0,2020-10-01,186,-13,199
"San Luis Obispo-Paso Robles, CA",42020.0,2020-11-01,224,0,224
"San Luis Obispo-Paso Robles, CA",42020.0,2020-12-01,260,10,250
"Las Vegas, NM",29780.0,2019-01-01,-1,0,-1
"Las Vegas, NM",29780.0,2019-02-01,-15,0,-15
"Las Vegas, NM",29780.0,2019-03-01,0,0,0
"Las Vegas, NM",29780.0,2019-04-01,5,0,5
"Las Vegas, NM",29780.0,2019-05-01,-1,0,-1
"Las Vegas, NM",29780.0,2019-06-01,-12,0,-12
"Las Vegas, NM",29780.0,2019-07-01,-8,0,-8
"Las Vegas, NM",29780.0,2019-08-01,0,0,0
"Las Vegas, NM",29780.0,2019-09-01,-5,0,-5
"Las Vegas, NM",29780.0,2019-10-01,0,0,0
"Las Vegas, NM",29780.0,2019-11-01,11,0,11
"Las Vegas, NM",29780.0,2019-12-01,12,0,12
"Las Vegas, NM",29780.0,2020-01-01,0,0,0
"Las Vegas, NM",29780.0,2020-02-01,0,0,0
"Las Vegas, NM",29780.0,2020-03-01,7,0,7
"Las Vegas, NM",29780.0,2020-04-01,11,0,11
"Las Vegas, NM",29780.0,2020-05-01,-1,0,-1
"Las Vegas, NM",29780.0,2020-06-01,17,0,17
"Las Vegas, NM",29780.0,2020-07-01,-13,0,-13
"Las Vegas, NM",29780.0,2020-08-01,17,0,17
"Las Vegas, NM",29780.0,2020-09-01,23,0,23
"Las Vegas, NM",29780.0,2020-10-01,20,0,20
"Las Vegas, NM",29780.0,2020-11-01,-1,0,-1
"Las Vegas, NM",29780.0,2020-12-01,29,0,29
"Fremont, OH",23380.0,2019-01-01,-12,-13,1
"Fremont, OH",23380.0,2019-02-01,-10,0,-10
"Fremont, OH",23380.0,2019-03-01,-14,0,-14
"Fremont, OH",23380.0,2019-04-01,14,19,-5
"Fremont, OH",23380.0,2019-05-01,62,0,62
"Fremont, OH",23380.0,2019-06-01,1,0,1
"Fremont, OH",23380.0,2019-07-01,-16,0,-16
"Fremont, OH",23380.0,2019-08-01,17,0,17
"Fremont, OH",23380.0,2019-09-01,-30,0,-30
"Fremont, OH",23380.0,2019-10-01,53,0,53
"Fremont, OH",23380.0,2019-11-01,-25,0,-25
"Fremont, OH",23380.0,2019-12-01,-26,-18,-8
"Fremont, OH",23380.0,2020-01-01,11,0,11
"Fremont, OH",23380.0,2020-02-01,-5,0,-5
"Fremont, OH",23380.0,2020-03-01,-4,0,-4
"Fremont, OH",23380.0,2020-04-01,-15,0,-15
"Fremont, OH",23380.0,2020-05-01,-10,0,-10
"Fremont, OH",23380.0,2020-06-01,-11,0,-11
"Fremont, OH",23380.0,2020-07-01,57,0,57
"Fremont, OH",23380.0,2020-08-01,8,0,8
"Fremont, OH",23380.0,2020-09-01,-46,0,-46
"Fremont, OH",23380.0,2020-10-01,0,0,0
"Fremont, OH",23380.0,2020-11-01,5,-11,16
"Fremont, OH",23380.0,2020-12-01,-4,-11,7
"Santa Maria-Santa Barbara, CA",42200.0,2019-01-01,-72,2,-74
"Santa Maria-Santa Barbara, CA",42200.0,2019-02-01,58,-11,69
"Santa Maria-Santa Barbara, CA",42200.0,2019-03-01,22,0,22
"Santa Maria-Santa Barbara, CA",42200.0,2019-04-01,-20,0,-20
"Santa Maria-Santa Barbara, CA",42200.0,2019-05-01,-5,15,-20
"Santa Maria-Santa Barbara, CA",42200.0,2019-06-01,-177,7,-184
"Santa Maria-Santa Barbara, CA",42200.0,2019-07-01,-139,-14,-125
"Santa Maria-Santa Barbara, CA",42200.0,2019-08-01,-180,0,-180
"Santa Maria-Santa Barbara, CA",42200.0,2019-09-01,0,-14,14
"Santa Maria-Santa Barbara, CA",42200.0,2019-10-01,-13,-13,0
"Santa Maria-Santa Barbara, CA",42200.0,2019-11-01,-79,17,-96
"Santa Maria-Santa Barbara, CA",42200.0,2019-12-01,-111,0,-111
"Santa Maria-Santa Barbara, CA",42200.0,2020-01-01,-100,0,-100
"Santa Maria-Santa Barbara, CA",42200.0,2020-02-01,-117,-11,-106
"Santa Maria-Santa Barbara, CA",42200.0,2020-03-01,-97,47,-144
"Santa Maria-Santa Barbara, CA",42200.0,2020-04-01,-9,51,-60
"Santa Maria-Santa Barbara, CA",42200.0,2020-05-01,45,21,24
"Santa Maria-Santa Barbara, CA",42200.0,2020-06-01,-169,13,-182
"Santa Maria-Santa Barbara, CA",42200.0,2020-07-01,3,48,-45
"Santa Maria-Santa Barbara, CA",42200.0,2020-08-01,107,22,85
"Santa Maria-Santa Barbara, CA",42200.0,2020-09-01,38,16,22
"Santa Maria-Santa Barbara, CA",42200.0,2020-10-01,155,1,154
"Santa Maria-Santa Barbara, CA",42200.0,2020-11-01,59,-14,73
"Santa Maria-Santa Barbara, CA",42200.0,2020-12-01,30,51,-21
"Nogales, AZ",35700.0,2019-01-01,19,0,19
"Nogales, AZ",35700.0,2019-02-01,9,0,9
"Nogales, AZ",35700.0,2019-03-01,-14,0,-14
"Nogales, AZ",35700.0,2019-04-01,-25,0,-25
"Nogales, AZ",35700.0,2019-05-01,-13,0,-13
"Nogales, AZ",35700.0,2019-06-01,21,15,6
"Nogales, AZ",35700.0,2019-07-01,2,0,2
"Nogales, AZ",35700.0,2019-08-01,-7,0,-7
"Nogales, AZ",35700.0,2019-09-01,-7,0,-7
"Nogales, AZ",35700.0,2019-10-01,0,0,0
"Nogales, AZ",35700.0,2019-11-01,4,0,4
"Nogales, AZ",35700.0,2019-12-01,-4,0,-4
"Nogales, AZ",35700.0,2020-01-01,9,0,9
"Nogales, AZ",35700.0,2020-02-01,15,0,15
"Nogales, AZ",35700.0,2020-03-01,3,0,3
"Nogales, AZ",35700.0,2020-04-01,23,14,9
"Nogales, AZ",35700.0,2020-05-01,23,0,23
"Nogales, AZ",35700.0,2020-06-01,19,0,19
"Nogales, AZ",35700.0,2020-07-01,3,0,3
"Nogales, AZ",35700.0,2020-08-01,12,0,12
"Nogales, AZ",35700.0,2020-09-01,4,0,4
"Nogales, AZ",35700.0,2020-10-01,7,0,7
"Nogales, AZ",35700.0,2020-11-01,17,0,17
"Nogales, AZ",35700.0,2020-12-01,16,0,16
"Santa Cruz-Watsonville, CA",42100.0,2019-01-01,-32,-13,-19
"Santa Cruz-Watsonville, CA",42100.0,2019-02-01,6,0,6
"Santa Cruz-Watsonville, CA",42100.0,2019-03-01,4,0,4
"Santa Cruz-Watsonville, CA",42100.0,2019-04-01,14,0,14
"Santa Cruz-Watsonville, CA",42100.0,2019-05-01,79,0,79
"Santa Cruz-Watsonville, CA",42100.0,2019-06-01,-147,-14,-133
"Santa Cruz-Watsonville, CA",42100.0,2019-07-01,-75,-11,-64
"Santa Cruz-Watsonville, CA",42100.0,2019-08-01,-116,0,-116
"Santa Cruz-Watsonville, CA",42100.0,2019-09-01,-64,0,-64
"Santa Cruz-Watsonville, CA",42100.0,2019-10-01,-9,0,-9
"Santa Cruz-Watsonville, CA",42100.0,2019-11-01,21,-12,33
"Santa Cruz-Watsonville, CA",42100.0,2019-12-01,30,11,19
"Santa Cruz-Watsonville, CA",42100.0,2020-01-01,24,0,24
"Santa Cruz-Watsonville, CA",42100.0,2020-02-01,-47,0,-47
"Santa Cruz-Watsonville, CA",42100.0,2020-03-01,11,63,-52
"Santa Cruz-Watsonville, CA",42100.0,2020-04-01,-84,39,-123
"Santa Cruz-Watsonville, CA",42100.0,2020-05-01,88,0,88
"Santa Cruz-Watsonville, CA",42100.0,2020-06-01,191,36,155
"Santa Cruz-Watsonville, CA",42100.0,2020-07-01,76,35,41
"Santa Cruz-Watsonville, CA",42100.0,2020-08-01,-829,-623,-206
"Santa Cruz-Watsonville, CA",42100.0,2020-09-01,-56,-39,-17
"Santa Cruz-Watsonville, CA",42100.0,2020-10-01,-14,-19,5
"Santa Cruz-Watsonville, CA",42100.0,2020-11-01,10,0,10
"Santa Cruz-Watsonville, CA",42100.0,2020-12-01,64,1,63
"Santa Fe, NM",42140.0,2019-01-01,-41,0,-41
"Santa Fe, NM",42140.0,2019-02-01,-5,-11,6
"Santa Fe, NM",42140.0,2019-03-01,23,0,23
"Santa Fe, NM",42140.0,2019-04-01,-35,-1,-34
"Santa Fe, NM",42140.0,2019-05-01,108,48,60
"Santa Fe, NM",42140.0,2019-06-01,107,47,60
"Santa Fe, NM",42140.0,2019-07-01,18,0,18
"Santa Fe, NM",42140.0,2019-08-01,-23,0,-23
"Santa Fe, NM",42140.0,2019-09-01,29,0,29
"Santa Fe, NM",42140.0,2019-10-01,-13,-23,10
"Santa Fe, NM",42140.0,2019-11-01,-35,-17,-18
"Santa Fe, NM",42140.0,2019-12-01,-8,-22,14
"Santa Fe, NM",42140.0,2020-01-01,21,15,6
"Santa Fe, NM",42140.0,2020-02-01,30,-12,42
"Santa Fe, NM",42140.0,2020-03-01,22,10,12
"Santa Fe, NM",42140.0,2020-04-01,41,29,12
"Santa Fe, NM",42140.0,2020-05-01,78,33,45
"Santa Fe, NM",42140.0,2020-06-01,75,41,34
"Santa Fe, NM",42140.0,2020-07-01,99,13,86
"Santa Fe, NM",42140.0,2020-08-01,54,0,54
"Santa Fe, NM",42140.0,2020-09-01,81,26,55
"Santa Fe, NM",42140.0,2020-10-01,22,-29,51
"Santa Fe, NM",42140.0,2020-11-01,-32,-21,-11
"Santa Fe, NM",42140.0,2020-12-01,-24,-12,-12
"Santa Isabel, PR",42180.0,2019-01-01,0,0,0
"Santa Isabel, PR",42180.0,2019-04-01,0,0,0
"Santa Isabel, PR",42180.0,2019-07-01,0,0,0
"Santa Isabel, PR",42180.0,2019-08-01,0,0,0
"Santa Isabel, PR",42180.0,2019-09-01,0,0,0
"Santa Isabel, PR",42180.0,2019-11-01,0,0,0
"Santa Isabel, PR",42180.0,2020-01-01,0,0,0
"Santa Isabel, PR",42180.0,2020-03-01,0,0,0
"Santa Isabel, PR",42180.0,2020-08-01,0,0,0
"Santa Isabel, PR",42180.0,2020-09-01,0,0,0
"Santa Isabel, PR",42180.0,2020-10-01,0,0,0
"Santa Isabel, PR",42180.0,2020-12-01,0,0,0
"Baraboo, WI",12660.0,2019-01-01,-34,-38,4
"Baraboo, WI",12660.0,2019-02-01,-11,0,-11
"Baraboo, WI",12660.0,2019-03-01,20,0,20
"Baraboo, WI",12660.0,2019-04-01,9,11,-2
"Baraboo, WI",12660.0,2019-05-01,12,32,-20
"Baraboo, WI",12660.0,2019-06-01,30,0,30
"Baraboo, WI",12660.0,2019-07-01,38,0,38
"Baraboo, WI",12660.0,2019-08-01,-19,0,-19
"Baraboo, WI",12660.0,2019-09-01,-40,0,-40
"Baraboo, WI",12660.0,2019-10-01,-50,-53,3
"Baraboo, WI",12660.0,2019-11-01,-30,-25,-5
"Baraboo, WI",12660.0,2019-12-01,-35,-35,0
"Baraboo, WI",12660.0,2020-01-01,1,-27,28
"Baraboo, WI",12660.0,2020-02-01,-19,0,-19
"Baraboo, WI",12660.0,2020-03-01,4,11,-7
"Baraboo, WI",12660.0,2020-04-01,22,11,11
"Baraboo, WI",12660.0,2020-05-01,43,25,18
"Baraboo, WI",12660.0,2020-06-01,19,0,19
"Baraboo, WI",12660.0,2020-07-01,28,0,28
"Baraboo, WI",12660.0,2020-08-01,39,0,39
"Baraboo, WI",12660.0,2020-09-01,-6,0,-6
"Baraboo, WI",12660.0,2020-10-01,6,-32,38
"Baraboo, WI",12660.0,2020-11-01,-23,-27,4
"Baraboo, WI",12660.0,2020-12-01,58,-18,76
"Americus, GA",11140.0,2019-01-01,0,0,0
"Americus, GA",11140.0,2019-02-01,0,0,0
"Americus, GA",11140.0,2019-03-01,0,0,0
"Americus, GA",11140.0,2019-04-01,-11,0,-11
"Americus, GA",11140.0,2019-05-01,0,0,0
"Americus, GA",11140.0,2019-06-01,0,0,0
"Americus, GA",11140.0,2019-07-01,0,0,0
"Americus, GA",11140.0,2019-08-01,0,0,0
"Americus, GA",11140.0,2019-09-01,0,0,0
"Americus, GA",11140.0,2019-10-01,0,0,0
"Americus, GA",11140.0,2019-11-01,-24,0,-24
"Americus, GA",11140.0,2019-12-01,0,0,0
"Americus, GA",11140.0,2020-01-01,0,0,0
"Americus, GA",11140.0,2020-02-01,0,0,0
"Americus, GA",11140.0,2020-03-01,-11,0,-11
"Americus, GA",11140.0,2020-04-01,-11,0,-11
"Americus, GA",11140.0,2020-05-01,0,0,0
"Americus, GA",11140.0,2020-06-01,0,0,0
"Americus, GA",11140.0,2020-07-01,0,0,0
"Americus, GA",11140.0,2020-08-01,0,0,0
"Americus, GA",11140.0,2020-09-01,0,0,0
"Americus, GA",11140.0,2020-10-01,-11,0,-11
"Americus, GA",11140.0,2020-11-01,0,0,0
"Americus, GA",11140.0,2020-12-01,0,0,0
"Pottsville, PA",39060.0,2019-01-01,56,0,56
"Pottsville, PA",39060.0,2019-02-01,24,0,24
"Pottsville, PA",39060.0,2019-03-01,34,0,34
"Pottsville, PA",39060.0,2019-04-01,55,0,55
"Pottsville, PA",39060.0,2019-05-01,-14,0,-14
"Pottsville, PA",39060.0,2019-06-01,83,0,83
"Pottsville, PA",39060.0,2019-07-01,45,0,45
"Pottsville, PA",39060.0,2019-08-01,36,0,36
"Pottsville, PA",39060.0,2019-09-01,27,-19,46
"Pottsville, PA",39060.0,2019-10-01,56,0,56
"Pottsville, PA",39060.0,2019-11-01,46,0,46
"Pottsville, PA",39060.0,2019-12-01,92,0,92
"Pottsville, PA",39060.0,2020-01-01,77,-12,89
"Pottsville, PA",39060.0,2020-02-01,4,0,4
"Pottsville, PA",39060.0,2020-03-01,60,0,60
"Pottsville, PA",39060.0,2020-04-01,101,0,101
"Pottsville, PA",39060.0,2020-05-01,25,0,25
"Pottsville, PA",39060.0,2020-06-01,57,0,57
"Pottsville, PA",39060.0,2020-07-01,75,0,75
"Pottsville, PA",39060.0,2020-08-01,68,0,68
"Pottsville, PA",39060.0,2020-09-01,40,0,40
"Pottsville, PA",39060.0,2020-10-01,95,0,95
"Pottsville, PA",39060.0,2020-11-01,71,0,71
"Pottsville, PA",39060.0,2020-12-01,65,0,65
"Portsmouth, OH",39020.0,2019-01-01,2,0,2
"Portsmouth, OH",39020.0,2019-02-01,-27,0,-27
"Portsmouth, OH",39020.0,2019-03-01,0,0,0
"Portsmouth, OH",39020.0,2019-04-01,-2,0,-2
"Portsmouth, OH",39020.0,2019-05-01,2,0,2
"Portsmouth, OH",39020.0,2019-06-01,20,0,20
"Portsmouth, OH",39020.0,2019-07-01,20,0,20
"Portsmouth, OH",39020.0,2019-08-01,1,0,1
"Portsmouth, OH",39020.0,2019-09-01,-38,0,-38
"Portsmouth, OH",39020.0,2019-10-01,14,0,14
"Portsmouth, OH",39020.0,2019-11-01,1,0,1
"Portsmouth, OH",39020.0,2019-12-01,2,0,2
"Portsmouth, OH",39020.0,2020-01-01,-33,0,-33
"Portsmouth, OH",39020.0,2020-02-01,-2,0,-2
"Portsmouth, OH",39020.0,2020-03-01,21,0,21
"Portsmouth, OH",39020.0,2020-04-01,6,0,6
"Portsmouth, OH",39020.0,2020-05-01,-26,0,-26
"Portsmouth, OH",39020.0,2020-06-01,14,0,14
"Portsmouth, OH",39020.0,2020-07-01,1,0,1
"Portsmouth, OH",39020.0,2020-08-01,12,0,12
"Portsmouth, OH",39020.0,2020-09-01,29,0,29
"Portsmouth, OH",39020.0,2020-10-01,-12,0,-12
"Portsmouth, OH",39020.0,2020-11-01,-26,0,-26
"Portsmouth, OH",39020.0,2020-12-01,-23,0,-23
"Laurinburg, NC",29900.0,2019-01-01,-1,0,-1
"Laurinburg, NC",29900.0,2019-02-01,-12,0,-12
"Laurinburg, NC",29900.0,2019-03-01,12,0,12
"Laurinburg, NC",29900.0,2019-04-01,-11,0,-11
"Laurinburg, NC",29900.0,2019-05-01,0,0,0
"Laurinburg, NC",29900.0,2019-06-01,-12,0,-12
"Laurinburg, NC",29900.0,2019-07-01,0,0,0
"Laurinburg, NC",29900.0,2019-08-01,-1,0,-1
"Laurinburg, NC",29900.0,2019-09-01,0,0,0
"Laurinburg, NC",29900.0,2019-10-01,-12,0,-12
"Laurinburg, NC",29900.0,2019-11-01,2,0,2
"Laurinburg, NC",29900.0,2019-12-01,13,0,13
"Laurinburg, NC",29900.0,2020-01-01,32,0,32
"Laurinburg, NC",29900.0,2020-02-01,0,0,0
"Laurinburg, NC",29900.0,2020-03-01,-11,0,-11
"Laurinburg, NC",29900.0,2020-04-01,2,0,2
"Laurinburg, NC",29900.0,2020-05-01,-13,0,-13
"Laurinburg, NC",29900.0,2020-06-01,-11,0,-11
"Laurinburg, NC",29900.0,2020-07-01,12,0,12
"Laurinburg, NC",29900.0,2020-08-01,-14,0,-14
"Laurinburg, NC",29900.0,2020-09-01,-13,0,-13
"Laurinburg, NC",29900.0,2020-10-01,11,0,11
"Laurinburg, NC",29900.0,2020-11-01,-16,0,-16
"Laurinburg, NC",29900.0,2020-12-01,0,0,0
"Scottsburg, IN",42500.0,2019-01-01,6,0,6
"Scottsburg, IN",42500.0,2019-02-01,-12,0,-12
"Scottsburg, IN",42500.0,2019-03-01,6,0,6
"Scottsburg, IN",42500.0,2019-04-01,-17,0,-17
"Scottsburg, IN",42500.0,2019-05-01,22,0,22
"Scottsburg, IN",42500.0,2019-06-01,-7,0,-7
"Scottsburg, IN",42500.0,2019-07-01,-25,0,-25
"Scottsburg, IN",42500.0,2019-08-01,-25,0,-25
"Scottsburg, IN",42500.0,2019-09-01,-12,0,-12
"Scottsburg, IN",42500.0,2019-10-01,8,0,8
"Scottsburg, IN",42500.0,2019-11-01,-35,0,-35
"Scottsburg, IN",42500.0,2019-12-01,21,0,21
"Scottsburg, IN",42500.0,2020-01-01,-1,0,-1
"Scottsburg, IN",42500.0,2020-02-01,1,0,1
"Scottsburg, IN",42500.0,2020-03-01,32,0,32
"Scottsburg, IN",42500.0,2020-04-01,7,0,7
"Scottsburg, IN",42500.0,2020-05-01,15,0,15
"Scottsburg, IN",42500.0,2020-06-01,13,0,13
"Scottsburg, IN",42500.0,2020-07-01,62,0,62
"Scottsburg, IN",42500.0,2020-08-01,35,0,35
"Scottsburg, IN",42500.0,2020-09-01,9,0,9
"Scottsburg, IN",42500.0,2020-10-01,3,0,3
"Scottsburg, IN",42500.0,2020-11-01,-20,0,-20
"Scottsburg, IN",42500.0,2020-12-01,35,0,35
"Sikeston, MO",43460.0,2019-01-01,-33,0,-33
"Sikeston, MO",43460.0,2019-02-01,-9,0,-9
"Sikeston, MO",43460.0,2019-03-01,-4,0,-4
"Sikeston, MO",43460.0,2019-04-01,-2,0,-2
"Sikeston, MO",43460.0,2019-05-01,-6,0,-6
"Sikeston, MO",43460.0,2019-06-01,-10,0,-10
"Sikeston, MO",43460.0,2019-07-01,12,0,12
"Sikeston, MO",43460.0,2019-08-01,0,0,0
"Sikeston, MO",43460.0,2019-09-01,22,0,22
"Sikeston, MO",43460.0,2019-10-01,12,0,12
"Sikeston, MO",43460.0,2019-11-01,-9,0,-9
"Sikeston, MO",43460.0,2019-12-01,6,0,6
"Sikeston, MO",43460.0,2020-01-01,-26,0,-26
"Sikeston, MO",43460.0,2020-02-01,-31,0,-31
"Sikeston, MO",43460.0,2020-03-01,30,0,30
"Sikeston, MO",43460.0,2020-04-01,33,0,33
"Sikeston, MO",43460.0,2020-05-01,-25,0,-25
"Sikeston, MO",43460.0,2020-06-01,22,0,22
"Sikeston, MO",43460.0,2020-07-01,-8,0,-8
"Sikeston, MO",43460.0,2020-08-01,-16,0,-16
"Sikeston, MO",43460.0,2020-09-01,-6,0,-6
"Sikeston, MO",43460.0,2020-10-01,15,0,15
"Sikeston, MO",43460.0,2020-11-01,-2,0,-2
"Sikeston, MO",43460.0,2020-12-01,-26,0,-26
"Scottsbluff, NE",42420.0,2019-01-01,0,0,0
"Scottsbluff, NE",42420.0,2019-02-01,12,0,12
"Scottsbluff, NE",42420.0,2019-03-01,-11,0,-11
"Scottsbluff, NE",42420.0,2019-04-01,0,0,0
"Scottsbluff, NE",42420.0,2019-05-01,0,0,0
"Scottsbluff, NE",42420.0,2019-06-01,-11,0,-11
"Scottsbluff, NE",42420.0,2019-07-01,-11,0,-11
"Scottsbluff, NE",42420.0,2019-08-01,22,0,22
"Scottsbluff, NE",42420.0,2019-09-01,0,0,0
"Scottsbluff, NE",42420.0,2019-10-01,0,0,0
"Scottsbluff, NE",42420.0,2019-11-01,-24,0,-24
"Scottsbluff, NE",42420.0,2019-12-01,0,0,0
"Scottsbluff, NE",42420.0,2020-01-01,-11,0,-11
"Scottsbluff, NE",42420.0,2020-02-01,0,0,0
"Scottsbluff, NE",42420.0,2020-03-01,12,0,12
"Scottsbluff, NE",42420.0,2020-04-01,-11,0,-11
"Scottsbluff, NE",42420.0,2020-05-01,0,0,0
"Scottsbluff, NE",42420.0,2020-06-01,19,0,19
"Scottsbluff, NE",42420.0,2020-07-01,0,0,0
"Scottsbluff, NE",42420.0,2020-08-01,11,0,11
"Scottsbluff, NE",42420.0,2020-09-01,11,0,11
"Scottsbluff, NE",42420.0,2020-10-01,0,0,0
"Scottsbluff, NE",42420.0,2020-11-01,0,0,0
"Scottsbluff, NE",42420.0,2020-12-01,0,0,0
"Snyder, TX",43660.0,2019-01-01,11,0,11
"Snyder, TX",43660.0,2019-02-01,0,0,0
"Snyder, TX",43660.0,2019-03-01,0,0,0
"Snyder, TX",43660.0,2019-04-01,0,0,0
"Snyder, TX",43660.0,2019-05-01,0,0,0
"Snyder, TX",43660.0,2019-06-01,0,0,0
"Snyder, TX",43660.0,2019-07-01,0,0,0
"Snyder, TX",43660.0,2019-08-01,0,0,0
"Snyder, TX",43660.0,2019-09-01,0,0,0
"Snyder, TX",43660.0,2019-10-01,0,0,0
"Snyder, TX",43660.0,2019-11-01,0,0,0
"Snyder, TX",43660.0,2019-12-01,0,0,0
"Snyder, TX",43660.0,2020-01-01,0,0,0
"Snyder, TX",43660.0,2020-02-01,0,0,0
"Snyder, TX",43660.0,2020-03-01,-11,0,-11
"Snyder, TX",43660.0,2020-04-01,0,0,0
"Snyder, TX",43660.0,2020-05-01,0,0,0
"Snyder, TX",43660.0,2020-06-01,0,0,0
"Snyder, TX",43660.0,2020-07-01,0,0,0
"Snyder, TX",43660.0,2020-08-01,0,0,0
"Snyder, TX",43660.0,2020-09-01,0,0,0
"Snyder, TX",43660.0,2020-10-01,0,0,0
"Snyder, TX",43660.0,2020-11-01,0,0,0
"Snyder, TX",43660.0,2020-12-01,0,0,0
"Seneca Falls, NY",42900.0,2019-01-01,11,0,11
"Seneca Falls, NY",42900.0,2019-02-01,0,0,0
"Seneca Falls, NY",42900.0,2019-03-01,-9,0,-9
"Seneca Falls, NY",42900.0,2019-04-01,11,0,11
"Seneca Falls, NY",42900.0,2019-05-01,33,0,33
"Seneca Falls, NY",42900.0,2019-06-01,-15,0,-15
"Seneca Falls, NY",42900.0,2019-07-01,-15,0,-15
"Seneca Falls, NY",42900.0,2019-08-01,-2,0,-2
"Seneca Falls, NY",42900.0,2019-09-01,-14,0,-14
"Seneca Falls, NY",42900.0,2019-10-01,15,0,15
"Seneca Falls, NY",42900.0,2019-11-01,-1,0,-1
"Seneca Falls, NY",42900.0,2019-12-01,-14,0,-14
"Seneca Falls, NY",42900.0,2020-01-01,-19,0,-19
"Seneca Falls, NY",42900.0,2020-02-01,23,0,23
"Seneca Falls, NY",42900.0,2020-03-01,-23,0,-23
"Seneca Falls, NY",42900.0,2020-04-01,-9,0,-9
"Seneca Falls, NY",42900.0,2020-05-01,-22,0,-22
"Seneca Falls, NY",42900.0,2020-06-01,7,0,7
"Seneca Falls, NY",42900.0,2020-07-01,-2,0,-2
"Seneca Falls, NY",42900.0,2020-08-01,17,0,17
"Seneca Falls, NY",42900.0,2020-09-01,-5,0,-5
"Seneca Falls, NY",42900.0,2020-10-01,-34,-13,-21
"Seneca Falls, NY",42900.0,2020-11-01,3,0,3
"Seneca Falls, NY",42900.0,2020-12-01,3,0,3
"Tiffin, OH",45660.0,2019-01-01,22,-11,33
"Tiffin, OH",45660.0,2019-02-01,1,0,1
"Tiffin, OH",45660.0,2019-03-01,43,0,43
"Tiffin, OH",45660.0,2019-04-01,-3,0,-3
"Tiffin, OH",45660.0,2019-05-01,18,0,18
"Tiffin, OH",45660.0,2019-06-01,39,0,39
"Tiffin, OH",45660.0,2019-07-01,-7,0,-7
"Tiffin, OH",45660.0,2019-08-01,58,0,58
"Tiffin, OH",45660.0,2019-09-01,50,0,50
"Tiffin, OH",45660.0,2019-10-01,-23,0,-23
"Tiffin, OH",45660.0,2019-11-01,-32,-11,-21
"Tiffin, OH",45660.0,2019-12-01,1,-15,16
"Tiffin, OH",45660.0,2020-01-01,12,-12,24
"Tiffin, OH",45660.0,2020-02-01,-8,0,-8
"Tiffin, OH",45660.0,2020-03-01,26,0,26
"Tiffin, OH",45660.0,2020-04-01,55,0,55
"Tiffin, OH",45660.0,2020-05-01,17,0,17
"Tiffin, OH",45660.0,2020-06-01,8,0,8
"Tiffin, OH",45660.0,2020-07-01,-3,0,-3
"Tiffin, OH",45660.0,2020-08-01,42,0,42
"Tiffin, OH",45660.0,2020-09-01,-2,0,-2
"Tiffin, OH",45660.0,2020-10-01,11,-11,22
"Tiffin, OH",45660.0,2020-11-01,-26,-25,-1
"Tiffin, OH",45660.0,2020-12-01,-31,-12,-19
"Sevierville, TN",42940.0,2019-01-01,-62,0,-62
"Sevierville, TN",42940.0,2019-02-01,-32,0,-32
"Sevierville, TN",42940.0,2019-03-01,-21,0,-21
"Sevierville, TN",42940.0,2019-04-01,-49,0,-49
"Sevierville, TN",42940.0,2019-05-01,-3,0,-3
"Sevierville, TN",42940.0,2019-06-01,7,0,7
"Sevierville, TN",42940.0,2019-07-01,-10,0,-10
"Sevierville, TN",42940.0,2019-08-01,7,0,7
"Sevierville, TN",42940.0,2019-09-01,-19,0,-19
"Sevierville, TN",42940.0,2019-10-01,-87,0,-87
"Sevierville, TN",42940.0,2019-11-01,-21,0,-21
"Sevierville, TN",42940.0,2019-12-01,-61,0,-61
"Sevierville, TN",42940.0,2020-01-01,-50,0,-50
"Sevierville, TN",42940.0,2020-02-01,-31,0,-31
"Sevierville, TN",42940.0,2020-03-01,-4,13,-17
"Sevierville, TN",42940.0,2020-04-01,-33,0,-33
"Sevierville, TN",42940.0,2020-05-01,-16,0,-16
"Sevierville, TN",42940.0,2020-06-01,-36,0,-36
"Sevierville, TN",42940.0,2020-07-01,-8,0,-8
"Sevierville, TN",42940.0,2020-08-01,-32,0,-32
"Sevierville, TN",42940.0,2020-09-01,-24,0,-24
"Sevierville, TN",42940.0,2020-10-01,-35,0,-35
"Sevierville, TN",42940.0,2020-11-01,-27,0,-27
"Sevierville, TN",42940.0,2020-12-01,-24,0,-24
"Liberal, KS",30580.0,2019-01-01,0,0,0
"Liberal, KS",30580.0,2019-02-01,0,0,0
"Liberal, KS",30580.0,2019-03-01,0,0,0
"Liberal, KS",30580.0,2019-04-01,0,0,0
"Liberal, KS",30580.0,2019-05-01,0,0,0
"Liberal, KS",30580.0,2019-06-01,-13,0,-13
"Liberal, KS",30580.0,2019-07-01,0,0,0
"Liberal, KS",30580.0,2019-08-01,0,0,0
"Liberal, KS",30580.0,2019-09-01,0,0,0
"Liberal, KS",30580.0,2019-10-01,0,0,0
"Liberal, KS",30580.0,2019-11-01,0,0,0
"Liberal, KS",30580.0,2019-12-01,0,0,0
"Liberal, KS",30580.0,2020-01-01,0,0,0
"Liberal, KS",30580.0,2020-02-01,-11,0,-11
"Liberal, KS",30580.0,2020-03-01,0,0,0
"Liberal, KS",30580.0,2020-04-01,0,0,0
"Liberal, KS",30580.0,2020-05-01,0,0,0
"Liberal, KS",30580.0,2020-06-01,12,0,12
"Liberal, KS",30580.0,2020-07-01,0,0,0
"Liberal, KS",30580.0,2020-08-01,30,18,12
"Liberal, KS",30580.0,2020-09-01,0,0,0
"Liberal, KS",30580.0,2020-10-01,0,0,0
"Liberal, KS",30580.0,2020-11-01,0,0,0
"Liberal, KS",30580.0,2020-12-01,0,0,0
"Redding, CA",39820.0,2019-01-01,152,33,119
"Redding, CA",39820.0,2019-02-01,170,14,156
"Redding, CA",39820.0,2019-03-01,77,0,77
"Redding, CA",39820.0,2019-04-01,107,0,107
"Redding, CA",39820.0,2019-05-01,12,0,12
"Redding, CA",39820.0,2019-06-01,129,0,129
"Redding, CA",39820.0,2019-07-01,176,0,176
"Redding, CA",39820.0,2019-08-01,112,0,112
"Redding, CA",39820.0,2019-09-01,-2,0,-2
"Redding, CA",39820.0,2019-10-01,42,0,42
"Redding, CA",39820.0,2019-11-01,87,0,87
"Redding, CA",39820.0,2019-12-01,27,0,27
"Redding, CA",39820.0,2020-01-01,4,0,4
"Redding, CA",39820.0,2020-02-01,70,0,70
"Redding, CA",39820.0,2020-03-01,139,0,139
"Redding, CA",39820.0,2020-04-01,144,13,131
"Redding, CA",39820.0,2020-05-01,134,0,134
"Redding, CA",39820.0,2020-06-01,143,0,143
"Redding, CA",39820.0,2020-07-01,72,0,72
"Redding, CA",39820.0,2020-08-01,144,0,144
"Redding, CA",39820.0,2020-09-01,97,0,97
"Redding, CA",39820.0,2020-10-01,128,0,128
"Redding, CA",39820.0,2020-11-01,51,0,51
"Redding, CA",39820.0,2020-12-01,104,0,104
"Shawano, WI",43020.0,2019-01-01,-10,-12,2
"Shawano, WI",43020.0,2019-02-01,0,0,0
"Shawano, WI",43020.0,2019-03-01,0,0,0
"Shawano, WI",43020.0,2019-04-01,-20,0,-20
"Shawano, WI",43020.0,2019-05-01,-11,0,-11
"Shawano, WI",43020.0,2019-06-01,12,0,12
"Shawano, WI",43020.0,2019-07-01,-2,0,-2
"Shawano, WI",43020.0,2019-08-01,7,0,7
"Shawano, WI",43020.0,2019-09-01,-30,0,-30
"Shawano, WI",43020.0,2019-10-01,-18,0,-18
"Shawano, WI",43020.0,2019-11-01,-8,0,-8
"Shawano, WI",43020.0,2019-12-01,-20,-11,-9
"Shawano, WI",43020.0,2020-01-01,1,0,1
"Shawano, WI",43020.0,2020-02-01,23,0,23
"Shawano, WI",43020.0,2020-03-01,41,0,41
"Shawano, WI",43020.0,2020-04-01,-5,0,-5
"Shawano, WI",43020.0,2020-05-01,21,0,21
"Shawano, WI",43020.0,2020-06-01,17,0,17
"Shawano, WI",43020.0,2020-07-01,16,0,16
"Shawano, WI",43020.0,2020-08-01,-22,0,-22
"Shawano, WI",43020.0,2020-09-01,8,0,8
"Shawano, WI",43020.0,2020-10-01,2,0,2
"Shawano, WI",43020.0,2020-11-01,39,0,39
"Shawano, WI",43020.0,2020-12-01,2,0,2
"Sheboygan, WI",43100.0,2019-01-01,-34,-46,12
"Sheboygan, WI",43100.0,2019-02-01,13,0,13
"Sheboygan, WI",43100.0,2019-03-01,19,0,19
"Sheboygan, WI",43100.0,2019-04-01,82,38,44
"Sheboygan, WI",43100.0,2019-05-01,121,77,44
"Sheboygan, WI",43100.0,2019-06-01,18,0,18
"Sheboygan, WI",43100.0,2019-07-01,-27,0,-27
"Sheboygan, WI",43100.0,2019-08-01,-13,0,-13
"Sheboygan, WI",43100.0,2019-09-01,-38,0,-38
"Sheboygan, WI",43100.0,2019-10-01,-60,-64,4
"Sheboygan, WI",43100.0,2019-11-01,-24,-20,-4
"Sheboygan, WI",43100.0,2019-12-01,-64,-85,21
"Sheboygan, WI",43100.0,2020-01-01,-16,-42,26
"Sheboygan, WI",43100.0,2020-02-01,7,0,7
"Sheboygan, WI",43100.0,2020-03-01,40,0,40
"Sheboygan, WI",43100.0,2020-04-01,48,16,32
"Sheboygan, WI",43100.0,2020-05-01,133,74,59
"Sheboygan, WI",43100.0,2020-06-01,41,18,23
"Sheboygan, WI",43100.0,2020-07-01,29,0,29
"Sheboygan, WI",43100.0,2020-08-01,13,0,13
"Sheboygan, WI",43100.0,2020-09-01,-11,0,-11
"Sheboygan, WI",43100.0,2020-10-01,-104,-97,-7
"Sheboygan, WI",43100.0,2020-11-01,-49,-54,5
"Sheboygan, WI",43100.0,2020-12-01,-58,-75,17
"Sidney, OH",43380.0,2019-01-01,-11,0,-11
"Sidney, OH",43380.0,2019-02-01,-28,0,-28
"Sidney, OH",43380.0,2019-03-01,-25,0,-25
"Sidney, OH",43380.0,2019-04-01,-24,0,-24
"Sidney, OH",43380.0,2019-05-01,-5,0,-5
"Sidney, OH",43380.0,2019-06-01,7,0,7
"Sidney, OH",43380.0,2019-07-01,-4,0,-4
"Sidney, OH",43380.0,2019-08-01,3,0,3
"Sidney, OH",43380.0,2019-09-01,-22,0,-22
"Sidney, OH",43380.0,2019-10-01,23,0,23
"Sidney, OH",43380.0,2019-11-01,-8,0,-8
"Sidney, OH",43380.0,2019-12-01,5,0,5
"Sidney, OH",43380.0,2020-01-01,13,0,13
"Sidney, OH",43380.0,2020-02-01,3,0,3
"Sidney, OH",43380.0,2020-03-01,18,0,18
"Sidney, OH",43380.0,2020-04-01,-9,0,-9
"Sidney, OH",43380.0,2020-05-01,-9,0,-9
"Sidney, OH",43380.0,2020-06-01,-9,0,-9
"Sidney, OH",43380.0,2020-07-01,35,0,35
"Sidney, OH",43380.0,2020-08-01,10,0,10
"Sidney, OH",43380.0,2020-09-01,-17,0,-17
"Sidney, OH",43380.0,2020-10-01,-17,0,-17
"Sidney, OH",43380.0,2020-11-01,8,0,8
"Sidney, OH",43380.0,2020-12-01,-18,0,-18
"Sheridan, WY",43260.0,2019-01-01,-11,-11,0
"Sheridan, WY",43260.0,2019-02-01,-11,0,-11
"Sheridan, WY",43260.0,2019-03-01,0,0,0
"Sheridan, WY",43260.0,2019-04-01,13,13,0
"Sheridan, WY",43260.0,2019-05-01,14,14,0
"Sheridan, WY",43260.0,2019-06-01,-13,0,-13
"Sheridan, WY",43260.0,2019-07-01,0,0,0
"Sheridan, WY",43260.0,2019-08-01,14,0,14
"Sheridan, WY",43260.0,2019-09-01,13,0,13
"Sheridan, WY",43260.0,2019-10-01,-30,-16,-14
"Sheridan, WY",43260.0,2019-11-01,-30,-30,0
"Sheridan, WY",43260.0,2019-12-01,-18,-18,0
"Sheridan, WY",43260.0,2020-01-01,0,0,0
"Sheridan, WY",43260.0,2020-02-01,14,0,14
"Sheridan, WY",43260.0,2020-03-01,0,0,0
"Sheridan, WY",43260.0,2020-04-01,18,0,18
"Sheridan, WY",43260.0,2020-05-01,0,0,0
"Sheridan, WY",43260.0,2020-06-01,0,0,0
"Sheridan, WY",43260.0,2020-07-01,22,0,22
"Sheridan, WY",43260.0,2020-08-01,-1,0,-1
"Sheridan, WY",43260.0,2020-09-01,0,0,0
"Sheridan, WY",43260.0,2020-10-01,-3,-15,12
"Sheridan, WY",43260.0,2020-11-01,-28,-28,0
"Sheridan, WY",43260.0,2020-12-01,-18,-18,0
"Butte-Silver Bow, MT",15580.0,2019-01-01,-24,-13,-11
"Butte-Silver Bow, MT",15580.0,2019-02-01,0,0,0
"Butte-Silver Bow, MT",15580.0,2019-03-01,0,0,0
"Butte-Silver Bow, MT",15580.0,2019-04-01,22,0,22
"Butte-Silver Bow, MT",15580.0,2019-05-01,-10,13,-23
"Butte-Silver Bow, MT",15580.0,2019-06-01,-13,0,-13
"Butte-Silver Bow, MT",15580.0,2019-07-01,12,0,12
"Butte-Silver Bow, MT",15580.0,2019-08-01,56,0,56
"Butte-Silver Bow, MT",15580.0,2019-09-01,14,0,14
"Butte-Silver Bow, MT",15580.0,2019-10-01,-5,-14,9
"Butte-Silver Bow, MT",15580.0,2019-11-01,-48,-11,-37
"Butte-Silver Bow, MT",15580.0,2019-12-01,11,0,11
"Butte-Silver Bow, MT",15580.0,2020-01-01,-12,0,-12
"Butte-Silver Bow, MT",15580.0,2020-02-01,12,0,12
"Butte-Silver Bow, MT",15580.0,2020-03-01,-11,0,-11
"Butte-Silver Bow, MT",15580.0,2020-04-01,-13,0,-13
"Butte-Silver Bow, MT",15580.0,2020-05-01,21,19,2
"Butte-Silver Bow, MT",15580.0,2020-06-01,20,0,20
"Butte-Silver Bow, MT",15580.0,2020-07-01,-11,0,-11
"Butte-Silver Bow, MT",15580.0,2020-08-01,27,0,27
"Butte-Silver Bow, MT",15580.0,2020-09-01,0,0,0
"Butte-Silver Bow, MT",15580.0,2020-10-01,-31,-31,0
"Butte-Silver Bow, MT",15580.0,2020-11-01,7,-15,22
"Butte-Silver Bow, MT",15580.0,2020-12-01,11,0,11
"Mount Vernon-Anacortes, WA",34580.0,2019-01-01,6,-68,74
"Mount Vernon-Anacortes, WA",34580.0,2019-02-01,50,0,50
"Mount Vernon-Anacortes, WA",34580.0,2019-03-01,71,0,71
"Mount Vernon-Anacortes, WA",34580.0,2019-04-01,208,97,111
"Mount Vernon-Anacortes, WA",34580.0,2019-05-01,217,117,100
"Mount Vernon-Anacortes, WA",34580.0,2019-06-01,105,38,67
"Mount Vernon-Anacortes, WA",34580.0,2019-07-01,137,-12,149
"Mount Vernon-Anacortes, WA",34580.0,2019-08-01,43,0,43
"Mount Vernon-Anacortes, WA",34580.0,2019-09-01,61,-18,79
"Mount Vernon-Anacortes, WA",34580.0,2019-10-01,-198,-189,-9
"Mount Vernon-Anacortes, WA",34580.0,2019-11-01,-52,-69,17
"Mount Vernon-Anacortes, WA",34580.0,2019-12-01,-39,-66,27
"Mount Vernon-Anacortes, WA",34580.0,2020-01-01,-13,-44,31
"Mount Vernon-Anacortes, WA",34580.0,2020-02-01,32,0,32
"Mount Vernon-Anacortes, WA",34580.0,2020-03-01,109,37,72
"Mount Vernon-Anacortes, WA",34580.0,2020-04-01,80,-8,88
"Mount Vernon-Anacortes, WA",34580.0,2020-05-01,213,82,131
"Mount Vernon-Anacortes, WA",34580.0,2020-06-01,250,68,182
"Mount Vernon-Anacortes, WA",34580.0,2020-07-01,189,28,161
"Mount Vernon-Anacortes, WA",34580.0,2020-08-01,194,13,181
"Mount Vernon-Anacortes, WA",34580.0,2020-09-01,126,12,114
"Mount Vernon-Anacortes, WA",34580.0,2020-10-01,-15,-166,151
"Mount Vernon-Anacortes, WA",34580.0,2020-11-01,-14,-89,75
"Mount Vernon-Anacortes, WA",34580.0,2020-12-01,60,-20,80
"Tyler, TX",46340.0,2019-01-01,25,0,25
"Tyler, TX",46340.0,2019-02-01,41,0,41
"Tyler, TX",46340.0,2019-03-01,-4,0,-4
"Tyler, TX",46340.0,2019-04-01,102,0,102
"Tyler, TX",46340.0,2019-05-01,-25,0,-25
"Tyler, TX",46340.0,2019-06-01,-90,0,-90
"Tyler, TX",46340.0,2019-07-01,48,0,48
"Tyler, TX",46340.0,2019-08-01,91,0,91
"Tyler, TX",46340.0,2019-09-01,-38,0,-38
"Tyler, TX",46340.0,2019-10-01,32,0,32
"Tyler, TX",46340.0,2019-11-01,-60,0,-60
"Tyler, TX",46340.0,2019-12-01,-11,0,-11
"Tyler, TX",46340.0,2020-01-01,53,0,53
"Tyler, TX",46340.0,2020-02-01,32,0,32
"Tyler, TX",46340.0,2020-03-01,-2,0,-2
"Tyler, TX",46340.0,2020-04-01,-46,0,-46
"Tyler, TX",46340.0,2020-05-01,31,0,31
"Tyler, TX",46340.0,2020-06-01,75,0,75
"Tyler, TX",46340.0,2020-07-01,26,0,26
"Tyler, TX",46340.0,2020-08-01,100,0,100
"Tyler, TX",46340.0,2020-09-01,24,0,24
"Tyler, TX",46340.0,2020-10-01,60,0,60
"Tyler, TX",46340.0,2020-11-01,10,0,10
"Tyler, TX",46340.0,2020-12-01,-5,0,-5
"Selinsgrove, PA",42780.0,2019-01-01,-30,0,-30
"Selinsgrove, PA",42780.0,2019-02-01,29,0,29
"Selinsgrove, PA",42780.0,2019-03-01,-8,0,-8
"Selinsgrove, PA",42780.0,2019-04-01,-5,0,-5
"Selinsgrove, PA",42780.0,2019-05-01,-19,0,-19
"Selinsgrove, PA",42780.0,2019-06-01,-9,0,-9
"Selinsgrove, PA",42780.0,2019-07-01,-15,0,-15
"Selinsgrove, PA",42780.0,2019-08-01,-9,0,-9
"Selinsgrove, PA",42780.0,2019-09-01,-1,0,-1
"Selinsgrove, PA",42780.0,2019-10-01,-3,0,-3
"Selinsgrove, PA",42780.0,2019-11-01,-2,0,-2
"Selinsgrove, PA",42780.0,2019-12-01,20,0,20
"Selinsgrove, PA",42780.0,2020-01-01,12,0,12
"Selinsgrove, PA",42780.0,2020-02-01,6,0,6
"Selinsgrove, PA",42780.0,2020-03-01,-12,0,-12
"Selinsgrove, PA",42780.0,2020-04-01,11,0,11
"Selinsgrove, PA",42780.0,2020-05-01,-10,0,-10
"Selinsgrove, PA",42780.0,2020-06-01,15,0,15
"Selinsgrove, PA",42780.0,2020-07-01,-5,0,-5
"Selinsgrove, PA",42780.0,2020-08-01,27,0,27
"Selinsgrove, PA",42780.0,2020-09-01,17,0,17
"Selinsgrove, PA",42780.0,2020-10-01,7,0,7
"Selinsgrove, PA",42780.0,2020-11-01,-44,0,-44
"Selinsgrove, PA",42780.0,2020-12-01,-2,0,-2
"Vallejo, CA",46700.0,2019-01-01,216,-11,227
"Vallejo, CA",46700.0,2019-02-01,89,16,73
"Vallejo, CA",46700.0,2019-03-01,119,0,119
"Vallejo, CA",46700.0,2019-04-01,5,-13,18
"Vallejo, CA",46700.0,2019-05-01,117,0,117
"Vallejo, CA",46700.0,2019-06-01,66,0,66
"Vallejo, CA",46700.0,2019-07-01,179,0,179
"Vallejo, CA",46700.0,2019-08-01,206,2,204
"Vallejo, CA",46700.0,2019-09-01,52,0,52
"Vallejo, CA",46700.0,2019-10-01,121,0,121
"Vallejo, CA",46700.0,2019-11-01,38,12,26
"Vallejo, CA",46700.0,2019-12-01,-13,-12,-1
"Vallejo, CA",46700.0,2020-01-01,24,0,24
"Vallejo, CA",46700.0,2020-02-01,160,0,160
"Vallejo, CA",46700.0,2020-03-01,161,24,137
"Vallejo, CA",46700.0,2020-04-01,142,30,112
"Vallejo, CA",46700.0,2020-05-01,185,14,171
"Vallejo, CA",46700.0,2020-06-01,255,28,227
"Vallejo, CA",46700.0,2020-07-01,188,16,172
"Vallejo, CA",46700.0,2020-08-01,60,-13,73
"Vallejo, CA",46700.0,2020-09-01,171,13,158
"Vallejo, CA",46700.0,2020-10-01,-2,12,-14
"Vallejo, CA",46700.0,2020-11-01,36,0,36
"Vallejo, CA",46700.0,2020-12-01,214,12,202
"Salisbury, MD-DE",41540.0,2019-01-01,-433,-515,82
"Salisbury, MD-DE",41540.0,2019-02-01,43,-14,57
"Salisbury, MD-DE",41540.0,2019-03-01,213,-11,224
"Salisbury, MD-DE",41540.0,2019-04-01,637,298,339
"Salisbury, MD-DE",41540.0,2019-05-01,1230,765,465
"Salisbury, MD-DE",41540.0,2019-06-01,937,318,619
"Salisbury, MD-DE",41540.0,2019-07-01,409,13,396
"Salisbury, MD-DE",41540.0,2019-08-01,430,11,419
"Salisbury, MD-DE",41540.0,2019-09-01,60,-86,146
"Salisbury, MD-DE",41540.0,2019-10-01,-265,-438,173
"Salisbury, MD-DE",41540.0,2019-11-01,-25,-245,220
"Salisbury, MD-DE",41540.0,2019-12-01,-254,-421,167
"Salisbury, MD-DE",41540.0,2020-01-01,-243,-496,253
"Salisbury, MD-DE",41540.0,2020-02-01,78,-43,121
"Salisbury, MD-DE",41540.0,2020-03-01,878,318,560
"Salisbury, MD-DE",41540.0,2020-04-01,810,399,411
"Salisbury, MD-DE",41540.0,2020-05-01,1015,600,415
"Salisbury, MD-DE",41540.0,2020-06-01,1248,705,543
"Salisbury, MD-DE",41540.0,2020-07-01,909,188,721
"Salisbury, MD-DE",41540.0,2020-08-01,712,90,622
"Salisbury, MD-DE",41540.0,2020-09-01,595,-20,615
"Salisbury, MD-DE",41540.0,2020-10-01,60,-388,448
"Salisbury, MD-DE",41540.0,2020-11-01,118,-337,455
"Salisbury, MD-DE",41540.0,2020-12-01,125,-305,430
"Somerset, PA",43740.0,2019-01-01,30,0,30
"Somerset, PA",43740.0,2019-02-01,2,0,2
"Somerset, PA",43740.0,2019-03-01,-24,0,-24
"Somerset, PA",43740.0,2019-04-01,35,0,35
"Somerset, PA",43740.0,2019-05-01,29,0,29
"Somerset, PA",43740.0,2019-06-01,4,0,4
"Somerset, PA",43740.0,2019-07-01,-21,0,-21
"Somerset, PA",43740.0,2019-08-01,-39,0,-39
"Somerset, PA",43740.0,2019-09-01,-29,0,-29
"Somerset, PA",43740.0,2019-10-01,25,0,25
"Somerset, PA",43740.0,2019-11-01,-27,0,-27
"Somerset, PA",43740.0,2019-12-01,10,0,10
"Somerset, PA",43740.0,2020-01-01,-26,0,-26
"Somerset, PA",43740.0,2020-02-01,-11,0,-11
"Somerset, PA",43740.0,2020-03-01,4,0,4
"Somerset, PA",43740.0,2020-04-01,34,0,34
"Somerset, PA",43740.0,2020-05-01,18,0,18
"Somerset, PA",43740.0,2020-06-01,-13,0,-13
"Somerset, PA",43740.0,2020-07-01,-27,0,-27
"Somerset, PA",43740.0,2020-08-01,34,0,34
"Somerset, PA",43740.0,2020-09-01,8,0,8
"Somerset, PA",43740.0,2020-10-01,24,0,24
"Somerset, PA",43740.0,2020-11-01,-4,0,-4
"Somerset, PA",43740.0,2020-12-01,24,-11,35
"Santa Rosa-Petaluma, CA",42220.0,2019-01-01,73,-6,79
"Santa Rosa-Petaluma, CA",42220.0,2019-02-01,66,0,66
"Santa Rosa-Petaluma, CA",42220.0,2019-03-01,138,-13,151
"Santa Rosa-Petaluma, CA",42220.0,2019-04-01,20,-2,22
"Santa Rosa-Petaluma, CA",42220.0,2019-05-01,91,58,33
"Santa Rosa-Petaluma, CA",42220.0,2019-06-01,44,15,29
"Santa Rosa-Petaluma, CA",42220.0,2019-07-01,-33,0,-33
"Santa Rosa-Petaluma, CA",42220.0,2019-08-01,97,0,97
"Santa Rosa-Petaluma, CA",42220.0,2019-09-01,35,0,35
"Santa Rosa-Petaluma, CA",42220.0,2019-10-01,167,-42,209
"Santa Rosa-Petaluma, CA",42220.0,2019-11-01,-8,-2,-6
"Santa Rosa-Petaluma, CA",42220.0,2019-12-01,121,-16,137
"Santa Rosa-Petaluma, CA",42220.0,2020-01-01,7,-32,39
"Santa Rosa-Petaluma, CA",42220.0,2020-02-01,180,0,180
"Santa Rosa-Petaluma, CA",42220.0,2020-03-01,385,238,147
"Santa Rosa-Petaluma, CA",42220.0,2020-04-01,260,168,92
"Santa Rosa-Petaluma, CA",42220.0,2020-05-01,258,157,101
"Santa Rosa-Petaluma, CA",42220.0,2020-06-01,325,129,196
"Santa Rosa-Petaluma, CA",42220.0,2020-07-01,515,90,425
"Santa Rosa-Petaluma, CA",42220.0,2020-08-01,460,22,438
"Santa Rosa-Petaluma, CA",42220.0,2020-09-01,383,23,360
"Santa Rosa-Petaluma, CA",42220.0,2020-10-01,56,9,47
"Santa Rosa-Petaluma, CA",42220.0,2020-11-01,169,21,148
"Santa Rosa-Petaluma, CA",42220.0,2020-12-01,187,65,122
"Spartanburg, SC",43900.0,2019-01-01,5,0,5
"Spartanburg, SC",43900.0,2019-02-01,43,0,43
"Spartanburg, SC",43900.0,2019-03-01,96,0,96
"Spartanburg, SC",43900.0,2019-04-01,124,0,124
"Spartanburg, SC",43900.0,2019-05-01,237,0,237
"Spartanburg, SC",43900.0,2019-06-01,158,-11,169
"Spartanburg, SC",43900.0,2019-07-01,122,-9,131
"Spartanburg, SC",43900.0,2019-08-01,129,-12,141
"Spartanburg, SC",43900.0,2019-09-01,43,-14,57
"Spartanburg, SC",43900.0,2019-10-01,181,-2,183
"Spartanburg, SC",43900.0,2019-11-01,141,-3,144
"Spartanburg, SC",43900.0,2019-12-01,57,-13,70
"Spartanburg, SC",43900.0,2020-01-01,143,14,129
"Spartanburg, SC",43900.0,2020-02-01,117,17,100
"Spartanburg, SC",43900.0,2020-03-01,164,0,164
"Spartanburg, SC",43900.0,2020-04-01,153,0,153
"Spartanburg, SC",43900.0,2020-05-01,99,0,99
"Spartanburg, SC",43900.0,2020-06-01,112,12,100
"Spartanburg, SC",43900.0,2020-07-01,186,-15,201
"Spartanburg, SC",43900.0,2020-08-01,157,0,157
"Spartanburg, SC",43900.0,2020-09-01,112,0,112
"Spartanburg, SC",43900.0,2020-10-01,84,-13,97
"Spartanburg, SC",43900.0,2020-11-01,77,-11,88
"Spartanburg, SC",43900.0,2020-12-01,168,0,168
"Spokane-Spokane Valley, WA",44060.0,2019-01-01,-103,-225,122
"Spokane-Spokane Valley, WA",44060.0,2019-02-01,105,-19,124
"Spokane-Spokane Valley, WA",44060.0,2019-03-01,382,22,360
"Spokane-Spokane Valley, WA",44060.0,2019-04-01,747,340,407
"Spokane-Spokane Valley, WA",44060.0,2019-05-01,526,261,265
"Spokane-Spokane Valley, WA",44060.0,2019-06-01,199,65,134
"Spokane-Spokane Valley, WA",44060.0,2019-07-01,192,4,188
"Spokane-Spokane Valley, WA",44060.0,2019-08-01,215,13,202
"Spokane-Spokane Valley, WA",44060.0,2019-09-01,29,-102,131
"Spokane-Spokane Valley, WA",44060.0,2019-10-01,-605,-776,171
"Spokane-Spokane Valley, WA",44060.0,2019-11-01,-219,-388,169
"Spokane-Spokane Valley, WA",44060.0,2019-12-01,-32,-228,196
"Spokane-Spokane Valley, WA",44060.0,2020-01-01,-181,-265,84
"Spokane-Spokane Valley, WA",44060.0,2020-02-01,65,-51,116
"Spokane-Spokane Valley, WA",44060.0,2020-03-01,543,68,475
"Spokane-Spokane Valley, WA",44060.0,2020-04-01,433,126,307
"Spokane-Spokane Valley, WA",44060.0,2020-05-01,433,280,153
"Spokane-Spokane Valley, WA",44060.0,2020-06-01,309,113,196
"Spokane-Spokane Valley, WA",44060.0,2020-07-01,341,34,307
"Spokane-Spokane Valley, WA",44060.0,2020-08-01,457,20,437
"Spokane-Spokane Valley, WA",44060.0,2020-09-01,316,-75,391
"Spokane-Spokane Valley, WA",44060.0,2020-10-01,-319,-625,306
"Spokane-Spokane Valley, WA",44060.0,2020-11-01,-7,-322,315
"Spokane-Spokane Valley, WA",44060.0,2020-12-01,-98,-251,153
"Modesto, CA",33700.0,2019-01-01,111,17,94
"Modesto, CA",33700.0,2019-02-01,91,-11,102
"Modesto, CA",33700.0,2019-03-01,171,0,171
"Modesto, CA",33700.0,2019-04-01,65,0,65
"Modesto, CA",33700.0,2019-05-01,70,0,70
"Modesto, CA",33700.0,2019-06-01,131,11,120
"Modesto, CA",33700.0,2019-07-01,102,0,102
"Modesto, CA",33700.0,2019-08-01,-10,-20,10
"Modesto, CA",33700.0,2019-09-01,18,0,18
"Modesto, CA",33700.0,2019-10-01,-78,0,-78
"Modesto, CA",33700.0,2019-11-01,77,0,77
"Modesto, CA",33700.0,2019-12-01,79,0,79
"Modesto, CA",33700.0,2020-01-01,7,-17,24
"Modesto, CA",33700.0,2020-02-01,64,0,64
"Modesto, CA",33700.0,2020-03-01,51,5,46
"Modesto, CA",33700.0,2020-04-01,115,20,95
"Modesto, CA",33700.0,2020-05-01,153,0,153
"Modesto, CA",33700.0,2020-06-01,179,0,179
"Modesto, CA",33700.0,2020-07-01,-87,-11,-76
"Modesto, CA",33700.0,2020-08-01,84,0,84
"Modesto, CA",33700.0,2020-09-01,96,0,96
"Modesto, CA",33700.0,2020-10-01,98,0,98
"Modesto, CA",33700.0,2020-11-01,-22,0,-22
"Modesto, CA",33700.0,2020-12-01,14,-22,36
"Albemarle, NC",10620.0,2019-01-01,28,0,28
"Albemarle, NC",10620.0,2019-02-01,71,0,71
"Albemarle, NC",10620.0,2019-03-01,41,0,41
"Albemarle, NC",10620.0,2019-04-01,26,0,26
"Albemarle, NC",10620.0,2019-05-01,21,0,21
"Albemarle, NC",10620.0,2019-06-01,66,0,66
"Albemarle, NC",10620.0,2019-07-01,26,0,26
"Albemarle, NC",10620.0,2019-08-01,55,0,55
"Albemarle, NC",10620.0,2019-09-01,27,0,27
"Albemarle, NC",10620.0,2019-10-01,31,0,31
"Albemarle, NC",10620.0,2019-11-01,32,0,32
"Albemarle, NC",10620.0,2019-12-01,47,0,47
"Albemarle, NC",10620.0,2020-01-01,66,0,66
"Albemarle, NC",10620.0,2020-02-01,23,0,23
"Albemarle, NC",10620.0,2020-03-01,33,0,33
"Albemarle, NC",10620.0,2020-04-01,82,0,82
"Albemarle, NC",10620.0,2020-05-01,46,0,46
"Albemarle, NC",10620.0,2020-06-01,18,0,18
"Albemarle, NC",10620.0,2020-07-01,62,0,62
"Albemarle, NC",10620.0,2020-08-01,53,0,53
"Albemarle, NC",10620.0,2020-09-01,46,0,46
"Albemarle, NC",10620.0,2020-10-01,56,0,56
"Albemarle, NC",10620.0,2020-11-01,50,0,50
"Albemarle, NC",10620.0,2020-12-01,42,0,42
"Dickinson, ND",19860.0,2019-01-01,0,0,0
"Dickinson, ND",19860.0,2019-02-01,0,0,0
"Dickinson, ND",19860.0,2019-03-01,-11,0,-11
"Dickinson, ND",19860.0,2019-04-01,0,0,0
"Dickinson, ND",19860.0,2019-05-01,-17,0,-17
"Dickinson, ND",19860.0,2019-06-01,-18,0,-18
"Dickinson, ND",19860.0,2019-07-01,-16,0,-16
"Dickinson, ND",19860.0,2019-08-01,-15,0,-15
"Dickinson, ND",19860.0,2019-09-01,0,0,0
"Dickinson, ND",19860.0,2019-10-01,-13,0,-13
"Dickinson, ND",19860.0,2019-11-01,0,0,0
"Dickinson, ND",19860.0,2019-12-01,-13,-13,0
"Dickinson, ND",19860.0,2020-01-01,0,0,0
"Dickinson, ND",19860.0,2020-02-01,0,0,0
"Dickinson, ND",19860.0,2020-03-01,-11,0,-11
"Dickinson, ND",19860.0,2020-04-01,-13,0,-13
"Dickinson, ND",19860.0,2020-05-01,-22,0,-22
"Dickinson, ND",19860.0,2020-06-01,3,0,3
"Dickinson, ND",19860.0,2020-07-01,-17,0,-17
"Dickinson, ND",19860.0,2020-08-01,-4,0,-4
"Dickinson, ND",19860.0,2020-09-01,0,0,0
"Dickinson, ND",19860.0,2020-10-01,11,0,11
"Dickinson, ND",19860.0,2020-11-01,0,0,0
"Dickinson, ND",19860.0,2020-12-01,0,0,0
"Rio Grande City-Roma, TX",40100.0,2019-01-01,3,0,3
"Rio Grande City-Roma, TX",40100.0,2019-02-01,-14,0,-14
"Rio Grande City-Roma, TX",40100.0,2019-03-01,0,0,0
"Rio Grande City-Roma, TX",40100.0,2019-04-01,-12,0,-12
"Rio Grande City-Roma, TX",40100.0,2019-05-01,-20,0,-20
"Rio Grande City-Roma, TX",40100.0,2019-06-01,12,0,12
"Rio Grande City-Roma, TX",40100.0,2019-07-01,-13,0,-13
"Rio Grande City-Roma, TX",40100.0,2019-08-01,-14,0,-14
"Rio Grande City-Roma, TX",40100.0,2019-09-01,-13,0,-13
"Rio Grande City-Roma, TX",40100.0,2019-10-01,0,0,0
"Rio Grande City-Roma, TX",40100.0,2019-11-01,54,54,0
"Rio Grande City-Roma, TX",40100.0,2019-12-01,0,0,0
"Rio Grande City-Roma, TX",40100.0,2020-01-01,13,0,13
"Rio Grande City-Roma, TX",40100.0,2020-02-01,0,0,0
"Rio Grande City-Roma, TX",40100.0,2020-03-01,-2,0,-2
"Rio Grande City-Roma, TX",40100.0,2020-04-01,0,0,0
"Rio Grande City-Roma, TX",40100.0,2020-05-01,-14,0,-14
"Rio Grande City-Roma, TX",40100.0,2020-06-01,-17,0,-17
"Rio Grande City-Roma, TX",40100.0,2020-07-01,4,0,4
"Rio Grande City-Roma, TX",40100.0,2020-08-01,5,0,5
"Rio Grande City-Roma, TX",40100.0,2020-09-01,0,0,0
"Rio Grande City-Roma, TX",40100.0,2020-10-01,36,36,0
"Rio Grande City-Roma, TX",40100.0,2020-11-01,0,0,0
"Rio Grande City-Roma, TX",40100.0,2020-12-01,11,0,11
"Owatonna, MN",36940.0,2019-01-01,-5,-17,12
"Owatonna, MN",36940.0,2019-02-01,0,0,0
"Owatonna, MN",36940.0,2019-03-01,26,0,26
"Owatonna, MN",36940.0,2019-04-01,32,11,21
"Owatonna, MN",36940.0,2019-05-01,33,11,22
"Owatonna, MN",36940.0,2019-06-01,25,0,25
"Owatonna, MN",36940.0,2019-07-01,2,0,2
"Owatonna, MN",36940.0,2019-08-01,-12,0,-12
"Owatonna, MN",36940.0,2019-09-01,-15,0,-15
"Owatonna, MN",36940.0,2019-10-01,-19,-20,1
"Owatonna, MN",36940.0,2019-11-01,-24,-13,-11
"Owatonna, MN",36940.0,2019-12-01,17,-18,35
"Owatonna, MN",36940.0,2020-01-01,-13,-14,1
"Owatonna, MN",36940.0,2020-02-01,21,0,21
"Owatonna, MN",36940.0,2020-03-01,-13,0,-13
"Owatonna, MN",36940.0,2020-04-01,-7,0,-7
"Owatonna, MN",36940.0,2020-05-01,-15,0,-15
"Owatonna, MN",36940.0,2020-06-01,-3,0,-3
"Owatonna, MN",36940.0,2020-07-01,-7,0,-7
"Owatonna, MN",36940.0,2020-08-01,12,0,12
"Owatonna, MN",36940.0,2020-09-01,38,0,38
"Owatonna, MN",36940.0,2020-10-01,5,0,5
"Owatonna, MN",36940.0,2020-11-01,9,-12,21
"Owatonna, MN",36940.0,2020-12-01,-28,-12,-16
"Toccoa, GA",45740.0,2019-01-01,10,0,10
"Toccoa, GA",45740.0,2019-02-01,-12,0,-12
"Toccoa, GA",45740.0,2019-03-01,1,0,1
"Toccoa, GA",45740.0,2019-04-01,-18,0,-18
"Toccoa, GA",45740.0,2019-05-01,21,0,21
"Toccoa, GA",45740.0,2019-06-01,-15,0,-15
"Toccoa, GA",45740.0,2019-07-01,17,0,17
"Toccoa, GA",45740.0,2019-08-01,-8,0,-8
"Toccoa, GA",45740.0,2019-09-01,-5,0,-5
"Toccoa, GA",45740.0,2019-10-01,8,0,8
"Toccoa, GA",45740.0,2019-11-01,-5,0,-5
"Toccoa, GA",45740.0,2019-12-01,-20,0,-20
"Toccoa, GA",45740.0,2020-01-01,-2,0,-2
"Toccoa, GA",45740.0,2020-02-01,-4,0,-4
"Toccoa, GA",45740.0,2020-03-01,-17,0,-17
"Toccoa, GA",45740.0,2020-04-01,-2,0,-2
"Toccoa, GA",45740.0,2020-05-01,10,0,10
"Toccoa, GA",45740.0,2020-06-01,9,0,9
"Toccoa, GA",45740.0,2020-07-01,-22,0,-22
"Toccoa, GA",45740.0,2020-08-01,-8,0,-8
"Toccoa, GA",45740.0,2020-09-01,-11,0,-11
"Toccoa, GA",45740.0,2020-10-01,-8,0,-8
"Toccoa, GA",45740.0,2020-11-01,-17,0,-17
"Toccoa, GA",45740.0,2020-12-01,-3,0,-3
"Duncan, OK",20340.0,2019-01-01,15,0,15
"Duncan, OK",20340.0,2019-02-01,11,0,11
"Duncan, OK",20340.0,2019-03-01,-18,0,-18
"Duncan, OK",20340.0,2019-04-01,-12,0,-12
"Duncan, OK",20340.0,2019-05-01,-44,0,-44
"Duncan, OK",20340.0,2019-06-01,-15,0,-15
"Duncan, OK",20340.0,2019-07-01,4,0,4
"Duncan, OK",20340.0,2019-08-01,3,0,3
"Duncan, OK",20340.0,2019-09-01,-11,0,-11
"Duncan, OK",20340.0,2019-10-01,4,0,4
"Duncan, OK",20340.0,2019-11-01,-15,0,-15
"Duncan, OK",20340.0,2019-12-01,13,0,13
"Duncan, OK",20340.0,2020-01-01,-16,0,-16
"Duncan, OK",20340.0,2020-02-01,23,0,23
"Duncan, OK",20340.0,2020-03-01,-10,0,-10
"Duncan, OK",20340.0,2020-04-01,18,0,18
"Duncan, OK",20340.0,2020-05-01,42,0,42
"Duncan, OK",20340.0,2020-06-01,15,0,15
"Duncan, OK",20340.0,2020-07-01,-49,0,-49
"Duncan, OK",20340.0,2020-08-01,21,0,21
"Duncan, OK",20340.0,2020-09-01,17,0,17
"Duncan, OK",20340.0,2020-10-01,-9,0,-9
"Duncan, OK",20340.0,2020-11-01,0,0,0
"Duncan, OK",20340.0,2020-12-01,0,0,0
"Freeport, IL",23300.0,2019-01-01,-3,0,-3
"Freeport, IL",23300.0,2019-02-01,-4,0,-4
"Freeport, IL",23300.0,2019-03-01,-6,0,-6
"Freeport, IL",23300.0,2019-04-01,21,0,21
"Freeport, IL",23300.0,2019-05-01,-1,0,-1
"Freeport, IL",23300.0,2019-06-01,2,0,2
"Freeport, IL",23300.0,2019-07-01,25,0,25
"Freeport, IL",23300.0,2019-08-01,-23,0,-23
"Freeport, IL",23300.0,2019-09-01,-25,0,-25
"Freeport, IL",23300.0,2019-10-01,-12,-11,-1
"Freeport, IL",23300.0,2019-11-01,9,0,9
"Freeport, IL",23300.0,2019-12-01,2,0,2
"Freeport, IL",23300.0,2020-01-01,-7,-13,6
"Freeport, IL",23300.0,2020-02-01,4,0,4
"Freeport, IL",23300.0,2020-03-01,8,0,8
"Freeport, IL",23300.0,2020-04-01,-22,0,-22
"Freeport, IL",23300.0,2020-05-01,-8,0,-8
"Freeport, IL",23300.0,2020-06-01,-2,0,-2
"Freeport, IL",23300.0,2020-07-01,11,0,11
"Freeport, IL",23300.0,2020-08-01,9,0,9
"Freeport, IL",23300.0,2020-09-01,3,0,3
"Freeport, IL",23300.0,2020-10-01,9,0,9
"Freeport, IL",23300.0,2020-11-01,-40,-16,-24
"Freeport, IL",23300.0,2020-12-01,-8,0,-8
"Angola, IN",11420.0,2019-01-01,-25,-14,-11
"Angola, IN",11420.0,2019-02-01,26,0,26
"Angola, IN",11420.0,2019-03-01,8,0,8
"Angola, IN",11420.0,2019-04-01,97,99,-2
"Angola, IN",11420.0,2019-05-01,96,77,19
"Angola, IN",11420.0,2019-06-01,33,0,33
"Angola, IN",11420.0,2019-07-01,8,0,8
"Angola, IN",11420.0,2019-08-01,29,0,29
"Angola, IN",11420.0,2019-09-01,-7,0,-7
"Angola, IN",11420.0,2019-10-01,-60,-58,-2
"Angola, IN",11420.0,2019-11-01,-66,-46,-20
"Angola, IN",11420.0,2019-12-01,-57,-64,7
"Angola, IN",11420.0,2020-01-01,-41,-25,-16
"Angola, IN",11420.0,2020-02-01,17,0,17
"Angola, IN",11420.0,2020-03-01,41,0,41
"Angola, IN",11420.0,2020-04-01,18,12,6
"Angola, IN",11420.0,2020-05-01,101,95,6
"Angola, IN",11420.0,2020-06-01,11,12,-1
"Angola, IN",11420.0,2020-07-01,46,0,46
"Angola, IN",11420.0,2020-08-01,13,0,13
"Angola, IN",11420.0,2020-09-01,8,0,8
"Angola, IN",11420.0,2020-10-01,-88,-89,1
"Angola, IN",11420.0,2020-11-01,-31,-31,0
"Angola, IN",11420.0,2020-12-01,4,-51,55
"Corning, NY",18500.0,2019-01-01,-47,-45,-2
"Corning, NY",18500.0,2019-02-01,-26,0,-26
"Corning, NY",18500.0,2019-03-01,11,0,11
"Corning, NY",18500.0,2019-04-01,86,71,15
"Corning, NY",18500.0,2019-05-01,140,125,15
"Corning, NY",18500.0,2019-06-01,20,13,7
"Corning, NY",18500.0,2019-07-01,-26,0,-26
"Corning, NY",18500.0,2019-08-01,-3,0,-3
"Corning, NY",18500.0,2019-09-01,-60,0,-60
"Corning, NY",18500.0,2019-10-01,-140,-87,-53
"Corning, NY",18500.0,2019-11-01,-68,-90,22
"Corning, NY",18500.0,2019-12-01,-64,-71,7
"Corning, NY",18500.0,2020-01-01,-69,-13,-56
"Corning, NY",18500.0,2020-02-01,52,0,52
"Corning, NY",18500.0,2020-03-01,0,0,0
"Corning, NY",18500.0,2020-04-01,38,11,27
"Corning, NY",18500.0,2020-05-01,92,58,34
"Corning, NY",18500.0,2020-06-01,88,35,53
"Corning, NY",18500.0,2020-07-01,-4,0,-4
"Corning, NY",18500.0,2020-08-01,23,0,23
"Corning, NY",18500.0,2020-09-01,-51,0,-51
"Corning, NY",18500.0,2020-10-01,-72,-78,6
"Corning, NY",18500.0,2020-11-01,-77,-76,-1
"Corning, NY",18500.0,2020-12-01,-42,-74,32
"Jamestown, ND",27420.0,2019-01-01,0,0,0
"Jamestown, ND",27420.0,2019-02-01,-11,0,-11
"Jamestown, ND",27420.0,2019-03-01,0,0,0
"Jamestown, ND",27420.0,2019-04-01,-16,0,-16
"Jamestown, ND",27420.0,2019-05-01,1,14,-13
"Jamestown, ND",27420.0,2019-06-01,0,0,0
"Jamestown, ND",27420.0,2019-07-01,11,0,11
"Jamestown, ND",27420.0,2019-08-01,-22,0,-22
"Jamestown, ND",27420.0,2019-09-01,-15,0,-15
"Jamestown, ND",27420.0,2019-10-01,-30,-19,-11
"Jamestown, ND",27420.0,2019-11-01,0,0,0
"Jamestown, ND",27420.0,2019-12-01,-33,-33,0
"Jamestown, ND",27420.0,2020-01-01,0,0,0
"Jamestown, ND",27420.0,2020-02-01,12,0,12
"Jamestown, ND",27420.0,2020-03-01,0,0,0
"Jamestown, ND",27420.0,2020-04-01,-14,0,-14
"Jamestown, ND",27420.0,2020-05-01,25,11,14
"Jamestown, ND",27420.0,2020-06-01,-13,0,-13
"Jamestown, ND",27420.0,2020-07-01,0,0,0
"Jamestown, ND",27420.0,2020-08-01,-19,0,-19
"Jamestown, ND",27420.0,2020-09-01,0,0,0
"Jamestown, ND",27420.0,2020-10-01,-42,-31,-11
"Jamestown, ND",27420.0,2020-11-01,-11,-11,0
"Jamestown, ND",27420.0,2020-12-01,-18,-18,0
"Breckenridge, CO",14720.0,2019-01-01,-2,0,-2
"Breckenridge, CO",14720.0,2019-02-01,3,0,3
"Breckenridge, CO",14720.0,2019-03-01,19,0,19
"Breckenridge, CO",14720.0,2019-04-01,2,0,2
"Breckenridge, CO",14720.0,2019-05-01,117,91,26
"Breckenridge, CO",14720.0,2019-06-01,123,116,7
"Breckenridge, CO",14720.0,2019-07-01,30,0,30
"Breckenridge, CO",14720.0,2019-08-01,-7,0,-7
"Breckenridge, CO",14720.0,2019-09-01,-29,-12,-17
"Breckenridge, CO",14720.0,2019-10-01,-78,-61,-17
"Breckenridge, CO",14720.0,2019-11-01,38,0,38
"Breckenridge, CO",14720.0,2019-12-01,7,-13,20
"Breckenridge, CO",14720.0,2020-01-01,14,0,14
"Breckenridge, CO",14720.0,2020-02-01,13,0,13
"Breckenridge, CO",14720.0,2020-03-01,-22,-16,-6
"Breckenridge, CO",14720.0,2020-04-01,-3,-11,8
"Breckenridge, CO",14720.0,2020-05-01,78,56,22
"Breckenridge, CO",14720.0,2020-06-01,150,121,29
"Breckenridge, CO",14720.0,2020-07-01,72,25,47
"Breckenridge, CO",14720.0,2020-08-01,40,0,40
"Breckenridge, CO",14720.0,2020-09-01,26,-12,38
"Breckenridge, CO",14720.0,2020-10-01,-1,-60,59
"Breckenridge, CO",14720.0,2020-11-01,48,-13,61
"Breckenridge, CO",14720.0,2020-12-01,37,14,23
"Heber, UT",25720.0,2019-01-01,-13,0,-13
"Heber, UT",25720.0,2019-02-01,40,0,40
"Heber, UT",25720.0,2019-03-01,0,0,0
"Heber, UT",25720.0,2019-04-01,27,0,27
"Heber, UT",25720.0,2019-05-01,134,108,26
"Heber, UT",25720.0,2019-06-01,273,216,57
"Heber, UT",25720.0,2019-07-01,54,53,1
"Heber, UT",25720.0,2019-08-01,30,0,30
"Heber, UT",25720.0,2019-09-01,-24,-15,-9
"Heber, UT",25720.0,2019-10-01,-147,-124,-23
"Heber, UT",25720.0,2019-11-01,-47,-12,-35
"Heber, UT",25720.0,2019-12-01,-6,0,-6
"Heber, UT",25720.0,2020-01-01,-18,-14,-4
"Heber, UT",25720.0,2020-02-01,-9,-15,6
"Heber, UT",25720.0,2020-03-01,30,-2,32
"Heber, UT",25720.0,2020-04-01,27,0,27
"Heber, UT",25720.0,2020-05-01,166,123,43
"Heber, UT",25720.0,2020-06-01,336,220,116
"Heber, UT",25720.0,2020-07-01,82,52,30
"Heber, UT",25720.0,2020-08-01,84,0,84
"Heber, UT",25720.0,2020-09-01,24,-16,40
"Heber, UT",25720.0,2020-10-01,-74,-107,33
"Heber, UT",25720.0,2020-11-01,44,-30,74
"Heber, UT",25720.0,2020-12-01,92,59,33
"The Villages, FL",45540.0,2019-01-01,1254,1160,94
"The Villages, FL",45540.0,2019-02-01,117,88,29
"The Villages, FL",45540.0,2019-03-01,104,24,80
"The Villages, FL",45540.0,2019-04-01,-931,-896,-35
"The Villages, FL",45540.0,2019-05-01,-1871,-1878,7
"The Villages, FL",45540.0,2019-06-01,-259,-376,117
"The Villages, FL",45540.0,2019-07-01,127,0,127
"The Villages, FL",45540.0,2019-08-01,155,0,155
"The Villages, FL",45540.0,2019-09-01,388,267,121
"The Villages, FL",45540.0,2019-10-01,1298,1168,130
"The Villages, FL",45540.0,2019-11-01,309,223,86
"The Villages, FL",45540.0,2019-12-01,1413,1397,16
"The Villages, FL",45540.0,2020-01-01,1229,1163,66
"The Villages, FL",45540.0,2020-02-01,138,61,77
"The Villages, FL",45540.0,2020-03-01,72,4,68
"The Villages, FL",45540.0,2020-04-01,27,-37,64
"The Villages, FL",45540.0,2020-05-01,-830,-834,4
"The Villages, FL",45540.0,2020-06-01,-684,-766,82
"The Villages, FL",45540.0,2020-07-01,-49,-98,49
"The Villages, FL",45540.0,2020-08-01,150,0,150
"The Villages, FL",45540.0,2020-09-01,288,112,176
"The Villages, FL",45540.0,2020-10-01,1172,984,188
"The Villages, FL",45540.0,2020-11-01,384,272,112
"The Villages, FL",45540.0,2020-12-01,1123,966,157
"Indianola, MS",26940.0,2019-01-01,0,0,0
"Indianola, MS",26940.0,2019-02-01,-18,0,-18
"Indianola, MS",26940.0,2019-03-01,0,0,0
"Indianola, MS",26940.0,2019-04-01,0,0,0
"Indianola, MS",26940.0,2019-05-01,0,0,0
"Indianola, MS",26940.0,2019-06-01,-24,0,-24
"Indianola, MS",26940.0,2019-07-01,0,0,0
"Indianola, MS",26940.0,2019-08-01,0,0,0
"Indianola, MS",26940.0,2019-09-01,0,0,0
"Indianola, MS",26940.0,2019-10-01,0,0,0
"Indianola, MS",26940.0,2019-11-01,0,0,0
"Indianola, MS",26940.0,2019-12-01,0,0,0
"Indianola, MS",26940.0,2020-01-01,0,0,0
"Indianola, MS",26940.0,2020-02-01,0,0,0
"Indianola, MS",26940.0,2020-03-01,0,0,0
"Indianola, MS",26940.0,2020-04-01,-12,0,-12
"Indianola, MS",26940.0,2020-05-01,0,0,0
"Indianola, MS",26940.0,2020-06-01,-1,0,-1
"Indianola, MS",26940.0,2020-07-01,0,0,0
"Indianola, MS",26940.0,2020-08-01,0,0,0
"Indianola, MS",26940.0,2020-09-01,0,0,0
"Indianola, MS",26940.0,2020-10-01,0,0,0
"Indianola, MS",26940.0,2020-11-01,0,0,0
"Indianola, MS",26940.0,2020-12-01,0,0,0
"Mount Airy, NC",34340.0,2019-01-01,23,0,23
"Mount Airy, NC",34340.0,2019-02-01,4,0,4
"Mount Airy, NC",34340.0,2019-03-01,18,0,18
"Mount Airy, NC",34340.0,2019-04-01,-20,0,-20
"Mount Airy, NC",34340.0,2019-05-01,-14,0,-14
"Mount Airy, NC",34340.0,2019-06-01,10,0,10
"Mount Airy, NC",34340.0,2019-07-01,7,0,7
"Mount Airy, NC",34340.0,2019-08-01,5,0,5
"Mount Airy, NC",34340.0,2019-09-01,-19,0,-19
"Mount Airy, NC",34340.0,2019-10-01,8,0,8
"Mount Airy, NC",34340.0,2019-11-01,10,0,10
"Mount Airy, NC",34340.0,2019-12-01,21,0,21
"Mount Airy, NC",34340.0,2020-01-01,19,0,19
"Mount Airy, NC",34340.0,2020-02-01,21,0,21
"Mount Airy, NC",34340.0,2020-03-01,-1,0,-1
"Mount Airy, NC",34340.0,2020-04-01,18,0,18
"Mount Airy, NC",34340.0,2020-05-01,-3,0,-3
"Mount Airy, NC",34340.0,2020-06-01,-13,0,-13
"Mount Airy, NC",34340.0,2020-07-01,8,0,8
"Mount Airy, NC",34340.0,2020-08-01,3,0,3
"Mount Airy, NC",34340.0,2020-09-01,3,0,3
"Mount Airy, NC",34340.0,2020-10-01,41,0,41
"Mount Airy, NC",34340.0,2020-11-01,31,0,31
"Mount Airy, NC",34340.0,2020-12-01,-21,0,-21
"Yuba City, CA",49700.0,2019-01-01,181,58,123
"Yuba City, CA",49700.0,2019-02-01,116,18,98
"Yuba City, CA",49700.0,2019-03-01,103,13,90
"Yuba City, CA",49700.0,2019-04-01,85,0,85
"Yuba City, CA",49700.0,2019-05-01,81,0,81
"Yuba City, CA",49700.0,2019-06-01,36,0,36
"Yuba City, CA",49700.0,2019-07-01,72,0,72
"Yuba City, CA",49700.0,2019-08-01,69,0,69
"Yuba City, CA",49700.0,2019-09-01,78,0,78
"Yuba City, CA",49700.0,2019-10-01,13,0,13
"Yuba City, CA",49700.0,2019-11-01,75,0,75
"Yuba City, CA",49700.0,2019-12-01,15,0,15
"Yuba City, CA",49700.0,2020-01-01,13,0,13
"Yuba City, CA",49700.0,2020-02-01,69,0,69
"Yuba City, CA",49700.0,2020-03-01,80,0,80
"Yuba City, CA",49700.0,2020-04-01,84,0,84
"Yuba City, CA",49700.0,2020-05-01,58,0,58
"Yuba City, CA",49700.0,2020-06-01,68,0,68
"Yuba City, CA",49700.0,2020-07-01,76,0,76
"Yuba City, CA",49700.0,2020-08-01,117,0,117
"Yuba City, CA",49700.0,2020-09-01,63,0,63
"Yuba City, CA",49700.0,2020-10-01,79,0,79
"Yuba City, CA",49700.0,2020-11-01,60,0,60
"Yuba City, CA",49700.0,2020-12-01,68,0,68
"Rock Springs, WY",40540.0,2019-01-01,0,0,0
"Rock Springs, WY",40540.0,2019-02-01,0,0,0
"Rock Springs, WY",40540.0,2019-03-01,0,0,0
"Rock Springs, WY",40540.0,2019-04-01,12,0,12
"Rock Springs, WY",40540.0,2019-05-01,0,0,0
"Rock Springs, WY",40540.0,2019-06-01,-12,0,-12
"Rock Springs, WY",40540.0,2019-07-01,-12,0,-12
"Rock Springs, WY",40540.0,2019-08-01,4,0,4
"Rock Springs, WY",40540.0,2019-09-01,0,0,0
"Rock Springs, WY",40540.0,2019-10-01,0,0,0
"Rock Springs, WY",40540.0,2019-11-01,0,0,0
"Rock Springs, WY",40540.0,2019-12-01,0,0,0
"Rock Springs, WY",40540.0,2020-01-01,0,0,0
"Rock Springs, WY",40540.0,2020-02-01,0,0,0
"Rock Springs, WY",40540.0,2020-03-01,-5,0,-5
"Rock Springs, WY",40540.0,2020-04-01,0,0,0
"Rock Springs, WY",40540.0,2020-05-01,0,0,0
"Rock Springs, WY",40540.0,2020-06-01,0,0,0
"Rock Springs, WY",40540.0,2020-07-01,-2,0,-2
"Rock Springs, WY",40540.0,2020-08-01,-16,0,-16
"Rock Springs, WY",40540.0,2020-09-01,0,0,0
"Rock Springs, WY",40540.0,2020-10-01,3,-20,23
"Rock Springs, WY",40540.0,2020-11-01,-11,-11,0
"Rock Springs, WY",40540.0,2020-12-01,0,0,0
"Easton, MD",20660.0,2019-01-01,3,0,3
"Easton, MD",20660.0,2019-02-01,3,0,3
"Easton, MD",20660.0,2019-03-01,-16,0,-16
"Easton, MD",20660.0,2019-04-01,45,13,32
"Easton, MD",20660.0,2019-05-01,-2,11,-13
"Easton, MD",20660.0,2019-06-01,-7,0,-7
"Easton, MD",20660.0,2019-07-01,-17,0,-17
"Easton, MD",20660.0,2019-08-01,-9,0,-9
"Easton, MD",20660.0,2019-09-01,3,0,3
"Easton, MD",20660.0,2019-10-01,9,0,9
"Easton, MD",20660.0,2019-11-01,-26,-12,-14
"Easton, MD",20660.0,2019-12-01,-15,0,-15
"Easton, MD",20660.0,2020-01-01,-9,0,-9
"Easton, MD",20660.0,2020-02-01,3,0,3
"Easton, MD",20660.0,2020-03-01,49,36,13
"Easton, MD",20660.0,2020-04-01,31,24,7
"Easton, MD",20660.0,2020-05-01,48,23,25
"Easton, MD",20660.0,2020-06-01,41,0,41
"Easton, MD",20660.0,2020-07-01,37,0,37
"Easton, MD",20660.0,2020-08-01,35,0,35
"Easton, MD",20660.0,2020-09-01,-3,0,-3
"Easton, MD",20660.0,2020-10-01,16,0,16
"Easton, MD",20660.0,2020-11-01,11,-11,22
"Easton, MD",20660.0,2020-12-01,-6,0,-6
"Talladega-Sylacauga, AL",45180.0,2019-01-01,3,0,3
"Talladega-Sylacauga, AL",45180.0,2019-02-01,18,0,18
"Talladega-Sylacauga, AL",45180.0,2019-03-01,2,0,2
"Talladega-Sylacauga, AL",45180.0,2019-04-01,40,0,40
"Talladega-Sylacauga, AL",45180.0,2019-05-01,24,0,24
"Talladega-Sylacauga, AL",45180.0,2019-06-01,-15,0,-15
"Talladega-Sylacauga, AL",45180.0,2019-07-01,27,0,27
"Talladega-Sylacauga, AL",45180.0,2019-08-01,-23,0,-23
"Talladega-Sylacauga, AL",45180.0,2019-09-01,-40,0,-40
"Talladega-Sylacauga, AL",45180.0,2019-10-01,-9,0,-9
"Talladega-Sylacauga, AL",45180.0,2019-11-01,-8,0,-8
"Talladega-Sylacauga, AL",45180.0,2019-12-01,-6,0,-6
"Talladega-Sylacauga, AL",45180.0,2020-01-01,-28,0,-28
"Talladega-Sylacauga, AL",45180.0,2020-02-01,-3,0,-3
"Talladega-Sylacauga, AL",45180.0,2020-03-01,-16,0,-16
"Talladega-Sylacauga, AL",45180.0,2020-04-01,66,0,66
"Talladega-Sylacauga, AL",45180.0,2020-05-01,31,0,31
"Talladega-Sylacauga, AL",45180.0,2020-06-01,-1,0,-1
"Talladega-Sylacauga, AL",45180.0,2020-07-01,81,0,81
"Talladega-Sylacauga, AL",45180.0,2020-08-01,23,0,23
"Talladega-Sylacauga, AL",45180.0,2020-09-01,55,0,55
"Talladega-Sylacauga, AL",45180.0,2020-10-01,7,0,7
"Talladega-Sylacauga, AL",45180.0,2020-11-01,10,0,10
"Talladega-Sylacauga, AL",45180.0,2020-12-01,40,0,40
"Branson, MO",14700.0,2019-01-01,-1,0,-1
"Branson, MO",14700.0,2019-02-01,-12,0,-12
"Branson, MO",14700.0,2019-03-01,-25,0,-25
"Branson, MO",14700.0,2019-04-01,10,12,-2
"Branson, MO",14700.0,2019-05-01,-57,0,-57
"Branson, MO",14700.0,2019-06-01,-30,0,-30
"Branson, MO",14700.0,2019-07-01,-34,0,-34
"Branson, MO",14700.0,2019-08-01,-9,0,-9
"Branson, MO",14700.0,2019-09-01,-36,0,-36
"Branson, MO",14700.0,2019-10-01,-37,0,-37
"Branson, MO",14700.0,2019-11-01,-8,-11,3
"Branson, MO",14700.0,2019-12-01,-21,0,-21
"Branson, MO",14700.0,2020-01-01,-19,0,-19
"Branson, MO",14700.0,2020-02-01,-51,0,-51
"Branson, MO",14700.0,2020-03-01,-23,0,-23
"Branson, MO",14700.0,2020-04-01,-49,0,-49
"Branson, MO",14700.0,2020-05-01,-27,0,-27
"Branson, MO",14700.0,2020-06-01,-25,0,-25
"Branson, MO",14700.0,2020-07-01,4,0,4
"Branson, MO",14700.0,2020-08-01,-24,0,-24
"Branson, MO",14700.0,2020-09-01,-15,0,-15
"Branson, MO",14700.0,2020-10-01,-33,0,-33
"Branson, MO",14700.0,2020-11-01,-9,0,-9
"Branson, MO",14700.0,2020-12-01,-9,0,-9
"Hammond, LA",25220.0,2019-01-01,32,0,32
"Hammond, LA",25220.0,2019-02-01,28,0,28
"Hammond, LA",25220.0,2019-03-01,36,0,36
"Hammond, LA",25220.0,2019-04-01,50,0,50
"Hammond, LA",25220.0,2019-05-01,43,0,43
"Hammond, LA",25220.0,2019-06-01,77,0,77
"Hammond, LA",25220.0,2019-07-01,0,0,0
"Hammond, LA",25220.0,2019-08-01,52,0,52
"Hammond, LA",25220.0,2019-09-01,25,0,25
"Hammond, LA",25220.0,2019-10-01,88,0,88
"Hammond, LA",25220.0,2019-11-01,69,0,69
"Hammond, LA",25220.0,2019-12-01,29,0,29
"Hammond, LA",25220.0,2020-01-01,35,0,35
"Hammond, LA",25220.0,2020-02-01,-13,0,-13
"Hammond, LA",25220.0,2020-03-01,35,0,35
"Hammond, LA",25220.0,2020-04-01,28,0,28
"Hammond, LA",25220.0,2020-05-01,84,0,84
"Hammond, LA",25220.0,2020-06-01,55,0,55
"Hammond, LA",25220.0,2020-07-01,23,0,23
"Hammond, LA",25220.0,2020-08-01,3,0,3
"Hammond, LA",25220.0,2020-09-01,22,0,22
"Hammond, LA",25220.0,2020-10-01,45,0,45
"Hammond, LA",25220.0,2020-11-01,55,0,55
"Hammond, LA",25220.0,2020-12-01,5,0,5
"Taos, NM",45340.0,2019-01-01,-11,0,-11
"Taos, NM",45340.0,2019-02-01,0,0,0
"Taos, NM",45340.0,2019-03-01,-9,0,-9
"Taos, NM",45340.0,2019-04-01,14,0,14
"Taos, NM",45340.0,2019-05-01,11,11,0
"Taos, NM",45340.0,2019-06-01,12,0,12
"Taos, NM",45340.0,2019-07-01,-31,0,-31
"Taos, NM",45340.0,2019-08-01,3,0,3
"Taos, NM",45340.0,2019-09-01,-11,0,-11
"Taos, NM",45340.0,2019-10-01,-2,0,-2
"Taos, NM",45340.0,2019-11-01,0,0,0
"Taos, NM",45340.0,2019-12-01,-11,0,-11
"Taos, NM",45340.0,2020-01-01,0,0,0
"Taos, NM",45340.0,2020-02-01,0,0,0
"Taos, NM",45340.0,2020-03-01,-11,0,-11
"Taos, NM",45340.0,2020-04-01,-14,0,-14
"Taos, NM",45340.0,2020-05-01,28,0,28
"Taos, NM",45340.0,2020-06-01,1,12,-11
"Taos, NM",45340.0,2020-07-01,21,0,21
"Taos, NM",45340.0,2020-08-01,32,0,32
"Taos, NM",45340.0,2020-09-01,16,0,16
"Taos, NM",45340.0,2020-10-01,22,0,22
"Taos, NM",45340.0,2020-11-01,11,0,11
"Taos, NM",45340.0,2020-12-01,0,0,0
"Red Bluff, CA",39780.0,2019-01-01,171,36,135
"Red Bluff, CA",39780.0,2019-02-01,54,32,22
"Red Bluff, CA",39780.0,2019-03-01,51,0,51
"Red Bluff, CA",39780.0,2019-04-01,44,12,32
"Red Bluff, CA",39780.0,2019-05-01,40,0,40
"Red Bluff, CA",39780.0,2019-06-01,-51,0,-51
"Red Bluff, CA",39780.0,2019-07-01,-31,0,-31
"Red Bluff, CA",39780.0,2019-08-01,-31,0,-31
"Red Bluff, CA",39780.0,2019-09-01,-24,0,-24
"Red Bluff, CA",39780.0,2019-10-01,-20,0,-20
"Red Bluff, CA",39780.0,2019-11-01,19,0,19
"Red Bluff, CA",39780.0,2019-12-01,-1,0,-1
"Red Bluff, CA",39780.0,2020-01-01,6,0,6
"Red Bluff, CA",39780.0,2020-02-01,11,0,11
"Red Bluff, CA",39780.0,2020-03-01,-31,0,-31
"Red Bluff, CA",39780.0,2020-04-01,-9,0,-9
"Red Bluff, CA",39780.0,2020-05-01,25,0,25
"Red Bluff, CA",39780.0,2020-06-01,-7,0,-7
"Red Bluff, CA",39780.0,2020-07-01,33,0,33
"Red Bluff, CA",39780.0,2020-08-01,-17,0,-17
"Red Bluff, CA",39780.0,2020-09-01,9,0,9
"Red Bluff, CA",39780.0,2020-10-01,-3,0,-3
"Red Bluff, CA",39780.0,2020-11-01,8,0,8
"Red Bluff, CA",39780.0,2020-12-01,-12,0,-12
"Jackson, WY-ID",27220.0,2019-01-01,0,0,0
"Jackson, WY-ID",27220.0,2019-02-01,0,0,0
"Jackson, WY-ID",27220.0,2019-03-01,-14,-14,0
"Jackson, WY-ID",27220.0,2019-04-01,15,15,0
"Jackson, WY-ID",27220.0,2019-05-01,68,68,0
"Jackson, WY-ID",27220.0,2019-06-01,17,17,0
"Jackson, WY-ID",27220.0,2019-07-01,0,0,0
"Jackson, WY-ID",27220.0,2019-08-01,0,0,0
"Jackson, WY-ID",27220.0,2019-09-01,-11,0,-11
"Jackson, WY-ID",27220.0,2019-10-01,-59,-59,0
"Jackson, WY-ID",27220.0,2019-11-01,-13,-13,0
"Jackson, WY-ID",27220.0,2019-12-01,0,0,0
"Jackson, WY-ID",27220.0,2020-01-01,0,0,0
"Jackson, WY-ID",27220.0,2020-02-01,0,0,0
"Jackson, WY-ID",27220.0,2020-03-01,45,32,13
"Jackson, WY-ID",27220.0,2020-04-01,-11,-11,0
"Jackson, WY-ID",27220.0,2020-05-01,10,25,-15
"Jackson, WY-ID",27220.0,2020-06-01,10,21,-11
"Jackson, WY-ID",27220.0,2020-07-01,-1,0,-1
"Jackson, WY-ID",27220.0,2020-08-01,-12,0,-12
"Jackson, WY-ID",27220.0,2020-09-01,12,0,12
"Jackson, WY-ID",27220.0,2020-10-01,-76,-61,-15
"Jackson, WY-ID",27220.0,2020-11-01,-8,-22,14
"Jackson, WY-ID",27220.0,2020-12-01,0,0,0
"Guymon, OK",25100.0,2019-01-01,0,0,0
"Guymon, OK",25100.0,2019-02-01,0,0,0
"Guymon, OK",25100.0,2019-03-01,0,0,0
"Guymon, OK",25100.0,2019-04-01,0,0,0
"Guymon, OK",25100.0,2019-05-01,0,0,0
"Guymon, OK",25100.0,2019-06-01,13,0,13
"Guymon, OK",25100.0,2019-07-01,0,0,0
"Guymon, OK",25100.0,2019-08-01,0,0,0
"Guymon, OK",25100.0,2019-09-01,0,0,0
"Guymon, OK",25100.0,2019-10-01,0,0,0
"Guymon, OK",25100.0,2019-11-01,0,0,0
"Guymon, OK",25100.0,2019-12-01,0,0,0
"Guymon, OK",25100.0,2020-01-01,0,0,0
"Guymon, OK",25100.0,2020-02-01,11,0,11
"Guymon, OK",25100.0,2020-03-01,0,0,0
"Guymon, OK",25100.0,2020-04-01,0,0,0
"Guymon, OK",25100.0,2020-05-01,0,0,0
"Guymon, OK",25100.0,2020-06-01,-12,0,-12
"Guymon, OK",25100.0,2020-07-01,0,0,0
"Guymon, OK",25100.0,2020-08-01,-12,0,-12
"Guymon, OK",25100.0,2020-09-01,0,0,0
"Guymon, OK",25100.0,2020-10-01,0,0,0
"Guymon, OK",25100.0,2020-11-01,0,0,0
"Guymon, OK",25100.0,2020-12-01,0,0,0
"Thomasville, GA",45620.0,2019-01-01,11,0,11
"Thomasville, GA",45620.0,2019-02-01,-6,0,-6
"Thomasville, GA",45620.0,2019-03-01,-11,0,-11
"Thomasville, GA",45620.0,2019-04-01,34,0,34
"Thomasville, GA",45620.0,2019-05-01,15,0,15
"Thomasville, GA",45620.0,2019-06-01,-7,0,-7
"Thomasville, GA",45620.0,2019-07-01,30,0,30
"Thomasville, GA",45620.0,2019-08-01,13,0,13
"Thomasville, GA",45620.0,2019-09-01,6,0,6
"Thomasville, GA",45620.0,2019-10-01,-13,0,-13
"Thomasville, GA",45620.0,2019-11-01,-6,0,-6
"Thomasville, GA",45620.0,2019-12-01,1,0,1
"Thomasville, GA",45620.0,2020-01-01,-29,0,-29
"Thomasville, GA",45620.0,2020-02-01,-10,0,-10
"Thomasville, GA",45620.0,2020-03-01,-25,0,-25
"Thomasville, GA",45620.0,2020-04-01,39,0,39
"Thomasville, GA",45620.0,2020-05-01,-2,0,-2
"Thomasville, GA",45620.0,2020-06-01,32,0,32
"Thomasville, GA",45620.0,2020-07-01,-2,0,-2
"Thomasville, GA",45620.0,2020-08-01,0,0,0
"Thomasville, GA",45620.0,2020-09-01,22,0,22
"Thomasville, GA",45620.0,2020-10-01,-2,0,-2
"Thomasville, GA",45620.0,2020-11-01,20,0,20
"Thomasville, GA",45620.0,2020-12-01,15,0,15
"Olympia-Lacey-Tumwater, WA",36500.0,2019-01-01,65,-89,154
"Olympia-Lacey-Tumwater, WA",36500.0,2019-02-01,50,-42,92
"Olympia-Lacey-Tumwater, WA",36500.0,2019-03-01,225,-8,233
"Olympia-Lacey-Tumwater, WA",36500.0,2019-04-01,441,148,293
"Olympia-Lacey-Tumwater, WA",36500.0,2019-05-01,485,194,291
"Olympia-Lacey-Tumwater, WA",36500.0,2019-06-01,281,14,267
"Olympia-Lacey-Tumwater, WA",36500.0,2019-07-01,269,14,255
"Olympia-Lacey-Tumwater, WA",36500.0,2019-08-01,127,0,127
"Olympia-Lacey-Tumwater, WA",36500.0,2019-09-01,59,-45,104
"Olympia-Lacey-Tumwater, WA",36500.0,2019-10-01,-197,-293,96
"Olympia-Lacey-Tumwater, WA",36500.0,2019-11-01,-105,-164,59
"Olympia-Lacey-Tumwater, WA",36500.0,2019-12-01,37,-112,149
"Olympia-Lacey-Tumwater, WA",36500.0,2020-01-01,-37,-127,90
"Olympia-Lacey-Tumwater, WA",36500.0,2020-02-01,30,-38,68
"Olympia-Lacey-Tumwater, WA",36500.0,2020-03-01,43,-45,88
"Olympia-Lacey-Tumwater, WA",36500.0,2020-04-01,209,-8,217
"Olympia-Lacey-Tumwater, WA",36500.0,2020-05-01,267,174,93
"Olympia-Lacey-Tumwater, WA",36500.0,2020-06-01,204,61,143
"Olympia-Lacey-Tumwater, WA",36500.0,2020-07-01,132,12,120
"Olympia-Lacey-Tumwater, WA",36500.0,2020-08-01,109,27,82
"Olympia-Lacey-Tumwater, WA",36500.0,2020-09-01,160,-23,183
"Olympia-Lacey-Tumwater, WA",36500.0,2020-10-01,-69,-225,156
"Olympia-Lacey-Tumwater, WA",36500.0,2020-11-01,-34,-166,132
"Olympia-Lacey-Tumwater, WA",36500.0,2020-12-01,73,-71,144
"Tifton, GA",45700.0,2019-01-01,-12,0,-12
"Tifton, GA",45700.0,2019-02-01,19,0,19
"Tifton, GA",45700.0,2019-03-01,0,0,0
"Tifton, GA",45700.0,2019-04-01,-11,0,-11
"Tifton, GA",45700.0,2019-05-01,-11,0,-11
"Tifton, GA",45700.0,2019-06-01,-9,0,-9
"Tifton, GA",45700.0,2019-07-01,12,0,12
"Tifton, GA",45700.0,2019-08-01,0,0,0
"Tifton, GA",45700.0,2019-09-01,0,0,0
"Tifton, GA",45700.0,2019-10-01,-13,0,-13
"Tifton, GA",45700.0,2019-11-01,-23,0,-23
"Tifton, GA",45700.0,2019-12-01,0,0,0
"Tifton, GA",45700.0,2020-01-01,-11,0,-11
"Tifton, GA",45700.0,2020-02-01,-3,0,-3
"Tifton, GA",45700.0,2020-03-01,-32,0,-32
"Tifton, GA",45700.0,2020-04-01,-14,0,-14
"Tifton, GA",45700.0,2020-05-01,14,0,14
"Tifton, GA",45700.0,2020-06-01,2,0,2
"Tifton, GA",45700.0,2020-07-01,-50,0,-50
"Tifton, GA",45700.0,2020-08-01,0,0,0
"Tifton, GA",45700.0,2020-09-01,0,0,0
"Tifton, GA",45700.0,2020-10-01,0,0,0
"Tifton, GA",45700.0,2020-11-01,0,0,0
"Tifton, GA",45700.0,2020-12-01,3,0,3
"San Angelo, TX",41660.0,2019-01-01,34,0,34
"San Angelo, TX",41660.0,2019-02-01,56,0,56
"San Angelo, TX",41660.0,2019-03-01,-4,0,-4
"San Angelo, TX",41660.0,2019-04-01,-23,0,-23
"San Angelo, TX",41660.0,2019-05-01,-41,0,-41
"San Angelo, TX",41660.0,2019-06-01,-3,0,-3
"San Angelo, TX",41660.0,2019-07-01,-45,0,-45
"San Angelo, TX",41660.0,2019-08-01,6,0,6
"San Angelo, TX",41660.0,2019-09-01,20,0,20
"San Angelo, TX",41660.0,2019-10-01,-17,0,-17
"San Angelo, TX",41660.0,2019-11-01,-25,0,-25
"San Angelo, TX",41660.0,2019-12-01,-23,0,-23
"San Angelo, TX",41660.0,2020-01-01,-35,0,-35
"San Angelo, TX",41660.0,2020-02-01,-75,0,-75
"San Angelo, TX",41660.0,2020-03-01,-35,0,-35
"San Angelo, TX",41660.0,2020-04-01,6,0,6
"San Angelo, TX",41660.0,2020-05-01,-53,0,-53
"San Angelo, TX",41660.0,2020-06-01,-20,0,-20
"San Angelo, TX",41660.0,2020-07-01,-75,0,-75
"San Angelo, TX",41660.0,2020-08-01,-55,0,-55
"San Angelo, TX",41660.0,2020-09-01,-33,0,-33
"San Angelo, TX",41660.0,2020-10-01,-20,0,-20
"San Angelo, TX",41660.0,2020-11-01,-26,0,-26
"San Angelo, TX",41660.0,2020-12-01,-34,0,-34
"Ithaca, NY",27060.0,2019-01-01,-48,-37,-11
"Ithaca, NY",27060.0,2019-02-01,-52,0,-52
"Ithaca, NY",27060.0,2019-03-01,-15,0,-15
"Ithaca, NY",27060.0,2019-04-01,44,24,20
"Ithaca, NY",27060.0,2019-05-01,-52,12,-64
"Ithaca, NY",27060.0,2019-06-01,-121,0,-121
"Ithaca, NY",27060.0,2019-07-01,-245,0,-245
"Ithaca, NY",27060.0,2019-08-01,-36,0,-36
"Ithaca, NY",27060.0,2019-09-01,-39,0,-39
"Ithaca, NY",27060.0,2019-10-01,-9,-36,27
"Ithaca, NY",27060.0,2019-11-01,-22,0,-22
"Ithaca, NY",27060.0,2019-12-01,-65,-35,-30
"Ithaca, NY",27060.0,2020-01-01,-18,-19,1
"Ithaca, NY",27060.0,2020-02-01,1,0,1
"Ithaca, NY",27060.0,2020-03-01,-7,62,-69
"Ithaca, NY",27060.0,2020-04-01,30,37,-7
"Ithaca, NY",27060.0,2020-05-01,37,45,-8
"Ithaca, NY",27060.0,2020-06-01,-44,44,-88
"Ithaca, NY",27060.0,2020-07-01,-137,15,-152
"Ithaca, NY",27060.0,2020-08-01,33,0,33
"Ithaca, NY",27060.0,2020-09-01,38,17,21
"Ithaca, NY",27060.0,2020-10-01,-40,-37,-3
"Ithaca, NY",27060.0,2020-11-01,-56,-23,-33
"Ithaca, NY",27060.0,2020-12-01,-33,-11,-22
"Brevard, NC",14820.0,2019-01-01,-8,0,-8
"Brevard, NC",14820.0,2019-02-01,-11,0,-11
"Brevard, NC",14820.0,2019-03-01,9,0,9
"Brevard, NC",14820.0,2019-04-01,53,42,11
"Brevard, NC",14820.0,2019-05-01,170,182,-12
"Brevard, NC",14820.0,2019-06-01,57,68,-11
"Brevard, NC",14820.0,2019-07-01,9,24,-15
"Brevard, NC",14820.0,2019-08-01,27,0,27
"Brevard, NC",14820.0,2019-09-01,32,0,32
"Brevard, NC",14820.0,2019-10-01,-106,-101,-5
"Brevard, NC",14820.0,2019-11-01,-69,-39,-30
"Brevard, NC",14820.0,2019-12-01,-18,-11,-7
"Brevard, NC",14820.0,2020-01-01,13,0,13
"Brevard, NC",14820.0,2020-02-01,-21,0,-21
"Brevard, NC",14820.0,2020-03-01,-12,13,-25
"Brevard, NC",14820.0,2020-04-01,30,11,19
"Brevard, NC",14820.0,2020-05-01,98,92,6
"Brevard, NC",14820.0,2020-06-01,137,134,3
"Brevard, NC",14820.0,2020-07-01,6,12,-6
"Brevard, NC",14820.0,2020-08-01,-9,0,-9
"Brevard, NC",14820.0,2020-09-01,3,0,3
"Brevard, NC",14820.0,2020-10-01,-94,-80,-14
"Brevard, NC",14820.0,2020-11-01,-20,-35,15
"Brevard, NC",14820.0,2020-12-01,1,-18,19
"Visalia, CA",47300.0,2019-01-01,81,0,81
"Visalia, CA",47300.0,2019-02-01,63,0,63
"Visalia, CA",47300.0,2019-03-01,48,0,48
"Visalia, CA",47300.0,2019-04-01,90,0,90
"Visalia, CA",47300.0,2019-05-01,121,0,121
"Visalia, CA",47300.0,2019-06-01,49,0,49
"Visalia, CA",47300.0,2019-07-01,67,0,67
"Visalia, CA",47300.0,2019-08-01,119,-12,131
"Visalia, CA",47300.0,2019-09-01,140,0,140
"Visalia, CA",47300.0,2019-10-01,81,0,81
"Visalia, CA",47300.0,2019-11-01,65,0,65
"Visalia, CA",47300.0,2019-12-01,113,0,113
"Visalia, CA",47300.0,2020-01-01,143,0,143
"Visalia, CA",47300.0,2020-02-01,111,0,111
"Visalia, CA",47300.0,2020-03-01,74,11,63
"Visalia, CA",47300.0,2020-04-01,201,12,189
"Visalia, CA",47300.0,2020-05-01,174,-15,189
"Visalia, CA",47300.0,2020-06-01,106,0,106
"Visalia, CA",47300.0,2020-07-01,141,-12,153
"Visalia, CA",47300.0,2020-08-01,116,0,116
"Visalia, CA",47300.0,2020-09-01,121,-6,127
"Visalia, CA",47300.0,2020-10-01,111,0,111
"Visalia, CA",47300.0,2020-11-01,23,0,23
"Visalia, CA",47300.0,2020-12-01,68,0,68
"Sonora, CA",43760.0,2019-01-01,11,0,11
"Sonora, CA",43760.0,2019-02-01,26,0,26
"Sonora, CA",43760.0,2019-03-01,3,0,3
"Sonora, CA",43760.0,2019-04-01,33,0,33
"Sonora, CA",43760.0,2019-05-01,64,0,64
"Sonora, CA",43760.0,2019-06-01,48,0,48
"Sonora, CA",43760.0,2019-07-01,26,0,26
"Sonora, CA",43760.0,2019-08-01,4,0,4
"Sonora, CA",43760.0,2019-09-01,19,0,19
"Sonora, CA",43760.0,2019-10-01,57,0,57
"Sonora, CA",43760.0,2019-11-01,-1,0,-1
"Sonora, CA",43760.0,2019-12-01,14,0,14
"Sonora, CA",43760.0,2020-01-01,27,0,27
"Sonora, CA",43760.0,2020-02-01,28,0,28
"Sonora, CA",43760.0,2020-03-01,24,15,9
"Sonora, CA",43760.0,2020-04-01,84,0,84
"Sonora, CA",43760.0,2020-05-01,25,0,25
"Sonora, CA",43760.0,2020-06-01,33,0,33
"Sonora, CA",43760.0,2020-07-01,80,0,80
"Sonora, CA",43760.0,2020-08-01,58,0,58
"Sonora, CA",43760.0,2020-09-01,12,0,12
"Sonora, CA",43760.0,2020-10-01,99,0,99
"Sonora, CA",43760.0,2020-11-01,45,0,45
"Sonora, CA",43760.0,2020-12-01,76,0,76
"New Philadelphia-Dover, OH",35420.0,2019-01-01,-3,-16,13
"New Philadelphia-Dover, OH",35420.0,2019-02-01,-19,0,-19
"New Philadelphia-Dover, OH",35420.0,2019-03-01,13,0,13
"New Philadelphia-Dover, OH",35420.0,2019-04-01,24,0,24
"New Philadelphia-Dover, OH",35420.0,2019-05-01,-37,0,-37
"New Philadelphia-Dover, OH",35420.0,2019-06-01,16,0,16
"New Philadelphia-Dover, OH",35420.0,2019-07-01,-10,0,-10
"New Philadelphia-Dover, OH",35420.0,2019-08-01,-7,0,-7
"New Philadelphia-Dover, OH",35420.0,2019-09-01,10,0,10
"New Philadelphia-Dover, OH",35420.0,2019-10-01,-46,-16,-30
"New Philadelphia-Dover, OH",35420.0,2019-11-01,-26,-13,-13
"New Philadelphia-Dover, OH",35420.0,2019-12-01,-40,-15,-25
"New Philadelphia-Dover, OH",35420.0,2020-01-01,-60,-18,-42
"New Philadelphia-Dover, OH",35420.0,2020-02-01,-20,0,-20
"New Philadelphia-Dover, OH",35420.0,2020-03-01,-54,0,-54
"New Philadelphia-Dover, OH",35420.0,2020-04-01,-32,0,-32
"New Philadelphia-Dover, OH",35420.0,2020-05-01,11,0,11
"New Philadelphia-Dover, OH",35420.0,2020-06-01,-26,0,-26
"New Philadelphia-Dover, OH",35420.0,2020-07-01,7,0,7
"New Philadelphia-Dover, OH",35420.0,2020-08-01,3,0,3
"New Philadelphia-Dover, OH",35420.0,2020-09-01,-5,0,-5
"New Philadelphia-Dover, OH",35420.0,2020-10-01,46,-14,60
"New Philadelphia-Dover, OH",35420.0,2020-11-01,17,0,17
"New Philadelphia-Dover, OH",35420.0,2020-12-01,-10,-16,6
"Evanston, WY",21740.0,2019-01-01,0,0,0
"Evanston, WY",21740.0,2019-02-01,0,0,0
"Evanston, WY",21740.0,2019-03-01,11,0,11
"Evanston, WY",21740.0,2019-04-01,-12,0,-12
"Evanston, WY",21740.0,2019-05-01,0,0,0
"Evanston, WY",21740.0,2019-06-01,0,0,0
"Evanston, WY",21740.0,2019-07-01,0,0,0
"Evanston, WY",21740.0,2019-08-01,-3,0,-3
"Evanston, WY",21740.0,2019-09-01,12,0,12
"Evanston, WY",21740.0,2019-10-01,-18,-29,11
"Evanston, WY",21740.0,2019-11-01,0,0,0
"Evanston, WY",21740.0,2019-12-01,0,0,0
"Evanston, WY",21740.0,2020-01-01,0,0,0
"Evanston, WY",21740.0,2020-02-01,0,0,0
"Evanston, WY",21740.0,2020-03-01,0,0,0
"Evanston, WY",21740.0,2020-04-01,0,0,0
"Evanston, WY",21740.0,2020-05-01,0,0,0
"Evanston, WY",21740.0,2020-06-01,0,0,0
"Evanston, WY",21740.0,2020-07-01,0,0,0
"Evanston, WY",21740.0,2020-08-01,19,0,19
"Evanston, WY",21740.0,2020-09-01,0,0,0
"Evanston, WY",21740.0,2020-10-01,-14,-14,0
"Evanston, WY",21740.0,2020-11-01,-13,-13,0
"Evanston, WY",21740.0,2020-12-01,0,0,0
"Vernal, UT",46860.0,2019-01-01,17,0,17
"Vernal, UT",46860.0,2019-02-01,0,0,0
"Vernal, UT",46860.0,2019-03-01,4,0,4
"Vernal, UT",46860.0,2019-04-01,9,0,9
"Vernal, UT",46860.0,2019-05-01,17,0,17
"Vernal, UT",46860.0,2019-06-01,6,0,6
"Vernal, UT",46860.0,2019-07-01,1,0,1
"Vernal, UT",46860.0,2019-08-01,48,0,48
"Vernal, UT",46860.0,2019-09-01,10,0,10
"Vernal, UT",46860.0,2019-10-01,-13,0,-13
"Vernal, UT",46860.0,2019-11-01,-9,0,-9
"Vernal, UT",46860.0,2019-12-01,0,0,0
"Vernal, UT",46860.0,2020-01-01,1,0,1
"Vernal, UT",46860.0,2020-02-01,5,0,5
"Vernal, UT",46860.0,2020-03-01,-2,0,-2
"Vernal, UT",46860.0,2020-04-01,32,0,32
"Vernal, UT",46860.0,2020-05-01,20,0,20
"Vernal, UT",46860.0,2020-06-01,-11,0,-11
"Vernal, UT",46860.0,2020-07-01,26,0,26
"Vernal, UT",46860.0,2020-08-01,38,0,38
"Vernal, UT",46860.0,2020-09-01,27,0,27
"Vernal, UT",46860.0,2020-10-01,25,0,25
"Vernal, UT",46860.0,2020-11-01,-16,0,-16
"Vernal, UT",46860.0,2020-12-01,-7,0,-7
"Kingston, NY",28740.0,2019-01-01,-54,-119,65
"Kingston, NY",28740.0,2019-02-01,35,-13,48
"Kingston, NY",28740.0,2019-03-01,-22,-31,9
"Kingston, NY",28740.0,2019-04-01,210,125,85
"Kingston, NY",28740.0,2019-05-01,216,131,85
"Kingston, NY",28740.0,2019-06-01,144,48,96
"Kingston, NY",28740.0,2019-07-01,76,29,47
"Kingston, NY",28740.0,2019-08-01,32,0,32
"Kingston, NY",28740.0,2019-09-01,55,-17,72
"Kingston, NY",28740.0,2019-10-01,-67,-115,48
"Kingston, NY",28740.0,2019-11-01,-49,-97,48
"Kingston, NY",28740.0,2019-12-01,-186,-212,26
"Kingston, NY",28740.0,2020-01-01,-41,-118,77
"Kingston, NY",28740.0,2020-02-01,19,0,19
"Kingston, NY",28740.0,2020-03-01,1069,909,160
"Kingston, NY",28740.0,2020-04-01,871,659,212
"Kingston, NY",28740.0,2020-05-01,685,454,231
"Kingston, NY",28740.0,2020-06-01,667,398,269
"Kingston, NY",28740.0,2020-07-01,496,219,277
"Kingston, NY",28740.0,2020-08-01,445,102,343
"Kingston, NY",28740.0,2020-09-01,386,138,248
"Kingston, NY",28740.0,2020-10-01,216,81,135
"Kingston, NY",28740.0,2020-11-01,252,74,178
"Kingston, NY",28740.0,2020-12-01,248,71,177
"El Dorado, AR",20980.0,2019-01-01,-12,0,-12
"El Dorado, AR",20980.0,2019-02-01,-1,0,-1
"El Dorado, AR",20980.0,2019-03-01,-47,0,-47
"El Dorado, AR",20980.0,2019-04-01,0,0,0
"El Dorado, AR",20980.0,2019-05-01,0,0,0
"El Dorado, AR",20980.0,2019-06-01,0,0,0
"El Dorado, AR",20980.0,2019-07-01,12,0,12
"El Dorado, AR",20980.0,2019-08-01,0,0,0
"El Dorado, AR",20980.0,2019-09-01,0,0,0
"El Dorado, AR",20980.0,2019-10-01,0,0,0
"El Dorado, AR",20980.0,2019-11-01,0,0,0
"El Dorado, AR",20980.0,2019-12-01,0,0,0
"El Dorado, AR",20980.0,2020-01-01,14,0,14
"El Dorado, AR",20980.0,2020-02-01,0,0,0
"El Dorado, AR",20980.0,2020-03-01,12,0,12
"El Dorado, AR",20980.0,2020-04-01,-3,0,-3
"El Dorado, AR",20980.0,2020-05-01,15,0,15
"El Dorado, AR",20980.0,2020-06-01,0,0,0
"El Dorado, AR",20980.0,2020-07-01,-27,0,-27
"El Dorado, AR",20980.0,2020-08-01,0,0,0
"El Dorado, AR",20980.0,2020-09-01,0,0,0
"El Dorado, AR",20980.0,2020-10-01,0,0,0
"El Dorado, AR",20980.0,2020-11-01,0,0,0
"El Dorado, AR",20980.0,2020-12-01,0,0,0
"La Grande, OR",29260.0,2019-01-01,0,0,0
"La Grande, OR",29260.0,2019-02-01,0,0,0
"La Grande, OR",29260.0,2019-03-01,-27,0,-27
"La Grande, OR",29260.0,2019-04-01,-26,0,-26
"La Grande, OR",29260.0,2019-05-01,0,0,0
"La Grande, OR",29260.0,2019-06-01,-21,0,-21
"La Grande, OR",29260.0,2019-07-01,17,0,17
"La Grande, OR",29260.0,2019-08-01,-3,0,-3
"La Grande, OR",29260.0,2019-09-01,-11,0,-11
"La Grande, OR",29260.0,2019-10-01,-31,-16,-15
"La Grande, OR",29260.0,2019-11-01,-12,-12,0
"La Grande, OR",29260.0,2019-12-01,0,0,0
"La Grande, OR",29260.0,2020-01-01,0,0,0
"La Grande, OR",29260.0,2020-02-01,11,0,11
"La Grande, OR",29260.0,2020-03-01,0,0,0
"La Grande, OR",29260.0,2020-04-01,0,0,0
"La Grande, OR",29260.0,2020-05-01,0,0,0
"La Grande, OR",29260.0,2020-06-01,0,0,0
"La Grande, OR",29260.0,2020-07-01,-15,0,-15
"La Grande, OR",29260.0,2020-08-01,21,0,21
"La Grande, OR",29260.0,2020-09-01,0,0,0
"La Grande, OR",29260.0,2020-10-01,-14,-14,0
"La Grande, OR",29260.0,2020-11-01,-11,0,-11
"La Grande, OR",29260.0,2020-12-01,0,0,0
"Lewisburg, PA",30260.0,2019-01-01,-55,0,-55
"Lewisburg, PA",30260.0,2019-02-01,-15,0,-15
"Lewisburg, PA",30260.0,2019-03-01,2,0,2
"Lewisburg, PA",30260.0,2019-04-01,4,0,4
"Lewisburg, PA",30260.0,2019-05-01,17,0,17
"Lewisburg, PA",30260.0,2019-06-01,5,0,5
"Lewisburg, PA",30260.0,2019-07-01,28,0,28
"Lewisburg, PA",30260.0,2019-08-01,-16,0,-16
"Lewisburg, PA",30260.0,2019-09-01,10,0,10
"Lewisburg, PA",30260.0,2019-10-01,-2,0,-2
"Lewisburg, PA",30260.0,2019-11-01,15,0,15
"Lewisburg, PA",30260.0,2019-12-01,-6,0,-6
"Lewisburg, PA",30260.0,2020-01-01,-13,0,-13
"Lewisburg, PA",30260.0,2020-02-01,5,0,5
"Lewisburg, PA",30260.0,2020-03-01,14,0,14
"Lewisburg, PA",30260.0,2020-04-01,-16,0,-16
"Lewisburg, PA",30260.0,2020-05-01,3,0,3
"Lewisburg, PA",30260.0,2020-06-01,-14,0,-14
"Lewisburg, PA",30260.0,2020-07-01,13,0,13
"Lewisburg, PA",30260.0,2020-08-01,-5,0,-5
"Lewisburg, PA",30260.0,2020-09-01,-30,0,-30
"Lewisburg, PA",30260.0,2020-10-01,-14,0,-14
"Lewisburg, PA",30260.0,2020-11-01,14,0,14
"Lewisburg, PA",30260.0,2020-12-01,17,0,17
"Union, SC",46420.0,2019-01-01,0,0,0
"Union, SC",46420.0,2019-02-01,-11,0,-11
"Union, SC",46420.0,2019-03-01,6,0,6
"Union, SC",46420.0,2019-04-01,-14,0,-14
"Union, SC",46420.0,2019-05-01,-9,0,-9
"Union, SC",46420.0,2019-06-01,-2,0,-2
"Union, SC",46420.0,2019-07-01,4,0,4
"Union, SC",46420.0,2019-08-01,-20,0,-20
"Union, SC",46420.0,2019-09-01,1,0,1
"Union, SC",46420.0,2019-10-01,0,0,0
"Union, SC",46420.0,2019-11-01,-8,0,-8
"Union, SC",46420.0,2019-12-01,-11,0,-11
"Union, SC",46420.0,2020-01-01,3,0,3
"Union, SC",46420.0,2020-02-01,-16,0,-16
"Union, SC",46420.0,2020-03-01,-10,0,-10
"Union, SC",46420.0,2020-04-01,0,0,0
"Union, SC",46420.0,2020-05-01,-3,0,-3
"Union, SC",46420.0,2020-06-01,13,0,13
"Union, SC",46420.0,2020-07-01,9,0,9
"Union, SC",46420.0,2020-08-01,4,0,4
"Union, SC",46420.0,2020-09-01,21,0,21
"Union, SC",46420.0,2020-10-01,-2,0,-2
"Union, SC",46420.0,2020-11-01,1,0,1
"Union, SC",46420.0,2020-12-01,-19,0,-19
"Thomaston, GA",45580.0,2019-01-01,0,0,0
"Thomaston, GA",45580.0,2019-02-01,13,0,13
"Thomaston, GA",45580.0,2019-03-01,30,0,30
"Thomaston, GA",45580.0,2019-04-01,0,0,0
"Thomaston, GA",45580.0,2019-05-01,-3,0,-3
"Thomaston, GA",45580.0,2019-06-01,0,0,0
"Thomaston, GA",45580.0,2019-07-01,-9,0,-9
"Thomaston, GA",45580.0,2019-08-01,0,0,0
"Thomaston, GA",45580.0,2019-09-01,12,0,12
"Thomaston, GA",45580.0,2019-10-01,14,0,14
"Thomaston, GA",45580.0,2019-11-01,0,0,0
"Thomaston, GA",45580.0,2019-12-01,0,0,0
"Thomaston, GA",45580.0,2020-01-01,24,0,24
"Thomaston, GA",45580.0,2020-02-01,0,0,0
"Thomaston, GA",45580.0,2020-03-01,26,0,26
"Thomaston, GA",45580.0,2020-04-01,-11,0,-11
"Thomaston, GA",45580.0,2020-05-01,-2,0,-2
"Thomaston, GA",45580.0,2020-06-01,0,0,0
"Thomaston, GA",45580.0,2020-07-01,13,0,13
"Thomaston, GA",45580.0,2020-08-01,-15,0,-15
"Thomaston, GA",45580.0,2020-09-01,-17,0,-17
"Thomaston, GA",45580.0,2020-10-01,0,0,0
"Thomaston, GA",45580.0,2020-11-01,28,0,28
"Thomaston, GA",45580.0,2020-12-01,23,0,23
"Uvalde, TX",46620.0,2019-01-01,0,0,0
"Uvalde, TX",46620.0,2019-02-01,-14,0,-14
"Uvalde, TX",46620.0,2019-03-01,-17,0,-17
"Uvalde, TX",46620.0,2019-04-01,0,0,0
"Uvalde, TX",46620.0,2019-05-01,0,0,0
"Uvalde, TX",46620.0,2019-06-01,-17,0,-17
"Uvalde, TX",46620.0,2019-07-01,-7,0,-7
"Uvalde, TX",46620.0,2019-08-01,-12,0,-12
"Uvalde, TX",46620.0,2019-09-01,0,0,0
"Uvalde, TX",46620.0,2019-10-01,13,0,13
"Uvalde, TX",46620.0,2019-11-01,-12,0,-12
"Uvalde, TX",46620.0,2019-12-01,11,0,11
"Uvalde, TX",46620.0,2020-01-01,11,0,11
"Uvalde, TX",46620.0,2020-02-01,0,0,0
"Uvalde, TX",46620.0,2020-03-01,-14,0,-14
"Uvalde, TX",46620.0,2020-04-01,17,0,17
"Uvalde, TX",46620.0,2020-05-01,-14,0,-14
"Uvalde, TX",46620.0,2020-06-01,-11,0,-11
"Uvalde, TX",46620.0,2020-07-01,0,0,0
"Uvalde, TX",46620.0,2020-08-01,12,0,12
"Uvalde, TX",46620.0,2020-09-01,11,0,11
"Uvalde, TX",46620.0,2020-10-01,11,0,11
"Uvalde, TX",46620.0,2020-11-01,-11,0,-11
"Uvalde, TX",46620.0,2020-12-01,0,0,0
"Del Rio, TX",19620.0,2019-01-01,-14,0,-14
"Del Rio, TX",19620.0,2019-02-01,11,0,11
"Del Rio, TX",19620.0,2019-03-01,12,0,12
"Del Rio, TX",19620.0,2019-04-01,0,0,0
"Del Rio, TX",19620.0,2019-05-01,9,0,9
"Del Rio, TX",19620.0,2019-06-01,-5,0,-5
"Del Rio, TX",19620.0,2019-07-01,-4,0,-4
"Del Rio, TX",19620.0,2019-08-01,-10,0,-10
"Del Rio, TX",19620.0,2019-09-01,4,0,4
"Del Rio, TX",19620.0,2019-10-01,0,0,0
"Del Rio, TX",19620.0,2019-11-01,0,0,0
"Del Rio, TX",19620.0,2019-12-01,2,0,2
"Del Rio, TX",19620.0,2020-01-01,1,0,1
"Del Rio, TX",19620.0,2020-02-01,11,0,11
"Del Rio, TX",19620.0,2020-03-01,-4,0,-4
"Del Rio, TX",19620.0,2020-04-01,12,0,12
"Del Rio, TX",19620.0,2020-05-01,4,0,4
"Del Rio, TX",19620.0,2020-06-01,-2,0,-2
"Del Rio, TX",19620.0,2020-07-01,-6,0,-6
"Del Rio, TX",19620.0,2020-08-01,-12,0,-12
"Del Rio, TX",19620.0,2020-09-01,0,0,0
"Del Rio, TX",19620.0,2020-10-01,-2,0,-2
"Del Rio, TX",19620.0,2020-11-01,11,0,11
"Del Rio, TX",19620.0,2020-12-01,2,0,2
"Van Wert, OH",46780.0,2019-01-01,14,0,14
"Van Wert, OH",46780.0,2019-02-01,0,0,0
"Van Wert, OH",46780.0,2019-03-01,0,0,0
"Van Wert, OH",46780.0,2019-04-01,-13,0,-13
"Van Wert, OH",46780.0,2019-05-01,0,0,0
"Van Wert, OH",46780.0,2019-06-01,-1,0,-1
"Van Wert, OH",46780.0,2019-07-01,35,0,35
"Van Wert, OH",46780.0,2019-08-01,13,0,13
"Van Wert, OH",46780.0,2019-09-01,0,0,0
"Van Wert, OH",46780.0,2019-10-01,14,0,14
"Van Wert, OH",46780.0,2019-11-01,-11,0,-11
"Van Wert, OH",46780.0,2019-12-01,-11,0,-11
"Van Wert, OH",46780.0,2020-01-01,-8,0,-8
"Van Wert, OH",46780.0,2020-02-01,0,0,0
"Van Wert, OH",46780.0,2020-03-01,0,0,0
"Van Wert, OH",46780.0,2020-04-01,0,0,0
"Van Wert, OH",46780.0,2020-05-01,0,0,0
"Van Wert, OH",46780.0,2020-06-01,23,0,23
"Van Wert, OH",46780.0,2020-07-01,-13,0,-13
"Van Wert, OH",46780.0,2020-08-01,14,0,14
"Van Wert, OH",46780.0,2020-09-01,-14,0,-14
"Van Wert, OH",46780.0,2020-10-01,0,0,0
"Van Wert, OH",46780.0,2020-11-01,0,0,0
"Van Wert, OH",46780.0,2020-12-01,6,0,6
"Henderson, NC",25780.0,2019-01-01,27,0,27
"Henderson, NC",25780.0,2019-02-01,8,0,8
"Henderson, NC",25780.0,2019-03-01,-70,0,-70
"Henderson, NC",25780.0,2019-04-01,-25,0,-25
"Henderson, NC",25780.0,2019-05-01,11,0,11
"Henderson, NC",25780.0,2019-06-01,-9,0,-9
"Henderson, NC",25780.0,2019-07-01,51,0,51
"Henderson, NC",25780.0,2019-08-01,40,0,40
"Henderson, NC",25780.0,2019-09-01,34,0,34
"Henderson, NC",25780.0,2019-10-01,-33,0,-33
"Henderson, NC",25780.0,2019-11-01,-13,0,-13
"Henderson, NC",25780.0,2019-12-01,36,0,36
"Henderson, NC",25780.0,2020-01-01,-14,0,-14
"Henderson, NC",25780.0,2020-02-01,2,0,2
"Henderson, NC",25780.0,2020-03-01,14,0,14
"Henderson, NC",25780.0,2020-04-01,63,0,63
"Henderson, NC",25780.0,2020-05-01,41,0,41
"Henderson, NC",25780.0,2020-06-01,11,0,11
"Henderson, NC",25780.0,2020-07-01,-17,0,-17
"Henderson, NC",25780.0,2020-08-01,45,0,45
"Henderson, NC",25780.0,2020-09-01,14,0,14
"Henderson, NC",25780.0,2020-10-01,26,0,26
"Henderson, NC",25780.0,2020-11-01,-9,0,-9
"Henderson, NC",25780.0,2020-12-01,-10,0,-10
"Oil City, PA",36340.0,2019-01-01,-21,0,-21
"Oil City, PA",36340.0,2019-02-01,-21,0,-21
"Oil City, PA",36340.0,2019-03-01,44,0,44
"Oil City, PA",36340.0,2019-04-01,25,11,14
"Oil City, PA",36340.0,2019-05-01,4,0,4
"Oil City, PA",36340.0,2019-06-01,44,0,44
"Oil City, PA",36340.0,2019-07-01,14,0,14
"Oil City, PA",36340.0,2019-08-01,-31,0,-31
"Oil City, PA",36340.0,2019-09-01,46,0,46
"Oil City, PA",36340.0,2019-10-01,-8,0,-8
"Oil City, PA",36340.0,2019-11-01,20,0,20
"Oil City, PA",36340.0,2019-12-01,-24,0,-24
"Oil City, PA",36340.0,2020-01-01,-26,0,-26
"Oil City, PA",36340.0,2020-02-01,14,0,14
"Oil City, PA",36340.0,2020-03-01,9,0,9
"Oil City, PA",36340.0,2020-04-01,-26,0,-26
"Oil City, PA",36340.0,2020-05-01,-20,0,-20
"Oil City, PA",36340.0,2020-06-01,-5,0,-5
"Oil City, PA",36340.0,2020-07-01,12,0,12
"Oil City, PA",36340.0,2020-08-01,11,0,11
"Oil City, PA",36340.0,2020-09-01,26,0,26
"Oil City, PA",36340.0,2020-10-01,23,0,23
"Oil City, PA",36340.0,2020-11-01,-8,0,-8
"Oil City, PA",36340.0,2020-12-01,7,0,7
"Oxnard-Thousand Oaks-Ventura, CA",37100.0,2019-01-01,141,25,116
"Oxnard-Thousand Oaks-Ventura, CA",37100.0,2019-02-01,135,12,123
"Oxnard-Thousand Oaks-Ventura, CA",37100.0,2019-03-01,178,-1,179
"Oxnard-Thousand Oaks-Ventura, CA",37100.0,2019-04-01,242,-12,254
"Oxnard-Thousand Oaks-Ventura, CA",37100.0,2019-05-01,236,39,197
"Oxnard-Thousand Oaks-Ventura, CA",37100.0,2019-06-01,239,34,205
"Oxnard-Thousand Oaks-Ventura, CA",37100.0,2019-07-01,348,13,335
"Oxnard-Thousand Oaks-Ventura, CA",37100.0,2019-08-01,156,28,128
"Oxnard-Thousand Oaks-Ventura, CA",37100.0,2019-09-01,165,-1,166
"Oxnard-Thousand Oaks-Ventura, CA",37100.0,2019-10-01,194,-2,196
"Oxnard-Thousand Oaks-Ventura, CA",37100.0,2019-11-01,162,-8,170
"Oxnard-Thousand Oaks-Ventura, CA",37100.0,2019-12-01,156,-3,159
"Oxnard-Thousand Oaks-Ventura, CA",37100.0,2020-01-01,34,23,11
"Oxnard-Thousand Oaks-Ventura, CA",37100.0,2020-02-01,143,18,125
"Oxnard-Thousand Oaks-Ventura, CA",37100.0,2020-03-01,666,291,375
"Oxnard-Thousand Oaks-Ventura, CA",37100.0,2020-04-01,388,115,273
"Oxnard-Thousand Oaks-Ventura, CA",37100.0,2020-05-01,493,124,369
"Oxnard-Thousand Oaks-Ventura, CA",37100.0,2020-06-01,500,55,445
"Oxnard-Thousand Oaks-Ventura, CA",37100.0,2020-07-01,241,36,205
"Oxnard-Thousand Oaks-Ventura, CA",37100.0,2020-08-01,473,11,462
"Oxnard-Thousand Oaks-Ventura, CA",37100.0,2020-09-01,376,31,345
"Oxnard-Thousand Oaks-Ventura, CA",37100.0,2020-10-01,276,-7,283
"Oxnard-Thousand Oaks-Ventura, CA",37100.0,2020-11-01,389,36,353
"Oxnard-Thousand Oaks-Ventura, CA",37100.0,2020-12-01,499,38,461
"Danville, IL",19180.0,2019-01-01,-43,0,-43
"Danville, IL",19180.0,2019-02-01,14,0,14
"Danville, IL",19180.0,2019-03-01,-5,0,-5
"Danville, IL",19180.0,2019-04-01,-12,11,-23
"Danville, IL",19180.0,2019-05-01,-4,0,-4
"Danville, IL",19180.0,2019-06-01,-30,0,-30
"Danville, IL",19180.0,2019-07-01,-22,0,-22
"Danville, IL",19180.0,2019-08-01,-31,0,-31
"Danville, IL",19180.0,2019-09-01,-42,0,-42
"Danville, IL",19180.0,2019-10-01,-24,-11,-13
"Danville, IL",19180.0,2019-11-01,-5,0,-5
"Danville, IL",19180.0,2019-12-01,4,0,4
"Danville, IL",19180.0,2020-01-01,-25,0,-25
"Danville, IL",19180.0,2020-02-01,-58,0,-58
"Danville, IL",19180.0,2020-03-01,-24,0,-24
"Danville, IL",19180.0,2020-04-01,11,0,11
"Danville, IL",19180.0,2020-05-01,-10,0,-10
"Danville, IL",19180.0,2020-06-01,32,0,32
"Danville, IL",19180.0,2020-07-01,-48,0,-48
"Danville, IL",19180.0,2020-08-01,31,0,31
"Danville, IL",19180.0,2020-09-01,-41,0,-41
"Danville, IL",19180.0,2020-10-01,0,0,0
"Danville, IL",19180.0,2020-11-01,-1,0,-1
"Danville, IL",19180.0,2020-12-01,5,0,5
"Fort Polk South, LA",22860.0,2019-01-01,-5,0,-5
"Fort Polk South, LA",22860.0,2019-02-01,11,0,11
"Fort Polk South, LA",22860.0,2019-03-01,-5,0,-5
"Fort Polk South, LA",22860.0,2019-04-01,-32,0,-32
"Fort Polk South, LA",22860.0,2019-05-01,-41,0,-41
"Fort Polk South, LA",22860.0,2019-06-01,18,0,18
"Fort Polk South, LA",22860.0,2019-07-01,-25,0,-25
"Fort Polk South, LA",22860.0,2019-08-01,11,0,11
"Fort Polk South, LA",22860.0,2019-09-01,32,0,32
"Fort Polk South, LA",22860.0,2019-10-01,-1,0,-1
"Fort Polk South, LA",22860.0,2019-11-01,-27,0,-27
"Fort Polk South, LA",22860.0,2019-12-01,-3,0,-3
"Fort Polk South, LA",22860.0,2020-01-01,3,0,3
"Fort Polk South, LA",22860.0,2020-02-01,-3,0,-3
"Fort Polk South, LA",22860.0,2020-03-01,-13,0,-13
"Fort Polk South, LA",22860.0,2020-04-01,-1,0,-1
"Fort Polk South, LA",22860.0,2020-05-01,-3,0,-3
"Fort Polk South, LA",22860.0,2020-06-01,4,0,4
"Fort Polk South, LA",22860.0,2020-07-01,-9,0,-9
"Fort Polk South, LA",22860.0,2020-08-01,-7,0,-7
"Fort Polk South, LA",22860.0,2020-09-01,1,0,1
"Fort Polk South, LA",22860.0,2020-10-01,38,0,38
"Fort Polk South, LA",22860.0,2020-11-01,7,0,7
"Fort Polk South, LA",22860.0,2020-12-01,18,0,18
"Wabash, IN",47340.0,2019-01-01,-21,0,-21
"Wabash, IN",47340.0,2019-02-01,23,0,23
"Wabash, IN",47340.0,2019-03-01,-27,0,-27
"Wabash, IN",47340.0,2019-04-01,-3,0,-3
"Wabash, IN",47340.0,2019-05-01,0,0,0
"Wabash, IN",47340.0,2019-06-01,40,0,40
"Wabash, IN",47340.0,2019-07-01,-62,0,-62
"Wabash, IN",47340.0,2019-08-01,15,0,15
"Wabash, IN",47340.0,2019-09-01,-16,0,-16
"Wabash, IN",47340.0,2019-10-01,12,0,12
"Wabash, IN",47340.0,2019-11-01,11,0,11
"Wabash, IN",47340.0,2019-12-01,-4,0,-4
"Wabash, IN",47340.0,2020-01-01,-23,0,-23
"Wabash, IN",47340.0,2020-02-01,0,0,0
"Wabash, IN",47340.0,2020-03-01,-28,0,-28
"Wabash, IN",47340.0,2020-04-01,0,0,0
"Wabash, IN",47340.0,2020-05-01,-10,0,-10
"Wabash, IN",47340.0,2020-06-01,-11,0,-11
"Wabash, IN",47340.0,2020-07-01,-20,0,-20
"Wabash, IN",47340.0,2020-08-01,-9,0,-9
"Wabash, IN",47340.0,2020-09-01,-52,0,-52
"Wabash, IN",47340.0,2020-10-01,20,0,20
"Wabash, IN",47340.0,2020-11-01,4,0,4
"Wabash, IN",47340.0,2020-12-01,16,0,16
"Jasper, AL",27530.0,2019-01-01,47,0,47
"Jasper, AL",27530.0,2019-02-01,6,0,6
"Jasper, AL",27530.0,2019-03-01,18,0,18
"Jasper, AL",27530.0,2019-04-01,1,0,1
"Jasper, AL",27530.0,2019-05-01,22,0,22
"Jasper, AL",27530.0,2019-06-01,12,0,12
"Jasper, AL",27530.0,2019-07-01,-3,0,-3
"Jasper, AL",27530.0,2019-08-01,9,0,9
"Jasper, AL",27530.0,2019-09-01,21,0,21
"Jasper, AL",27530.0,2019-10-01,6,0,6
"Jasper, AL",27530.0,2019-11-01,24,0,24
"Jasper, AL",27530.0,2019-12-01,-19,0,-19
"Jasper, AL",27530.0,2020-01-01,-15,0,-15
"Jasper, AL",27530.0,2020-02-01,-25,0,-25
"Jasper, AL",27530.0,2020-03-01,26,0,26
"Jasper, AL",27530.0,2020-04-01,-10,0,-10
"Jasper, AL",27530.0,2020-05-01,21,0,21
"Jasper, AL",27530.0,2020-06-01,5,0,5
"Jasper, AL",27530.0,2020-07-01,20,0,20
"Jasper, AL",27530.0,2020-08-01,-20,0,-20
"Jasper, AL",27530.0,2020-09-01,-1,0,-1
"Jasper, AL",27530.0,2020-10-01,-10,0,-10
"Jasper, AL",27530.0,2020-11-01,-21,0,-21
"Jasper, AL",27530.0,2020-12-01,-1,0,-1
"Huntsville, TX",26660.0,2019-01-01,-7,0,-7
"Huntsville, TX",26660.0,2019-02-01,0,0,0
"Huntsville, TX",26660.0,2019-03-01,43,0,43
"Huntsville, TX",26660.0,2019-04-01,-19,0,-19
"Huntsville, TX",26660.0,2019-05-01,-15,0,-15
"Huntsville, TX",26660.0,2019-06-01,-57,0,-57
"Huntsville, TX",26660.0,2019-07-01,-58,0,-58
"Huntsville, TX",26660.0,2019-08-01,4,0,4
"Huntsville, TX",26660.0,2019-09-01,4,0,4
"Huntsville, TX",26660.0,2019-10-01,8,0,8
"Huntsville, TX",26660.0,2019-11-01,20,0,20
"Huntsville, TX",26660.0,2019-12-01,-14,0,-14
"Huntsville, TX",26660.0,2020-01-01,19,0,19
"Huntsville, TX",26660.0,2020-02-01,13,0,13
"Huntsville, TX",26660.0,2020-03-01,23,0,23
"Huntsville, TX",26660.0,2020-04-01,-5,0,-5
"Huntsville, TX",26660.0,2020-05-01,21,0,21
"Huntsville, TX",26660.0,2020-06-01,-7,0,-7
"Huntsville, TX",26660.0,2020-07-01,-102,0,-102
"Huntsville, TX",26660.0,2020-08-01,40,0,40
"Huntsville, TX",26660.0,2020-09-01,8,0,8
"Huntsville, TX",26660.0,2020-10-01,37,0,37
"Huntsville, TX",26660.0,2020-11-01,37,0,37
"Huntsville, TX",26660.0,2020-12-01,23,0,23
"Walla Walla, WA",47460.0,2019-01-01,5,0,5
"Walla Walla, WA",47460.0,2019-02-01,-12,0,-12
"Walla Walla, WA",47460.0,2019-03-01,-7,0,-7
"Walla Walla, WA",47460.0,2019-04-01,-1,0,-1
"Walla Walla, WA",47460.0,2019-05-01,-13,0,-13
"Walla Walla, WA",47460.0,2019-06-01,28,0,28
"Walla Walla, WA",47460.0,2019-07-01,19,0,19
"Walla Walla, WA",47460.0,2019-08-01,-56,0,-56
"Walla Walla, WA",47460.0,2019-09-01,38,0,38
"Walla Walla, WA",47460.0,2019-10-01,-26,-12,-14
"Walla Walla, WA",47460.0,2019-11-01,-18,-13,-5
"Walla Walla, WA",47460.0,2019-12-01,-3,0,-3
"Walla Walla, WA",47460.0,2020-01-01,42,0,42
"Walla Walla, WA",47460.0,2020-02-01,20,0,20
"Walla Walla, WA",47460.0,2020-03-01,0,0,0
"Walla Walla, WA",47460.0,2020-04-01,-9,0,-9
"Walla Walla, WA",47460.0,2020-05-01,-8,0,-8
"Walla Walla, WA",47460.0,2020-06-01,4,0,4
"Walla Walla, WA",47460.0,2020-07-01,0,0,0
"Walla Walla, WA",47460.0,2020-08-01,-14,0,-14
"Walla Walla, WA",47460.0,2020-09-01,21,0,21
"Walla Walla, WA",47460.0,2020-10-01,-10,-13,3
"Walla Walla, WA",47460.0,2020-11-01,-30,0,-30
"Walla Walla, WA",47460.0,2020-12-01,-10,0,-10
"Whitewater, WI",48580.0,2019-01-01,-124,-142,18
"Whitewater, WI",48580.0,2019-02-01,-5,-14,9
"Whitewater, WI",48580.0,2019-03-01,20,-12,32
"Whitewater, WI",48580.0,2019-04-01,240,130,110
"Whitewater, WI",48580.0,2019-05-01,317,349,-32
"Whitewater, WI",48580.0,2019-06-01,132,81,51
"Whitewater, WI",48580.0,2019-07-01,77,14,63
"Whitewater, WI",48580.0,2019-08-01,52,0,52
"Whitewater, WI",48580.0,2019-09-01,15,-11,26
"Whitewater, WI",48580.0,2019-10-01,-237,-256,19
"Whitewater, WI",48580.0,2019-11-01,-83,-112,29
"Whitewater, WI",48580.0,2019-12-01,-94,-135,41
"Whitewater, WI",48580.0,2020-01-01,-93,-140,47
"Whitewater, WI",48580.0,2020-02-01,25,0,25
"Whitewater, WI",48580.0,2020-03-01,77,64,13
"Whitewater, WI",48580.0,2020-04-01,235,128,107
"Whitewater, WI",48580.0,2020-05-01,184,267,-83
"Whitewater, WI",48580.0,2020-06-01,261,164,97
"Whitewater, WI",48580.0,2020-07-01,197,30,167
"Whitewater, WI",48580.0,2020-08-01,115,0,115
"Whitewater, WI",48580.0,2020-09-01,29,-14,43
"Whitewater, WI",48580.0,2020-10-01,-321,-332,11
"Whitewater, WI",48580.0,2020-11-01,31,-93,124
"Whitewater, WI",48580.0,2020-12-01,-47,-100,53
"Ottumwa, IA",36900.0,2019-01-01,27,0,27
"Ottumwa, IA",36900.0,2019-02-01,-35,0,-35
"Ottumwa, IA",36900.0,2019-03-01,-10,0,-10
"Ottumwa, IA",36900.0,2019-04-01,-2,0,-2
"Ottumwa, IA",36900.0,2019-05-01,-6,0,-6
"Ottumwa, IA",36900.0,2019-06-01,-13,0,-13
"Ottumwa, IA",36900.0,2019-07-01,3,0,3
"Ottumwa, IA",36900.0,2019-08-01,-41,0,-41
"Ottumwa, IA",36900.0,2019-09-01,-13,0,-13
"Ottumwa, IA",36900.0,2019-10-01,-28,0,-28
"Ottumwa, IA",36900.0,2019-11-01,-25,-11,-14
"Ottumwa, IA",36900.0,2019-12-01,13,0,13
"Ottumwa, IA",36900.0,2020-01-01,0,0,0
"Ottumwa, IA",36900.0,2020-02-01,0,0,0
"Ottumwa, IA",36900.0,2020-03-01,-32,0,-32
"Ottumwa, IA",36900.0,2020-04-01,-4,0,-4
"Ottumwa, IA",36900.0,2020-05-01,12,0,12
"Ottumwa, IA",36900.0,2020-06-01,-24,0,-24
"Ottumwa, IA",36900.0,2020-07-01,-7,0,-7
"Ottumwa, IA",36900.0,2020-08-01,-33,0,-33
"Ottumwa, IA",36900.0,2020-09-01,-29,0,-29
"Ottumwa, IA",36900.0,2020-10-01,-28,0,-28
"Ottumwa, IA",36900.0,2020-11-01,-15,0,-15
"Ottumwa, IA",36900.0,2020-12-01,-5,0,-5
"Minot, ND",33500.0,2019-01-01,14,-21,35
"Minot, ND",33500.0,2019-02-01,14,0,14
"Minot, ND",33500.0,2019-03-01,32,0,32
"Minot, ND",33500.0,2019-04-01,138,60,78
"Minot, ND",33500.0,2019-05-01,84,47,37
"Minot, ND",33500.0,2019-06-01,-18,0,-18
"Minot, ND",33500.0,2019-07-01,40,0,40
"Minot, ND",33500.0,2019-08-01,7,0,7
"Minot, ND",33500.0,2019-09-01,6,0,6
"Minot, ND",33500.0,2019-10-01,-106,-103,-3
"Minot, ND",33500.0,2019-11-01,-24,-50,26
"Minot, ND",33500.0,2019-12-01,-42,-42,0
"Minot, ND",33500.0,2020-01-01,-29,-42,13
"Minot, ND",33500.0,2020-02-01,16,0,16
"Minot, ND",33500.0,2020-03-01,73,15,58
"Minot, ND",33500.0,2020-04-01,91,29,62
"Minot, ND",33500.0,2020-05-01,77,39,38
"Minot, ND",33500.0,2020-06-01,27,0,27
"Minot, ND",33500.0,2020-07-01,-5,0,-5
"Minot, ND",33500.0,2020-08-01,35,0,35
"Minot, ND",33500.0,2020-09-01,32,0,32
"Minot, ND",33500.0,2020-10-01,-84,-84,0
"Minot, ND",33500.0,2020-11-01,-80,-68,-12
"Minot, ND",33500.0,2020-12-01,2,-32,34
"Vicksburg, MS",46980.0,2019-01-01,-12,0,-12
"Vicksburg, MS",46980.0,2019-02-01,-23,0,-23
"Vicksburg, MS",46980.0,2019-03-01,-2,0,-2
"Vicksburg, MS",46980.0,2019-04-01,-2,0,-2
"Vicksburg, MS",46980.0,2019-05-01,8,0,8
"Vicksburg, MS",46980.0,2019-06-01,-17,0,-17
"Vicksburg, MS",46980.0,2019-07-01,16,0,16
"Vicksburg, MS",46980.0,2019-08-01,-7,0,-7
"Vicksburg, MS",46980.0,2019-09-01,0,0,0
"Vicksburg, MS",46980.0,2019-10-01,-3,0,-3
"Vicksburg, MS",46980.0,2019-11-01,-5,0,-5
"Vicksburg, MS",46980.0,2019-12-01,-8,0,-8
"Vicksburg, MS",46980.0,2020-01-01,11,0,11
"Vicksburg, MS",46980.0,2020-02-01,-2,0,-2
"Vicksburg, MS",46980.0,2020-03-01,-13,0,-13
"Vicksburg, MS",46980.0,2020-04-01,-12,0,-12
"Vicksburg, MS",46980.0,2020-05-01,15,0,15
"Vicksburg, MS",46980.0,2020-06-01,18,0,18
"Vicksburg, MS",46980.0,2020-07-01,-16,0,-16
"Vicksburg, MS",46980.0,2020-08-01,-13,0,-13
"Vicksburg, MS",46980.0,2020-09-01,0,0,0
"Vicksburg, MS",46980.0,2020-10-01,13,0,13
"Vicksburg, MS",46980.0,2020-11-01,-11,0,-11
"Vicksburg, MS",46980.0,2020-12-01,1,0,1
"Glens Falls, NY",24020.0,2019-01-01,-119,-133,14
"Glens Falls, NY",24020.0,2019-02-01,-13,0,-13
"Glens Falls, NY",24020.0,2019-03-01,-4,0,-4
"Glens Falls, NY",24020.0,2019-04-01,187,174,13
"Glens Falls, NY",24020.0,2019-05-01,499,439,60
"Glens Falls, NY",24020.0,2019-06-01,73,131,-58
"Glens Falls, NY",24020.0,2019-07-01,57,14,43
"Glens Falls, NY",24020.0,2019-08-01,4,0,4
"Glens Falls, NY",24020.0,2019-09-01,-50,-12,-38
"Glens Falls, NY",24020.0,2019-10-01,-438,-410,-28
"Glens Falls, NY",24020.0,2019-11-01,-152,-120,-32
"Glens Falls, NY",24020.0,2019-12-01,-173,-163,-10
"Glens Falls, NY",24020.0,2020-01-01,-93,-84,-9
"Glens Falls, NY",24020.0,2020-02-01,-3,-11,8
"Glens Falls, NY",24020.0,2020-03-01,45,81,-36
"Glens Falls, NY",24020.0,2020-04-01,25,46,-21
"Glens Falls, NY",24020.0,2020-05-01,321,279,42
"Glens Falls, NY",24020.0,2020-06-01,237,273,-36
"Glens Falls, NY",24020.0,2020-07-01,18,13,5
"Glens Falls, NY",24020.0,2020-08-01,37,0,37
"Glens Falls, NY",24020.0,2020-09-01,10,-16,26
"Glens Falls, NY",24020.0,2020-10-01,-294,-298,4
"Glens Falls, NY",24020.0,2020-11-01,-131,-168,37
"Glens Falls, NY",24020.0,2020-12-01,-77,-106,29
"Warren, PA",47620.0,2019-01-01,-14,0,-14
"Warren, PA",47620.0,2019-02-01,-17,0,-17
"Warren, PA",47620.0,2019-03-01,-14,0,-14
"Warren, PA",47620.0,2019-04-01,-3,0,-3
"Warren, PA",47620.0,2019-05-01,-9,0,-9
"Warren, PA",47620.0,2019-06-01,31,0,31
"Warren, PA",47620.0,2019-07-01,17,0,17
"Warren, PA",47620.0,2019-08-01,18,0,18
"Warren, PA",47620.0,2019-09-01,4,0,4
"Warren, PA",47620.0,2019-10-01,-5,0,-5
"Warren, PA",47620.0,2019-11-01,-17,-17,0
"Warren, PA",47620.0,2019-12-01,17,0,17
"Warren, PA",47620.0,2020-01-01,-7,0,-7
"Warren, PA",47620.0,2020-02-01,13,0,13
"Warren, PA",47620.0,2020-03-01,0,0,0
"Warren, PA",47620.0,2020-04-01,19,0,19
"Warren, PA",47620.0,2020-05-01,-16,0,-16
"Warren, PA",47620.0,2020-06-01,11,0,11
"Warren, PA",47620.0,2020-07-01,5,0,5
"Warren, PA",47620.0,2020-08-01,-6,0,-6
"Warren, PA",47620.0,2020-09-01,-33,0,-33
"Warren, PA",47620.0,2020-10-01,-12,0,-12
"Warren, PA",47620.0,2020-11-01,0,0,0
"Warren, PA",47620.0,2020-12-01,-22,-11,-11
"McMinnville, TN",32660.0,2019-01-01,-31,0,-31
"McMinnville, TN",32660.0,2019-02-01,20,0,20
"McMinnville, TN",32660.0,2019-03-01,23,0,23
"McMinnville, TN",32660.0,2019-04-01,-17,0,-17
"McMinnville, TN",32660.0,2019-05-01,29,0,29
"McMinnville, TN",32660.0,2019-06-01,32,0,32
"McMinnville, TN",32660.0,2019-07-01,48,0,48
"McMinnville, TN",32660.0,2019-08-01,10,0,10
"McMinnville, TN",32660.0,2019-09-01,17,0,17
"McMinnville, TN",32660.0,2019-10-01,19,0,19
"McMinnville, TN",32660.0,2019-11-01,-34,0,-34
"McMinnville, TN",32660.0,2019-12-01,1,0,1
"McMinnville, TN",32660.0,2020-01-01,26,0,26
"McMinnville, TN",32660.0,2020-02-01,5,0,5
"McMinnville, TN",32660.0,2020-03-01,13,0,13
"McMinnville, TN",32660.0,2020-04-01,-3,0,-3
"McMinnville, TN",32660.0,2020-05-01,19,0,19
"McMinnville, TN",32660.0,2020-06-01,15,0,15
"McMinnville, TN",32660.0,2020-07-01,44,0,44
"McMinnville, TN",32660.0,2020-08-01,-17,0,-17
"McMinnville, TN",32660.0,2020-09-01,25,0,25
"McMinnville, TN",32660.0,2020-10-01,-7,0,-7
"McMinnville, TN",32660.0,2020-11-01,11,0,11
"McMinnville, TN",32660.0,2020-12-01,32,0,32
"The Dalles, OR",45520.0,2019-01-01,12,0,12
"The Dalles, OR",45520.0,2019-02-01,0,0,0
"The Dalles, OR",45520.0,2019-03-01,29,0,29
"The Dalles, OR",45520.0,2019-04-01,14,0,14
"The Dalles, OR",45520.0,2019-05-01,12,0,12
"The Dalles, OR",45520.0,2019-06-01,20,0,20
"The Dalles, OR",45520.0,2019-07-01,0,0,0
"The Dalles, OR",45520.0,2019-08-01,35,0,35
"The Dalles, OR",45520.0,2019-09-01,3,0,3
"The Dalles, OR",45520.0,2019-10-01,-35,-17,-18
"The Dalles, OR",45520.0,2019-11-01,-36,-11,-25
"The Dalles, OR",45520.0,2019-12-01,-13,0,-13
"The Dalles, OR",45520.0,2020-01-01,3,0,3
"The Dalles, OR",45520.0,2020-02-01,-2,0,-2
"The Dalles, OR",45520.0,2020-03-01,45,0,45
"The Dalles, OR",45520.0,2020-04-01,37,0,37
"The Dalles, OR",45520.0,2020-05-01,11,11,0
"The Dalles, OR",45520.0,2020-06-01,42,0,42
"The Dalles, OR",45520.0,2020-07-01,23,0,23
"The Dalles, OR",45520.0,2020-08-01,49,0,49
"The Dalles, OR",45520.0,2020-09-01,18,0,18
"The Dalles, OR",45520.0,2020-10-01,20,-12,32
"The Dalles, OR",45520.0,2020-11-01,13,0,13
"The Dalles, OR",45520.0,2020-12-01,31,0,31
"Bogalusa, LA",14220.0,2019-01-01,9,0,9
"Bogalusa, LA",14220.0,2019-02-01,-17,0,-17
"Bogalusa, LA",14220.0,2019-03-01,-31,0,-31
"Bogalusa, LA",14220.0,2019-04-01,22,0,22
"Bogalusa, LA",14220.0,2019-05-01,18,0,18
"Bogalusa, LA",14220.0,2019-06-01,-28,0,-28
"Bogalusa, LA",14220.0,2019-07-01,2,0,2
"Bogalusa, LA",14220.0,2019-08-01,-24,0,-24
"Bogalusa, LA",14220.0,2019-09-01,1,0,1
"Bogalusa, LA",14220.0,2019-10-01,-20,0,-20
"Bogalusa, LA",14220.0,2019-11-01,-29,0,-29
"Bogalusa, LA",14220.0,2019-12-01,17,0,17
"Bogalusa, LA",14220.0,2020-01-01,14,0,14
"Bogalusa, LA",14220.0,2020-02-01,-12,0,-12
"Bogalusa, LA",14220.0,2020-03-01,-4,0,-4
"Bogalusa, LA",14220.0,2020-04-01,-11,0,-11
"Bogalusa, LA",14220.0,2020-05-01,-12,0,-12
"Bogalusa, LA",14220.0,2020-06-01,-11,0,-11
"Bogalusa, LA",14220.0,2020-07-01,3,0,3
"Bogalusa, LA",14220.0,2020-08-01,9,0,9
"Bogalusa, LA",14220.0,2020-09-01,6,0,6
"Bogalusa, LA",14220.0,2020-10-01,-4,0,-4
"Bogalusa, LA",14220.0,2020-11-01,1,0,1
"Bogalusa, LA",14220.0,2020-12-01,2,0,2
"Greenville, MS",24740.0,2019-01-01,12,0,12
"Greenville, MS",24740.0,2019-02-01,0,0,0
"Greenville, MS",24740.0,2019-03-01,0,0,0
"Greenville, MS",24740.0,2019-04-01,12,0,12
"Greenville, MS",24740.0,2019-05-01,0,0,0
"Greenville, MS",24740.0,2019-06-01,13,0,13
"Greenville, MS",24740.0,2019-07-01,-1,0,-1
"Greenville, MS",24740.0,2019-08-01,0,0,0
"Greenville, MS",24740.0,2019-09-01,0,0,0
"Greenville, MS",24740.0,2019-10-01,11,0,11
"Greenville, MS",24740.0,2019-11-01,0,0,0
"Greenville, MS",24740.0,2019-12-01,0,0,0
"Greenville, MS",24740.0,2020-01-01,0,0,0
"Greenville, MS",24740.0,2020-02-01,0,0,0
"Greenville, MS",24740.0,2020-03-01,13,0,13
"Greenville, MS",24740.0,2020-04-01,0,0,0
"Greenville, MS",24740.0,2020-05-01,0,0,0
"Greenville, MS",24740.0,2020-06-01,3,0,3
"Greenville, MS",24740.0,2020-07-01,11,0,11
"Greenville, MS",24740.0,2020-08-01,11,0,11
"Greenville, MS",24740.0,2020-09-01,-14,0,-14
"Greenville, MS",24740.0,2020-10-01,0,0,0
"Greenville, MS",24740.0,2020-11-01,0,0,0
"Greenville, MS",24740.0,2020-12-01,0,0,0
"Marietta, OH",31930.0,2019-01-01,0,0,0
"Marietta, OH",31930.0,2019-02-01,-8,0,-8
"Marietta, OH",31930.0,2019-03-01,-9,0,-9
"Marietta, OH",31930.0,2019-04-01,10,0,10
"Marietta, OH",31930.0,2019-05-01,-14,0,-14
"Marietta, OH",31930.0,2019-06-01,-18,0,-18
"Marietta, OH",31930.0,2019-07-01,16,0,16
"Marietta, OH",31930.0,2019-08-01,16,0,16
"Marietta, OH",31930.0,2019-09-01,20,0,20
"Marietta, OH",31930.0,2019-10-01,1,0,1
"Marietta, OH",31930.0,2019-11-01,8,0,8
"Marietta, OH",31930.0,2019-12-01,12,0,12
"Marietta, OH",31930.0,2020-01-01,-7,0,-7
"Marietta, OH",31930.0,2020-02-01,25,0,25
"Marietta, OH",31930.0,2020-03-01,7,0,7
"Marietta, OH",31930.0,2020-04-01,-20,0,-20
"Marietta, OH",31930.0,2020-05-01,14,0,14
"Marietta, OH",31930.0,2020-06-01,-20,0,-20
"Marietta, OH",31930.0,2020-07-01,52,0,52
"Marietta, OH",31930.0,2020-08-01,33,0,33
"Marietta, OH",31930.0,2020-09-01,-11,0,-11
"Marietta, OH",31930.0,2020-10-01,-5,0,-5
"Marietta, OH",31930.0,2020-11-01,-17,0,-17
"Marietta, OH",31930.0,2020-12-01,9,0,9
"Bartlesville, OK",12780.0,2019-01-01,-5,0,-5
"Bartlesville, OK",12780.0,2019-02-01,38,0,38
"Bartlesville, OK",12780.0,2019-03-01,5,0,5
"Bartlesville, OK",12780.0,2019-04-01,11,0,11
"Bartlesville, OK",12780.0,2019-05-01,15,0,15
"Bartlesville, OK",12780.0,2019-06-01,-5,0,-5
"Bartlesville, OK",12780.0,2019-07-01,32,0,32
"Bartlesville, OK",12780.0,2019-08-01,9,0,9
"Bartlesville, OK",12780.0,2019-09-01,-13,0,-13
"Bartlesville, OK",12780.0,2019-10-01,2,0,2
"Bartlesville, OK",12780.0,2019-11-01,9,0,9
"Bartlesville, OK",12780.0,2019-12-01,-3,0,-3
"Bartlesville, OK",12780.0,2020-01-01,-3,0,-3
"Bartlesville, OK",12780.0,2020-02-01,20,0,20
"Bartlesville, OK",12780.0,2020-03-01,-17,0,-17
"Bartlesville, OK",12780.0,2020-04-01,-8,0,-8
"Bartlesville, OK",12780.0,2020-05-01,7,0,7
"Bartlesville, OK",12780.0,2020-06-01,-28,0,-28
"Bartlesville, OK",12780.0,2020-07-01,-10,0,-10
"Bartlesville, OK",12780.0,2020-08-01,-37,0,-37
"Bartlesville, OK",12780.0,2020-09-01,17,0,17
"Bartlesville, OK",12780.0,2020-10-01,1,0,1
"Bartlesville, OK",12780.0,2020-11-01,30,0,30
"Bartlesville, OK",12780.0,2020-12-01,22,0,22
"Brenham, TX",14780.0,2019-01-01,-23,0,-23
"Brenham, TX",14780.0,2019-02-01,2,0,2
"Brenham, TX",14780.0,2019-03-01,-2,0,-2
"Brenham, TX",14780.0,2019-04-01,6,0,6
"Brenham, TX",14780.0,2019-05-01,7,0,7
"Brenham, TX",14780.0,2019-06-01,-21,0,-21
"Brenham, TX",14780.0,2019-07-01,33,0,33
"Brenham, TX",14780.0,2019-08-01,36,0,36
"Brenham, TX",14780.0,2019-09-01,11,0,11
"Brenham, TX",14780.0,2019-10-01,17,0,17
"Brenham, TX",14780.0,2019-11-01,9,0,9
"Brenham, TX",14780.0,2019-12-01,7,0,7
"Brenham, TX",14780.0,2020-01-01,-12,0,-12
"Brenham, TX",14780.0,2020-02-01,-8,0,-8
"Brenham, TX",14780.0,2020-03-01,23,0,23
"Brenham, TX",14780.0,2020-04-01,9,0,9
"Brenham, TX",14780.0,2020-05-01,21,0,21
"Brenham, TX",14780.0,2020-06-01,31,0,31
"Brenham, TX",14780.0,2020-07-01,17,0,17
"Brenham, TX",14780.0,2020-08-01,24,0,24
"Brenham, TX",14780.0,2020-09-01,23,0,23
"Brenham, TX",14780.0,2020-10-01,3,0,3
"Brenham, TX",14780.0,2020-11-01,3,0,3
"Brenham, TX",14780.0,2020-12-01,18,0,18
"St. George, UT",41100.0,2019-01-01,319,174,145
"St. George, UT",41100.0,2019-02-01,102,11,91
"St. George, UT",41100.0,2019-03-01,99,-6,105
"St. George, UT",41100.0,2019-04-01,-58,-117,59
"St. George, UT",41100.0,2019-05-01,-108,-232,124
"St. George, UT",41100.0,2019-06-01,196,-110,306
"St. George, UT",41100.0,2019-07-01,215,-26,241
"St. George, UT",41100.0,2019-08-01,276,0,276
"St. George, UT",41100.0,2019-09-01,205,11,194
"St. George, UT",41100.0,2019-10-01,394,282,112
"St. George, UT",41100.0,2019-11-01,284,144,140
"St. George, UT",41100.0,2019-12-01,143,102,41
"St. George, UT",41100.0,2020-01-01,234,174,60
"St. George, UT",41100.0,2020-02-01,118,19,99
"St. George, UT",41100.0,2020-03-01,186,62,124
"St. George, UT",41100.0,2020-04-01,248,33,215
"St. George, UT",41100.0,2020-05-01,-65,-221,156
"St. George, UT",41100.0,2020-06-01,85,-147,232
"St. George, UT",41100.0,2020-07-01,261,-16,277
"St. George, UT",41100.0,2020-08-01,348,0,348
"St. George, UT",41100.0,2020-09-01,360,31,329
"St. George, UT",41100.0,2020-10-01,552,286,266
"St. George, UT",41100.0,2020-11-01,474,175,299
"St. George, UT",41100.0,2020-12-01,308,130,178
"Barre, VT",12740.0,2019-01-01,2,-12,14
"Barre, VT",12740.0,2019-02-01,-11,0,-11
"Barre, VT",12740.0,2019-03-01,-17,0,-17
"Barre, VT",12740.0,2019-04-01,18,0,18
"Barre, VT",12740.0,2019-05-01,55,44,11
"Barre, VT",12740.0,2019-06-01,-12,0,-12
"Barre, VT",12740.0,2019-07-01,-36,0,-36
"Barre, VT",12740.0,2019-08-01,37,0,37
"Barre, VT",12740.0,2019-09-01,10,0,10
"Barre, VT",12740.0,2019-10-01,-30,-50,20
"Barre, VT",12740.0,2019-11-01,-25,0,-25
"Barre, VT",12740.0,2019-12-01,17,0,17
"Barre, VT",12740.0,2020-01-01,-16,0,-16
"Barre, VT",12740.0,2020-02-01,-28,0,-28
"Barre, VT",12740.0,2020-03-01,6,15,-9
"Barre, VT",12740.0,2020-04-01,62,35,27
"Barre, VT",12740.0,2020-05-01,98,73,25
"Barre, VT",12740.0,2020-06-01,13,24,-11
"Barre, VT",12740.0,2020-07-01,-14,0,-14
"Barre, VT",12740.0,2020-08-01,43,0,43
"Barre, VT",12740.0,2020-09-01,41,0,41
"Barre, VT",12740.0,2020-10-01,13,-25,38
"Barre, VT",12740.0,2020-11-01,13,-13,26
"Barre, VT",12740.0,2020-12-01,11,19,-8
"Reno, NV",39900.0,2019-01-01,179,-82,261
"Reno, NV",39900.0,2019-02-01,109,-13,122
"Reno, NV",39900.0,2019-03-01,64,-30,94
"Reno, NV",39900.0,2019-04-01,375,52,323
"Reno, NV",39900.0,2019-05-01,220,129,91
"Reno, NV",39900.0,2019-06-01,304,102,202
"Reno, NV",39900.0,2019-07-01,91,13,78
"Reno, NV",39900.0,2019-08-01,349,-1,350
"Reno, NV",39900.0,2019-09-01,183,-65,248
"Reno, NV",39900.0,2019-10-01,-7,-230,223
"Reno, NV",39900.0,2019-11-01,68,-160,228
"Reno, NV",39900.0,2019-12-01,12,-128,140
"Reno, NV",39900.0,2020-01-01,37,-134,171
"Reno, NV",39900.0,2020-02-01,125,-32,157
"Reno, NV",39900.0,2020-03-01,255,40,215
"Reno, NV",39900.0,2020-04-01,227,21,206
"Reno, NV",39900.0,2020-05-01,340,129,211
"Reno, NV",39900.0,2020-06-01,345,130,215
"Reno, NV",39900.0,2020-07-01,444,66,378
"Reno, NV",39900.0,2020-08-01,468,51,417
"Reno, NV",39900.0,2020-09-01,496,-16,512
"Reno, NV",39900.0,2020-10-01,252,-226,478
"Reno, NV",39900.0,2020-11-01,162,-226,388
"Reno, NV",39900.0,2020-12-01,211,-64,275
"Ann Arbor, MI",11460.0,2019-01-01,-369,-174,-195
"Ann Arbor, MI",11460.0,2019-02-01,-89,-15,-74
"Ann Arbor, MI",11460.0,2019-03-01,-144,-12,-132
"Ann Arbor, MI",11460.0,2019-04-01,76,176,-100
"Ann Arbor, MI",11460.0,2019-05-01,-357,119,-476
"Ann Arbor, MI",11460.0,2019-06-01,-567,-26,-541
"Ann Arbor, MI",11460.0,2019-07-01,-549,-14,-535
"Ann Arbor, MI",11460.0,2019-08-01,-724,3,-727
"Ann Arbor, MI",11460.0,2019-09-01,-162,8,-170
"Ann Arbor, MI",11460.0,2019-10-01,-175,-152,-23
"Ann Arbor, MI",11460.0,2019-11-01,-281,-147,-134
"Ann Arbor, MI",11460.0,2019-12-01,-303,-222,-81
"Ann Arbor, MI",11460.0,2020-01-01,-348,-191,-157
"Ann Arbor, MI",11460.0,2020-02-01,-11,-16,5
"Ann Arbor, MI",11460.0,2020-03-01,-100,22,-122
"Ann Arbor, MI",11460.0,2020-04-01,-131,42,-173
"Ann Arbor, MI",11460.0,2020-05-01,-116,151,-267
"Ann Arbor, MI",11460.0,2020-06-01,-235,4,-239
"Ann Arbor, MI",11460.0,2020-07-01,-621,15,-636
"Ann Arbor, MI",11460.0,2020-08-01,-362,-1,-361
"Ann Arbor, MI",11460.0,2020-09-01,71,11,60
"Ann Arbor, MI",11460.0,2020-10-01,-159,-152,-7
"Ann Arbor, MI",11460.0,2020-11-01,-333,-193,-140
"Ann Arbor, MI",11460.0,2020-12-01,-271,-250,-21
"Boone, NC",14380.0,2019-01-01,-7,-11,4
"Boone, NC",14380.0,2019-02-01,22,0,22
"Boone, NC",14380.0,2019-03-01,-14,0,-14
"Boone, NC",14380.0,2019-04-01,-11,0,-11
"Boone, NC",14380.0,2019-05-01,110,160,-50
"Boone, NC",14380.0,2019-06-01,29,86,-57
"Boone, NC",14380.0,2019-07-01,-89,24,-113
"Boone, NC",14380.0,2019-08-01,-71,0,-71
"Boone, NC",14380.0,2019-09-01,-36,0,-36
"Boone, NC",14380.0,2019-10-01,-81,-63,-18
"Boone, NC",14380.0,2019-11-01,-23,-11,-12
"Boone, NC",14380.0,2019-12-01,3,0,3
"Boone, NC",14380.0,2020-01-01,5,0,5
"Boone, NC",14380.0,2020-02-01,-4,0,-4
"Boone, NC",14380.0,2020-03-01,3,32,-29
"Boone, NC",14380.0,2020-04-01,33,0,33
"Boone, NC",14380.0,2020-05-01,28,56,-28
"Boone, NC",14380.0,2020-06-01,-11,73,-84
"Boone, NC",14380.0,2020-07-01,-177,13,-190
"Boone, NC",14380.0,2020-08-01,-52,11,-63
"Boone, NC",14380.0,2020-09-01,39,12,27
"Boone, NC",14380.0,2020-10-01,-40,-30,-10
"Boone, NC",14380.0,2020-11-01,-14,-11,-3
"Boone, NC",14380.0,2020-12-01,-42,0,-42
"Jesup, GA",27700.0,2019-01-01,12,0,12
"Jesup, GA",27700.0,2019-02-01,-2,0,-2
"Jesup, GA",27700.0,2019-03-01,0,0,0
"Jesup, GA",27700.0,2019-04-01,-23,0,-23
"Jesup, GA",27700.0,2019-05-01,11,0,11
"Jesup, GA",27700.0,2019-06-01,0,0,0
"Jesup, GA",27700.0,2019-07-01,0,0,0
"Jesup, GA",27700.0,2019-08-01,0,0,0
"Jesup, GA",27700.0,2019-09-01,0,0,0
"Jesup, GA",27700.0,2019-10-01,0,0,0
"Jesup, GA",27700.0,2019-11-01,0,0,0
"Jesup, GA",27700.0,2019-12-01,0,0,0
"Jesup, GA",27700.0,2020-01-01,27,0,27
"Jesup, GA",27700.0,2020-02-01,-13,0,-13
"Jesup, GA",27700.0,2020-03-01,0,0,0
"Jesup, GA",27700.0,2020-04-01,0,0,0
"Jesup, GA",27700.0,2020-05-01,0,0,0
"Jesup, GA",27700.0,2020-06-01,0,0,0
"Jesup, GA",27700.0,2020-07-01,12,0,12
"Jesup, GA",27700.0,2020-08-01,-14,0,-14
"Jesup, GA",27700.0,2020-09-01,0,0,0
"Jesup, GA",27700.0,2020-10-01,0,0,0
"Jesup, GA",27700.0,2020-11-01,0,0,0
"Jesup, GA",27700.0,2020-12-01,0,0,0
"Richmond, IN",39980.0,2019-01-01,0,0,0
"Richmond, IN",39980.0,2019-02-01,46,0,46
"Richmond, IN",39980.0,2019-03-01,44,0,44
"Richmond, IN",39980.0,2019-04-01,10,0,10
"Richmond, IN",39980.0,2019-05-01,20,0,20
"Richmond, IN",39980.0,2019-06-01,13,0,13
"Richmond, IN",39980.0,2019-07-01,29,0,29
"Richmond, IN",39980.0,2019-08-01,6,0,6
"Richmond, IN",39980.0,2019-09-01,5,0,5
"Richmond, IN",39980.0,2019-10-01,5,0,5
"Richmond, IN",39980.0,2019-11-01,-19,0,-19
"Richmond, IN",39980.0,2019-12-01,-58,0,-58
"Richmond, IN",39980.0,2020-01-01,2,0,2
"Richmond, IN",39980.0,2020-02-01,21,0,21
"Richmond, IN",39980.0,2020-03-01,37,0,37
"Richmond, IN",39980.0,2020-04-01,-12,0,-12
"Richmond, IN",39980.0,2020-05-01,-12,0,-12
"Richmond, IN",39980.0,2020-06-01,22,0,22
"Richmond, IN",39980.0,2020-07-01,-21,0,-21
"Richmond, IN",39980.0,2020-08-01,44,0,44
"Richmond, IN",39980.0,2020-09-01,-23,0,-23
"Richmond, IN",39980.0,2020-10-01,32,0,32
"Richmond, IN",39980.0,2020-11-01,-4,0,-4
"Richmond, IN",39980.0,2020-12-01,23,0,23
"Goldsboro, NC",24140.0,2019-01-01,-8,0,-8
"Goldsboro, NC",24140.0,2019-02-01,7,0,7
"Goldsboro, NC",24140.0,2019-03-01,70,0,70
"Goldsboro, NC",24140.0,2019-04-01,14,0,14
"Goldsboro, NC",24140.0,2019-05-01,32,0,32
"Goldsboro, NC",24140.0,2019-06-01,26,0,26
"Goldsboro, NC",24140.0,2019-07-01,37,0,37
"Goldsboro, NC",24140.0,2019-08-01,72,0,72
"Goldsboro, NC",24140.0,2019-09-01,-21,0,-21
"Goldsboro, NC",24140.0,2019-10-01,35,0,35
"Goldsboro, NC",24140.0,2019-11-01,-18,0,-18
"Goldsboro, NC",24140.0,2019-12-01,44,0,44
"Goldsboro, NC",24140.0,2020-01-01,19,0,19
"Goldsboro, NC",24140.0,2020-02-01,-3,0,-3
"Goldsboro, NC",24140.0,2020-03-01,67,0,67
"Goldsboro, NC",24140.0,2020-04-01,12,0,12
"Goldsboro, NC",24140.0,2020-05-01,-22,0,-22
"Goldsboro, NC",24140.0,2020-06-01,27,0,27
"Goldsboro, NC",24140.0,2020-07-01,35,0,35
"Goldsboro, NC",24140.0,2020-08-01,-5,0,-5
"Goldsboro, NC",24140.0,2020-09-01,48,0,48
"Goldsboro, NC",24140.0,2020-10-01,11,0,11
"Goldsboro, NC",24140.0,2020-11-01,22,0,22
"Goldsboro, NC",24140.0,2020-12-01,10,0,10
"Wooster, OH",49300.0,2019-01-01,-57,-52,-5
"Wooster, OH",49300.0,2019-02-01,-7,0,-7
"Wooster, OH",49300.0,2019-03-01,5,0,5
"Wooster, OH",49300.0,2019-04-01,-9,22,-31
"Wooster, OH",49300.0,2019-05-01,-10,0,-10
"Wooster, OH",49300.0,2019-06-01,-15,0,-15
"Wooster, OH",49300.0,2019-07-01,-54,0,-54
"Wooster, OH",49300.0,2019-08-01,-7,0,-7
"Wooster, OH",49300.0,2019-09-01,7,0,7
"Wooster, OH",49300.0,2019-10-01,-4,-16,12
"Wooster, OH",49300.0,2019-11-01,-65,-11,-54
"Wooster, OH",49300.0,2019-12-01,-22,-41,19
"Wooster, OH",49300.0,2020-01-01,7,-38,45
"Wooster, OH",49300.0,2020-02-01,6,0,6
"Wooster, OH",49300.0,2020-03-01,-8,0,-8
"Wooster, OH",49300.0,2020-04-01,-24,0,-24
"Wooster, OH",49300.0,2020-05-01,35,0,35
"Wooster, OH",49300.0,2020-06-01,14,0,14
"Wooster, OH",49300.0,2020-07-01,21,0,21
"Wooster, OH",49300.0,2020-08-01,37,0,37
"Wooster, OH",49300.0,2020-09-01,4,0,4
"Wooster, OH",49300.0,2020-10-01,14,-26,40
"Wooster, OH",49300.0,2020-11-01,9,0,9
"Wooster, OH",49300.0,2020-12-01,28,-27,55
"Martin, TN",32280.0,2019-01-01,11,0,11
"Martin, TN",32280.0,2019-02-01,-11,0,-11
"Martin, TN",32280.0,2019-03-01,18,0,18
"Martin, TN",32280.0,2019-04-01,-20,0,-20
"Martin, TN",32280.0,2019-05-01,-11,0,-11
"Martin, TN",32280.0,2019-06-01,3,0,3
"Martin, TN",32280.0,2019-07-01,-11,0,-11
"Martin, TN",32280.0,2019-08-01,-16,0,-16
"Martin, TN",32280.0,2019-09-01,-15,0,-15
"Martin, TN",32280.0,2019-10-01,17,0,17
"Martin, TN",32280.0,2019-11-01,-26,0,-26
"Martin, TN",32280.0,2019-12-01,-34,0,-34
"Martin, TN",32280.0,2020-01-01,3,0,3
"Martin, TN",32280.0,2020-02-01,-19,0,-19
"Martin, TN",32280.0,2020-03-01,-29,0,-29
"Martin, TN",32280.0,2020-04-01,8,0,8
"Martin, TN",32280.0,2020-05-01,6,0,6
"Martin, TN",32280.0,2020-06-01,-12,0,-12
"Martin, TN",32280.0,2020-07-01,-35,0,-35
"Martin, TN",32280.0,2020-08-01,0,0,0
"Martin, TN",32280.0,2020-09-01,-9,0,-9
"Martin, TN",32280.0,2020-10-01,6,0,6
"Martin, TN",32280.0,2020-11-01,-16,0,-16
"Martin, TN",32280.0,2020-12-01,-19,0,-19
"Laredo, TX",29700.0,2019-01-01,16,0,16
"Laredo, TX",29700.0,2019-02-01,21,0,21
"Laredo, TX",29700.0,2019-03-01,-1,-14,13
"Laredo, TX",29700.0,2019-04-01,-18,0,-18
"Laredo, TX",29700.0,2019-05-01,-33,0,-33
"Laredo, TX",29700.0,2019-06-01,13,0,13
"Laredo, TX",29700.0,2019-07-01,-22,0,-22
"Laredo, TX",29700.0,2019-08-01,-23,0,-23
"Laredo, TX",29700.0,2019-09-01,-8,0,-8
"Laredo, TX",29700.0,2019-10-01,-17,0,-17
"Laredo, TX",29700.0,2019-11-01,-15,0,-15
"Laredo, TX",29700.0,2019-12-01,9,0,9
"Laredo, TX",29700.0,2020-01-01,2,0,2
"Laredo, TX",29700.0,2020-02-01,-20,0,-20
"Laredo, TX",29700.0,2020-03-01,-41,0,-41
"Laredo, TX",29700.0,2020-04-01,-10,0,-10
"Laredo, TX",29700.0,2020-05-01,40,0,40
"Laredo, TX",29700.0,2020-06-01,-48,0,-48
"Laredo, TX",29700.0,2020-07-01,-5,0,-5
"Laredo, TX",29700.0,2020-08-01,-19,0,-19
"Laredo, TX",29700.0,2020-09-01,-25,0,-25
"Laredo, TX",29700.0,2020-10-01,3,0,3
"Laredo, TX",29700.0,2020-11-01,18,18,0
"Laredo, TX",29700.0,2020-12-01,-8,16,-24
"Fort Dodge, IA",22700.0,2019-01-01,-15,0,-15
"Fort Dodge, IA",22700.0,2019-02-01,-20,0,-20
"Fort Dodge, IA",22700.0,2019-03-01,1,0,1
"Fort Dodge, IA",22700.0,2019-04-01,-3,0,-3
"Fort Dodge, IA",22700.0,2019-05-01,-44,0,-44
"Fort Dodge, IA",22700.0,2019-06-01,-38,0,-38
"Fort Dodge, IA",22700.0,2019-07-01,-5,0,-5
"Fort Dodge, IA",22700.0,2019-08-01,11,0,11
"Fort Dodge, IA",22700.0,2019-09-01,0,0,0
"Fort Dodge, IA",22700.0,2019-10-01,-36,-16,-20
"Fort Dodge, IA",22700.0,2019-11-01,-47,-24,-23
"Fort Dodge, IA",22700.0,2019-12-01,1,-25,26
"Fort Dodge, IA",22700.0,2020-01-01,19,0,19
"Fort Dodge, IA",22700.0,2020-02-01,11,0,11
"Fort Dodge, IA",22700.0,2020-03-01,11,0,11
"Fort Dodge, IA",22700.0,2020-04-01,0,0,0
"Fort Dodge, IA",22700.0,2020-05-01,-12,0,-12
"Fort Dodge, IA",22700.0,2020-06-01,-43,0,-43
"Fort Dodge, IA",22700.0,2020-07-01,-13,0,-13
"Fort Dodge, IA",22700.0,2020-08-01,-46,0,-46
"Fort Dodge, IA",22700.0,2020-09-01,64,0,64
"Fort Dodge, IA",22700.0,2020-10-01,-10,-15,5
"Fort Dodge, IA",22700.0,2020-11-01,-46,-23,-23
"Fort Dodge, IA",22700.0,2020-12-01,-12,0,-12
"Minden, LA",33380.0,2019-01-01,-3,0,-3
"Minden, LA",33380.0,2019-02-01,-8,0,-8
"Minden, LA",33380.0,2019-03-01,-30,0,-30
"Minden, LA",33380.0,2019-04-01,-4,0,-4
"Minden, LA",33380.0,2019-05-01,-14,0,-14
"Minden, LA",33380.0,2019-06-01,-14,0,-14
"Minden, LA",33380.0,2019-07-01,1,0,1
"Minden, LA",33380.0,2019-08-01,-31,0,-31
"Minden, LA",33380.0,2019-09-01,-6,0,-6
"Minden, LA",33380.0,2019-10-01,6,0,6
"Minden, LA",33380.0,2019-11-01,21,0,21
"Minden, LA",33380.0,2019-12-01,-13,0,-13
"Minden, LA",33380.0,2020-01-01,18,0,18
"Minden, LA",33380.0,2020-02-01,11,0,11
"Minden, LA",33380.0,2020-03-01,31,0,31
"Minden, LA",33380.0,2020-04-01,-10,0,-10
"Minden, LA",33380.0,2020-05-01,-65,0,-65
"Minden, LA",33380.0,2020-06-01,-25,0,-25
"Minden, LA",33380.0,2020-07-01,1,0,1
"Minden, LA",33380.0,2020-08-01,12,0,12
"Minden, LA",33380.0,2020-09-01,-10,0,-10
"Minden, LA",33380.0,2020-10-01,-39,0,-39
"Minden, LA",33380.0,2020-11-01,-33,0,-33
"Minden, LA",33380.0,2020-12-01,14,0,14
"Greeley, CO",24540.0,2019-01-01,193,-51,244
"Greeley, CO",24540.0,2019-02-01,340,0,340
"Greeley, CO",24540.0,2019-03-01,251,-23,274
"Greeley, CO",24540.0,2019-04-01,469,91,378
"Greeley, CO",24540.0,2019-05-01,376,35,341
"Greeley, CO",24540.0,2019-06-01,469,25,444
"Greeley, CO",24540.0,2019-07-01,421,3,418
"Greeley, CO",24540.0,2019-08-01,400,14,386
"Greeley, CO",24540.0,2019-09-01,396,-13,409
"Greeley, CO",24540.0,2019-10-01,288,-98,386
"Greeley, CO",24540.0,2019-11-01,202,-55,257
"Greeley, CO",24540.0,2019-12-01,167,-84,251
"Greeley, CO",24540.0,2020-01-01,165,-50,215
"Greeley, CO",24540.0,2020-02-01,263,0,263
"Greeley, CO",24540.0,2020-03-01,520,59,461
"Greeley, CO",24540.0,2020-04-01,337,11,326
"Greeley, CO",24540.0,2020-05-01,380,68,312
"Greeley, CO",24540.0,2020-06-01,364,6,358
"Greeley, CO",24540.0,2020-07-01,541,-11,552
"Greeley, CO",24540.0,2020-08-01,459,-17,476
"Greeley, CO",24540.0,2020-09-01,583,-13,596
"Greeley, CO",24540.0,2020-10-01,246,-122,368
"Greeley, CO",24540.0,2020-11-01,321,-64,385
"Greeley, CO",24540.0,2020-12-01,399,-4,403
"Bluffton, IN",14160.0,2019-01-01,22,0,22
"Bluffton, IN",14160.0,2019-02-01,-12,0,-12
"Bluffton, IN",14160.0,2019-03-01,12,0,12
"Bluffton, IN",14160.0,2019-04-01,7,0,7
"Bluffton, IN",14160.0,2019-05-01,4,0,4
"Bluffton, IN",14160.0,2019-06-01,-8,0,-8
"Bluffton, IN",14160.0,2019-07-01,-2,0,-2
"Bluffton, IN",14160.0,2019-08-01,15,0,15
"Bluffton, IN",14160.0,2019-09-01,-24,0,-24
"Bluffton, IN",14160.0,2019-10-01,-24,0,-24
"Bluffton, IN",14160.0,2019-11-01,-20,0,-20
"Bluffton, IN",14160.0,2019-12-01,9,0,9
"Bluffton, IN",14160.0,2020-01-01,-4,0,-4
"Bluffton, IN",14160.0,2020-02-01,-1,0,-1
"Bluffton, IN",14160.0,2020-03-01,-6,0,-6
"Bluffton, IN",14160.0,2020-04-01,17,0,17
"Bluffton, IN",14160.0,2020-05-01,18,0,18
"Bluffton, IN",14160.0,2020-06-01,11,0,11
"Bluffton, IN",14160.0,2020-07-01,29,0,29
"Bluffton, IN",14160.0,2020-08-01,-10,0,-10
"Bluffton, IN",14160.0,2020-09-01,-9,0,-9
"Bluffton, IN",14160.0,2020-10-01,-8,0,-8
"Bluffton, IN",14160.0,2020-11-01,4,0,4
"Bluffton, IN",14160.0,2020-12-01,2,0,2
"El Campo, TX",20900.0,2019-01-01,-8,0,-8
"El Campo, TX",20900.0,2019-02-01,2,0,2
"El Campo, TX",20900.0,2019-03-01,-21,0,-21
"El Campo, TX",20900.0,2019-04-01,31,0,31
"El Campo, TX",20900.0,2019-05-01,-3,0,-3
"El Campo, TX",20900.0,2019-06-01,15,0,15
"El Campo, TX",20900.0,2019-07-01,14,0,14
"El Campo, TX",20900.0,2019-08-01,-5,0,-5
"El Campo, TX",20900.0,2019-09-01,17,0,17
"El Campo, TX",20900.0,2019-10-01,-5,0,-5
"El Campo, TX",20900.0,2019-11-01,10,0,10
"El Campo, TX",20900.0,2019-12-01,-1,0,-1
"El Campo, TX",20900.0,2020-01-01,24,0,24
"El Campo, TX",20900.0,2020-02-01,10,0,10
"El Campo, TX",20900.0,2020-03-01,10,0,10
"El Campo, TX",20900.0,2020-04-01,-6,0,-6
"El Campo, TX",20900.0,2020-05-01,10,0,10
"El Campo, TX",20900.0,2020-06-01,3,0,3
"El Campo, TX",20900.0,2020-07-01,-3,0,-3
"El Campo, TX",20900.0,2020-08-01,-5,0,-5
"El Campo, TX",20900.0,2020-09-01,-4,0,-4
"El Campo, TX",20900.0,2020-10-01,22,0,22
"El Campo, TX",20900.0,2020-11-01,6,0,6
"El Campo, TX",20900.0,2020-12-01,29,0,29
"Bellingham, WA",13380.0,2019-01-01,-175,-119,-56
"Bellingham, WA",13380.0,2019-02-01,7,-40,47
"Bellingham, WA",13380.0,2019-03-01,66,3,63
"Bellingham, WA",13380.0,2019-04-01,378,194,184
"Bellingham, WA",13380.0,2019-05-01,208,156,52
"Bellingham, WA",13380.0,2019-06-01,42,58,-16
"Bellingham, WA",13380.0,2019-07-01,-97,-5,-92
"Bellingham, WA",13380.0,2019-08-01,-50,-13,-37
"Bellingham, WA",13380.0,2019-09-01,-60,-73,13
"Bellingham, WA",13380.0,2019-10-01,-362,-352,-10
"Bellingham, WA",13380.0,2019-11-01,-41,-141,100
"Bellingham, WA",13380.0,2019-12-01,-43,-54,11
"Bellingham, WA",13380.0,2020-01-01,-88,-120,32
"Bellingham, WA",13380.0,2020-02-01,-26,-31,5
"Bellingham, WA",13380.0,2020-03-01,82,37,45
"Bellingham, WA",13380.0,2020-04-01,85,13,72
"Bellingham, WA",13380.0,2020-05-01,230,137,93
"Bellingham, WA",13380.0,2020-06-01,-66,53,-119
"Bellingham, WA",13380.0,2020-07-01,-54,0,-54
"Bellingham, WA",13380.0,2020-08-01,-21,4,-25
"Bellingham, WA",13380.0,2020-09-01,136,-49,185
"Bellingham, WA",13380.0,2020-10-01,-170,-296,126
"Bellingham, WA",13380.0,2020-11-01,-71,-158,87
"Bellingham, WA",13380.0,2020-12-01,-31,-77,46
"Searcy, AR",42620.0,2019-01-01,13,0,13
"Searcy, AR",42620.0,2019-02-01,-2,0,-2
"Searcy, AR",42620.0,2019-03-01,16,0,16
"Searcy, AR",42620.0,2019-04-01,-31,0,-31
"Searcy, AR",42620.0,2019-05-01,21,0,21
"Searcy, AR",42620.0,2019-06-01,9,0,9
"Searcy, AR",42620.0,2019-07-01,58,0,58
"Searcy, AR",42620.0,2019-08-01,64,0,64
"Searcy, AR",42620.0,2019-09-01,-7,0,-7
"Searcy, AR",42620.0,2019-10-01,15,0,15
"Searcy, AR",42620.0,2019-11-01,-19,0,-19
"Searcy, AR",42620.0,2019-12-01,46,0,46
"Searcy, AR",42620.0,2020-01-01,34,0,34
"Searcy, AR",42620.0,2020-02-01,22,0,22
"Searcy, AR",42620.0,2020-03-01,6,0,6
"Searcy, AR",42620.0,2020-04-01,34,0,34
"Searcy, AR",42620.0,2020-05-01,-5,0,-5
"Searcy, AR",42620.0,2020-06-01,-17,0,-17
"Searcy, AR",42620.0,2020-07-01,-16,0,-16
"Searcy, AR",42620.0,2020-08-01,11,0,11
"Searcy, AR",42620.0,2020-09-01,-21,0,-21
"Searcy, AR",42620.0,2020-10-01,-9,0,-9
"Searcy, AR",42620.0,2020-11-01,36,0,36
"Searcy, AR",42620.0,2020-12-01,6,0,6
"Sterling, IL",44580.0,2019-01-01,-4,-16,12
"Sterling, IL",44580.0,2019-02-01,11,0,11
"Sterling, IL",44580.0,2019-03-01,10,0,10
"Sterling, IL",44580.0,2019-04-01,50,11,39
"Sterling, IL",44580.0,2019-05-01,-10,0,-10
"Sterling, IL",44580.0,2019-06-01,16,0,16
"Sterling, IL",44580.0,2019-07-01,0,0,0
"Sterling, IL",44580.0,2019-08-01,8,0,8
"Sterling, IL",44580.0,2019-09-01,8,0,8
"Sterling, IL",44580.0,2019-10-01,-13,-33,20
"Sterling, IL",44580.0,2019-11-01,-4,0,-4
"Sterling, IL",44580.0,2019-12-01,-47,-38,-9
"Sterling, IL",44580.0,2020-01-01,-6,-14,8
"Sterling, IL",44580.0,2020-02-01,-15,0,-15
"Sterling, IL",44580.0,2020-03-01,24,0,24
"Sterling, IL",44580.0,2020-04-01,28,0,28
"Sterling, IL",44580.0,2020-05-01,5,0,5
"Sterling, IL",44580.0,2020-06-01,-15,0,-15
"Sterling, IL",44580.0,2020-07-01,22,0,22
"Sterling, IL",44580.0,2020-08-01,-10,0,-10
"Sterling, IL",44580.0,2020-09-01,2,0,2
"Sterling, IL",44580.0,2020-10-01,17,0,17
"Sterling, IL",44580.0,2020-11-01,4,-11,15
"Sterling, IL",44580.0,2020-12-01,-1,-12,11
"Pullman, WA",39420.0,2019-01-01,-27,0,-27
"Pullman, WA",39420.0,2019-02-01,5,0,5
"Pullman, WA",39420.0,2019-03-01,-28,0,-28
"Pullman, WA",39420.0,2019-04-01,-42,0,-42
"Pullman, WA",39420.0,2019-05-01,-378,-34,-344
"Pullman, WA",39420.0,2019-06-01,-162,0,-162
"Pullman, WA",39420.0,2019-07-01,-97,0,-97
"Pullman, WA",39420.0,2019-08-01,-6,0,-6
"Pullman, WA",39420.0,2019-09-01,5,0,5
"Pullman, WA",39420.0,2019-10-01,-22,-11,-11
"Pullman, WA",39420.0,2019-11-01,-38,0,-38
"Pullman, WA",39420.0,2019-12-01,-76,0,-76
"Pullman, WA",39420.0,2020-01-01,-28,0,-28
"Pullman, WA",39420.0,2020-02-01,-13,0,-13
"Pullman, WA",39420.0,2020-03-01,-10,-11,1
"Pullman, WA",39420.0,2020-04-01,-69,0,-69
"Pullman, WA",39420.0,2020-05-01,-185,-15,-170
"Pullman, WA",39420.0,2020-06-01,-123,0,-123
"Pullman, WA",39420.0,2020-07-01,-116,0,-116
"Pullman, WA",39420.0,2020-08-01,6,0,6
"Pullman, WA",39420.0,2020-09-01,-39,0,-39
"Pullman, WA",39420.0,2020-10-01,-12,0,-12
"Pullman, WA",39420.0,2020-11-01,-29,-12,-17
"Pullman, WA",39420.0,2020-12-01,-17,0,-17
"Vernon, TX",46900.0,2019-01-01,0,0,0
"Vernon, TX",46900.0,2019-02-01,0,0,0
"Vernon, TX",46900.0,2019-03-01,0,0,0
"Vernon, TX",46900.0,2019-04-01,0,0,0
"Vernon, TX",46900.0,2019-05-01,0,0,0
"Vernon, TX",46900.0,2019-06-01,14,0,14
"Vernon, TX",46900.0,2019-07-01,0,0,0
"Vernon, TX",46900.0,2019-08-01,-11,0,-11
"Vernon, TX",46900.0,2019-09-01,-12,0,-12
"Vernon, TX",46900.0,2019-10-01,0,0,0
"Vernon, TX",46900.0,2019-11-01,0,0,0
"Vernon, TX",46900.0,2019-12-01,0,0,0
"Vernon, TX",46900.0,2020-01-01,-11,0,-11
"Vernon, TX",46900.0,2020-02-01,0,0,0
"Vernon, TX",46900.0,2020-03-01,13,0,13
"Vernon, TX",46900.0,2020-04-01,0,0,0
"Vernon, TX",46900.0,2020-05-01,0,0,0
"Vernon, TX",46900.0,2020-06-01,-11,0,-11
"Vernon, TX",46900.0,2020-07-01,0,0,0
"Vernon, TX",46900.0,2020-08-01,-12,0,-12
"Vernon, TX",46900.0,2020-09-01,11,0,11
"Vernon, TX",46900.0,2020-10-01,0,0,0
"Vernon, TX",46900.0,2020-11-01,0,0,0
"Vernon, TX",46900.0,2020-12-01,0,0,0
"North Wilkesboro, NC",35900.0,2019-01-01,14,0,14
"North Wilkesboro, NC",35900.0,2019-02-01,0,0,0
"North Wilkesboro, NC",35900.0,2019-03-01,-14,0,-14
"North Wilkesboro, NC",35900.0,2019-04-01,12,0,12
"North Wilkesboro, NC",35900.0,2019-05-01,-21,0,-21
"North Wilkesboro, NC",35900.0,2019-06-01,13,13,0
"North Wilkesboro, NC",35900.0,2019-07-01,-22,0,-22
"North Wilkesboro, NC",35900.0,2019-08-01,18,0,18
"North Wilkesboro, NC",35900.0,2019-09-01,26,0,26
"North Wilkesboro, NC",35900.0,2019-10-01,25,0,25
"North Wilkesboro, NC",35900.0,2019-11-01,-28,0,-28
"North Wilkesboro, NC",35900.0,2019-12-01,-13,0,-13
"North Wilkesboro, NC",35900.0,2020-01-01,-2,0,-2
"North Wilkesboro, NC",35900.0,2020-02-01,-14,0,-14
"North Wilkesboro, NC",35900.0,2020-03-01,40,0,40
"North Wilkesboro, NC",35900.0,2020-04-01,-39,0,-39
"North Wilkesboro, NC",35900.0,2020-05-01,6,0,6
"North Wilkesboro, NC",35900.0,2020-06-01,0,0,0
"North Wilkesboro, NC",35900.0,2020-07-01,0,0,0
"North Wilkesboro, NC",35900.0,2020-08-01,14,0,14
"North Wilkesboro, NC",35900.0,2020-09-01,14,0,14
"North Wilkesboro, NC",35900.0,2020-10-01,-7,0,-7
"North Wilkesboro, NC",35900.0,2020-11-01,-11,0,-11
"North Wilkesboro, NC",35900.0,2020-12-01,-4,0,-4
"Raymondville, TX",39700.0,2019-01-01,0,0,0
"Raymondville, TX",39700.0,2019-02-01,0,0,0
"Raymondville, TX",39700.0,2019-03-01,0,0,0
"Raymondville, TX",39700.0,2019-04-01,0,0,0
"Raymondville, TX",39700.0,2019-05-01,-14,0,-14
"Raymondville, TX",39700.0,2019-06-01,0,0,0
"Raymondville, TX",39700.0,2019-07-01,0,0,0
"Raymondville, TX",39700.0,2019-08-01,0,0,0
"Raymondville, TX",39700.0,2019-09-01,0,0,0
"Raymondville, TX",39700.0,2019-10-01,0,0,0
"Raymondville, TX",39700.0,2019-11-01,0,0,0
"Raymondville, TX",39700.0,2019-12-01,0,0,0
"Raymondville, TX",39700.0,2020-01-01,0,0,0
"Raymondville, TX",39700.0,2020-02-01,0,0,0
"Raymondville, TX",39700.0,2020-03-01,0,0,0
"Raymondville, TX",39700.0,2020-04-01,0,0,0
"Raymondville, TX",39700.0,2020-05-01,13,0,13
"Raymondville, TX",39700.0,2020-06-01,0,0,0
"Raymondville, TX",39700.0,2020-07-01,0,0,0
"Raymondville, TX",39700.0,2020-08-01,0,0,0
"Raymondville, TX",39700.0,2020-09-01,0,0,0
"Raymondville, TX",39700.0,2020-10-01,0,0,0
"Raymondville, TX",39700.0,2020-11-01,0,0,0
"Raymondville, TX",39700.0,2020-12-01,0,0,0
"Williston, ND",48780.0,2019-01-01,-27,-17,-10
"Williston, ND",48780.0,2019-02-01,4,0,4
"Williston, ND",48780.0,2019-03-01,0,0,0
"Williston, ND",48780.0,2019-04-01,28,23,5
"Williston, ND",48780.0,2019-05-01,29,21,8
"Williston, ND",48780.0,2019-06-01,1,0,1
"Williston, ND",48780.0,2019-07-01,-13,0,-13
"Williston, ND",48780.0,2019-08-01,12,0,12
"Williston, ND",48780.0,2019-09-01,16,0,16
"Williston, ND",48780.0,2019-10-01,-15,-24,9
"Williston, ND",48780.0,2019-11-01,3,-13,16
"Williston, ND",48780.0,2019-12-01,-26,-14,-12
"Williston, ND",48780.0,2020-01-01,3,-11,14
"Williston, ND",48780.0,2020-02-01,0,0,0
"Williston, ND",48780.0,2020-03-01,13,0,13
"Williston, ND",48780.0,2020-04-01,-6,12,-18
"Williston, ND",48780.0,2020-05-01,3,14,-11
"Williston, ND",48780.0,2020-06-01,-27,0,-27
"Williston, ND",48780.0,2020-07-01,-25,0,-25
"Williston, ND",48780.0,2020-08-01,-20,0,-20
"Williston, ND",48780.0,2020-09-01,-13,0,-13
"Williston, ND",48780.0,2020-10-01,-46,-33,-13
"Williston, ND",48780.0,2020-11-01,-20,-20,0
"Williston, ND",48780.0,2020-12-01,-28,-13,-15
"Wilson, NC",48980.0,2019-01-01,-9,0,-9
"Wilson, NC",48980.0,2019-02-01,12,0,12
"Wilson, NC",48980.0,2019-03-01,24,0,24
"Wilson, NC",48980.0,2019-04-01,-8,0,-8
"Wilson, NC",48980.0,2019-05-01,35,0,35
"Wilson, NC",48980.0,2019-06-01,46,0,46
"Wilson, NC",48980.0,2019-07-01,26,0,26
"Wilson, NC",48980.0,2019-08-01,23,0,23
"Wilson, NC",48980.0,2019-09-01,40,0,40
"Wilson, NC",48980.0,2019-10-01,-3,0,-3
"Wilson, NC",48980.0,2019-11-01,-2,0,-2
"Wilson, NC",48980.0,2019-12-01,-43,0,-43
"Wilson, NC",48980.0,2020-01-01,-2,0,-2
"Wilson, NC",48980.0,2020-02-01,1,0,1
"Wilson, NC",48980.0,2020-03-01,-55,0,-55
"Wilson, NC",48980.0,2020-04-01,-32,0,-32
"Wilson, NC",48980.0,2020-05-01,-14,0,-14
"Wilson, NC",48980.0,2020-06-01,40,0,40
"Wilson, NC",48980.0,2020-07-01,18,0,18
"Wilson, NC",48980.0,2020-08-01,3,0,3
"Wilson, NC",48980.0,2020-09-01,-8,0,-8
"Wilson, NC",48980.0,2020-10-01,-14,0,-14
"Wilson, NC",48980.0,2020-11-01,-79,0,-79
"Wilson, NC",48980.0,2020-12-01,-8,0,-8
"Worcester, MA-CT",49340.0,2019-01-01,-685,-803,118
"Worcester, MA-CT",49340.0,2019-02-01,75,-78,153
"Worcester, MA-CT",49340.0,2019-03-01,338,-25,363
"Worcester, MA-CT",49340.0,2019-04-01,1178,600,578
"Worcester, MA-CT",49340.0,2019-05-01,1112,761,351
"Worcester, MA-CT",49340.0,2019-06-01,44,53,-9
"Worcester, MA-CT",49340.0,2019-07-01,108,31,77
"Worcester, MA-CT",49340.0,2019-08-01,363,10,353
"Worcester, MA-CT",49340.0,2019-09-01,-53,-61,8
"Worcester, MA-CT",49340.0,2019-10-01,-485,-567,82
"Worcester, MA-CT",49340.0,2019-11-01,-305,-282,-23
"Worcester, MA-CT",49340.0,2019-12-01,-777,-807,30
"Worcester, MA-CT",49340.0,2020-01-01,-646,-753,107
"Worcester, MA-CT",49340.0,2020-02-01,245,-55,300
"Worcester, MA-CT",49340.0,2020-03-01,591,148,443
"Worcester, MA-CT",49340.0,2020-04-01,423,113,310
"Worcester, MA-CT",49340.0,2020-05-01,967,438,529
"Worcester, MA-CT",49340.0,2020-06-01,606,329,277
"Worcester, MA-CT",49340.0,2020-07-01,497,158,339
"Worcester, MA-CT",49340.0,2020-08-01,433,-17,450
"Worcester, MA-CT",49340.0,2020-09-01,421,8,413
"Worcester, MA-CT",49340.0,2020-10-01,-261,-355,94
"Worcester, MA-CT",49340.0,2020-11-01,-179,-391,212
"Worcester, MA-CT",49340.0,2020-12-01,-484,-616,132
"Oshkosh-Neenah, WI",36780.0,2019-01-01,-139,-137,-2
"Oshkosh-Neenah, WI",36780.0,2019-02-01,-50,0,-50
"Oshkosh-Neenah, WI",36780.0,2019-03-01,-89,0,-89
"Oshkosh-Neenah, WI",36780.0,2019-04-01,128,71,57
"Oshkosh-Neenah, WI",36780.0,2019-05-01,61,81,-20
"Oshkosh-Neenah, WI",36780.0,2019-06-01,18,11,7
"Oshkosh-Neenah, WI",36780.0,2019-07-01,29,-12,41
"Oshkosh-Neenah, WI",36780.0,2019-08-01,-70,0,-70
"Oshkosh-Neenah, WI",36780.0,2019-09-01,9,0,9
"Oshkosh-Neenah, WI",36780.0,2019-10-01,-124,-117,-7
"Oshkosh-Neenah, WI",36780.0,2019-11-01,-32,-41,9
"Oshkosh-Neenah, WI",36780.0,2019-12-01,-227,-175,-52
"Oshkosh-Neenah, WI",36780.0,2020-01-01,-132,-141,9
"Oshkosh-Neenah, WI",36780.0,2020-02-01,-26,-24,-2
"Oshkosh-Neenah, WI",36780.0,2020-03-01,-30,6,-36
"Oshkosh-Neenah, WI",36780.0,2020-04-01,46,40,6
"Oshkosh-Neenah, WI",36780.0,2020-05-01,125,87,38
"Oshkosh-Neenah, WI",36780.0,2020-06-01,10,-11,21
"Oshkosh-Neenah, WI",36780.0,2020-07-01,-8,0,-8
"Oshkosh-Neenah, WI",36780.0,2020-08-01,-86,0,-86
"Oshkosh-Neenah, WI",36780.0,2020-09-01,-40,0,-40
"Oshkosh-Neenah, WI",36780.0,2020-10-01,-76,-119,43
"Oshkosh-Neenah, WI",36780.0,2020-11-01,-118,-89,-29
"Oshkosh-Neenah, WI",36780.0,2020-12-01,-166,-139,-27
"Winona, MN",49100.0,2019-01-01,-26,-11,-15
"Winona, MN",49100.0,2019-02-01,-2,0,-2
"Winona, MN",49100.0,2019-03-01,-1,0,-1
"Winona, MN",49100.0,2019-04-01,8,11,-3
"Winona, MN",49100.0,2019-05-01,-48,17,-65
"Winona, MN",49100.0,2019-06-01,-45,0,-45
"Winona, MN",49100.0,2019-07-01,-28,0,-28
"Winona, MN",49100.0,2019-08-01,-13,0,-13
"Winona, MN",49100.0,2019-09-01,-18,0,-18
"Winona, MN",49100.0,2019-10-01,-13,-13,0
"Winona, MN",49100.0,2019-11-01,-11,-13,2
"Winona, MN",49100.0,2019-12-01,-42,-26,-16
"Winona, MN",49100.0,2020-01-01,-25,-24,-1
"Winona, MN",49100.0,2020-02-01,14,0,14
"Winona, MN",49100.0,2020-03-01,-38,0,-38
"Winona, MN",49100.0,2020-04-01,-5,0,-5
"Winona, MN",49100.0,2020-05-01,-32,13,-45
"Winona, MN",49100.0,2020-06-01,-15,0,-15
"Winona, MN",49100.0,2020-07-01,-56,0,-56
"Winona, MN",49100.0,2020-08-01,-5,0,-5
"Winona, MN",49100.0,2020-09-01,20,0,20
"Winona, MN",49100.0,2020-10-01,-15,-29,14
"Winona, MN",49100.0,2020-11-01,-2,0,-2
"Winona, MN",49100.0,2020-12-01,-28,-34,6
"Parkersburg-Vienna, WV",37620.0,2019-01-01,25,0,25
"Parkersburg-Vienna, WV",37620.0,2019-02-01,-4,0,-4
"Parkersburg-Vienna, WV",37620.0,2019-03-01,9,0,9
"Parkersburg-Vienna, WV",37620.0,2019-04-01,-10,0,-10
"Parkersburg-Vienna, WV",37620.0,2019-05-01,12,0,12
"Parkersburg-Vienna, WV",37620.0,2019-06-01,5,0,5
"Parkersburg-Vienna, WV",37620.0,2019-07-01,-15,0,-15
"Parkersburg-Vienna, WV",37620.0,2019-08-01,3,0,3
"Parkersburg-Vienna, WV",37620.0,2019-09-01,-46,0,-46
"Parkersburg-Vienna, WV",37620.0,2019-10-01,-1,0,-1
"Parkersburg-Vienna, WV",37620.0,2019-11-01,8,0,8
"Parkersburg-Vienna, WV",37620.0,2019-12-01,-12,0,-12
"Parkersburg-Vienna, WV",37620.0,2020-01-01,7,0,7
"Parkersburg-Vienna, WV",37620.0,2020-02-01,-25,0,-25
"Parkersburg-Vienna, WV",37620.0,2020-03-01,21,0,21
"Parkersburg-Vienna, WV",37620.0,2020-04-01,6,0,6
"Parkersburg-Vienna, WV",37620.0,2020-05-01,1,0,1
"Parkersburg-Vienna, WV",37620.0,2020-06-01,16,0,16
"Parkersburg-Vienna, WV",37620.0,2020-07-01,-35,0,-35
"Parkersburg-Vienna, WV",37620.0,2020-08-01,-10,0,-10
"Parkersburg-Vienna, WV",37620.0,2020-09-01,0,0,0
"Parkersburg-Vienna, WV",37620.0,2020-10-01,5,0,5
"Parkersburg-Vienna, WV",37620.0,2020-11-01,-10,0,-10
"Parkersburg-Vienna, WV",37620.0,2020-12-01,-9,0,-9
"Big Stone Gap, VA",13720.0,2019-01-01,0,0,0
"Big Stone Gap, VA",13720.0,2019-02-01,0,0,0
"Big Stone Gap, VA",13720.0,2019-03-01,-11,0,-11
"Big Stone Gap, VA",13720.0,2019-04-01,0,0,0
"Big Stone Gap, VA",13720.0,2019-05-01,-12,0,-12
"Big Stone Gap, VA",13720.0,2019-06-01,0,0,0
"Big Stone Gap, VA",13720.0,2019-07-01,0,0,0
"Big Stone Gap, VA",13720.0,2019-08-01,17,0,17
"Big Stone Gap, VA",13720.0,2019-09-01,12,0,12
"Big Stone Gap, VA",13720.0,2019-10-01,0,0,0
"Big Stone Gap, VA",13720.0,2019-11-01,-11,0,-11
"Big Stone Gap, VA",13720.0,2019-12-01,11,0,11
"Big Stone Gap, VA",13720.0,2020-01-01,0,0,0
"Big Stone Gap, VA",13720.0,2020-02-01,0,0,0
"Big Stone Gap, VA",13720.0,2020-03-01,0,0,0
"Big Stone Gap, VA",13720.0,2020-04-01,0,0,0
"Big Stone Gap, VA",13720.0,2020-05-01,0,0,0
"Big Stone Gap, VA",13720.0,2020-06-01,0,0,0
"Big Stone Gap, VA",13720.0,2020-07-01,-13,0,-13
"Big Stone Gap, VA",13720.0,2020-08-01,-1,0,-1
"Big Stone Gap, VA",13720.0,2020-09-01,0,0,0
"Big Stone Gap, VA",13720.0,2020-10-01,0,0,0
"Big Stone Gap, VA",13720.0,2020-11-01,0,0,0
"Big Stone Gap, VA",13720.0,2020-12-01,0,0,0
"Wisconsin Rapids-Marshfield, WI",49220.0,2019-01-01,-43,-29,-14
"Wisconsin Rapids-Marshfield, WI",49220.0,2019-02-01,3,0,3
"Wisconsin Rapids-Marshfield, WI",49220.0,2019-03-01,-11,0,-11
"Wisconsin Rapids-Marshfield, WI",49220.0,2019-04-01,12,21,-9
"Wisconsin Rapids-Marshfield, WI",49220.0,2019-05-01,24,18,6
"Wisconsin Rapids-Marshfield, WI",49220.0,2019-06-01,-2,0,-2
"Wisconsin Rapids-Marshfield, WI",49220.0,2019-07-01,12,0,12
"Wisconsin Rapids-Marshfield, WI",49220.0,2019-08-01,35,0,35
"Wisconsin Rapids-Marshfield, WI",49220.0,2019-09-01,21,0,21
"Wisconsin Rapids-Marshfield, WI",49220.0,2019-10-01,-87,-65,-22
"Wisconsin Rapids-Marshfield, WI",49220.0,2019-11-01,-21,-36,15
"Wisconsin Rapids-Marshfield, WI",49220.0,2019-12-01,-94,-95,1
"Wisconsin Rapids-Marshfield, WI",49220.0,2020-01-01,-39,-44,5
"Wisconsin Rapids-Marshfield, WI",49220.0,2020-02-01,27,0,27
"Wisconsin Rapids-Marshfield, WI",49220.0,2020-03-01,10,0,10
"Wisconsin Rapids-Marshfield, WI",49220.0,2020-04-01,3,0,3
"Wisconsin Rapids-Marshfield, WI",49220.0,2020-05-01,17,16,1
"Wisconsin Rapids-Marshfield, WI",49220.0,2020-06-01,52,12,40
"Wisconsin Rapids-Marshfield, WI",49220.0,2020-07-01,32,0,32
"Wisconsin Rapids-Marshfield, WI",49220.0,2020-08-01,33,0,33
"Wisconsin Rapids-Marshfield, WI",49220.0,2020-09-01,20,0,20
"Wisconsin Rapids-Marshfield, WI",49220.0,2020-10-01,-2,-37,35
"Wisconsin Rapids-Marshfield, WI",49220.0,2020-11-01,7,-28,35
"Wisconsin Rapids-Marshfield, WI",49220.0,2020-12-01,-20,-37,17
"Woodward, OK",49260.0,2019-01-01,0,0,0
"Woodward, OK",49260.0,2019-02-01,11,0,11
"Woodward, OK",49260.0,2019-03-01,0,0,0
"Woodward, OK",49260.0,2019-04-01,0,0,0
"Woodward, OK",49260.0,2019-05-01,0,0,0
"Woodward, OK",49260.0,2019-06-01,0,0,0
"Woodward, OK",49260.0,2019-07-01,0,0,0
"Woodward, OK",49260.0,2019-08-01,-12,0,-12
"Woodward, OK",49260.0,2019-09-01,0,0,0
"Woodward, OK",49260.0,2019-10-01,0,0,0
"Woodward, OK",49260.0,2019-11-01,0,0,0
"Woodward, OK",49260.0,2019-12-01,0,0,0
"Woodward, OK",49260.0,2020-01-01,0,0,0
"Woodward, OK",49260.0,2020-02-01,0,0,0
"Woodward, OK",49260.0,2020-03-01,-12,0,-12
"Woodward, OK",49260.0,2020-04-01,0,0,0
"Woodward, OK",49260.0,2020-05-01,0,0,0
"Woodward, OK",49260.0,2020-06-01,0,0,0
"Woodward, OK",49260.0,2020-07-01,0,0,0
"Woodward, OK",49260.0,2020-08-01,0,0,0
"Woodward, OK",49260.0,2020-09-01,0,0,0
"Woodward, OK",49260.0,2020-10-01,0,0,0
"Woodward, OK",49260.0,2020-11-01,0,0,0
"Woodward, OK",49260.0,2020-12-01,0,0,0
"Yakima, WA",49420.0,2019-01-01,-33,-29,-4
"Yakima, WA",49420.0,2019-02-01,7,0,7
"Yakima, WA",49420.0,2019-03-01,-51,0,-51
"Yakima, WA",49420.0,2019-04-01,74,71,3
"Yakima, WA",49420.0,2019-05-01,48,31,17
"Yakima, WA",49420.0,2019-06-01,-9,0,-9
"Yakima, WA",49420.0,2019-07-01,22,0,22
"Yakima, WA",49420.0,2019-08-01,24,0,24
"Yakima, WA",49420.0,2019-09-01,-37,0,-37
"Yakima, WA",49420.0,2019-10-01,-163,-102,-61
"Yakima, WA",49420.0,2019-11-01,-24,-14,-10
"Yakima, WA",49420.0,2019-12-01,-50,-23,-27
"Yakima, WA",49420.0,2020-01-01,-64,-30,-34
"Yakima, WA",49420.0,2020-02-01,20,0,20
"Yakima, WA",49420.0,2020-03-01,31,6,25
"Yakima, WA",49420.0,2020-04-01,-56,0,-56
"Yakima, WA",49420.0,2020-05-01,5,20,-15
"Yakima, WA",49420.0,2020-06-01,-8,0,-8
"Yakima, WA",49420.0,2020-07-01,2,0,2
"Yakima, WA",49420.0,2020-08-01,32,0,32
"Yakima, WA",49420.0,2020-09-01,-40,0,-40
"Yakima, WA",49420.0,2020-10-01,-169,-105,-64
"Yakima, WA",49420.0,2020-11-01,-36,-48,12
"Yakima, WA",49420.0,2020-12-01,-38,-12,-26
"Yankton, SD",49460.0,2019-01-01,-12,0,-12
"Yankton, SD",49460.0,2019-02-01,-12,0,-12
"Yankton, SD",49460.0,2019-03-01,0,0,0
"Yankton, SD",49460.0,2019-04-01,-2,0,-2
"Yankton, SD",49460.0,2019-05-01,13,0,13
"Yankton, SD",49460.0,2019-06-01,-23,0,-23
"Yankton, SD",49460.0,2019-07-01,3,0,3
"Yankton, SD",49460.0,2019-08-01,-20,0,-20
"Yankton, SD",49460.0,2019-09-01,-24,0,-24
"Yankton, SD",49460.0,2019-10-01,-27,-12,-15
"Yankton, SD",49460.0,2019-11-01,-17,0,-17
"Yankton, SD",49460.0,2019-12-01,-11,0,-11
"Yankton, SD",49460.0,2020-01-01,-11,0,-11
"Yankton, SD",49460.0,2020-02-01,0,0,0
"Yankton, SD",49460.0,2020-03-01,0,0,0
"Yankton, SD",49460.0,2020-04-01,11,0,11
"Yankton, SD",49460.0,2020-05-01,0,0,0
"Yankton, SD",49460.0,2020-06-01,16,0,16
"Yankton, SD",49460.0,2020-07-01,0,0,0
"Yankton, SD",49460.0,2020-08-01,7,0,7
"Yankton, SD",49460.0,2020-09-01,11,0,11
"Yankton, SD",49460.0,2020-10-01,-15,0,-15
"Yankton, SD",49460.0,2020-11-01,0,0,0
"Yankton, SD",49460.0,2020-12-01,0,0,0
"Yauco, PR",49500.0,2019-01-01,0,0,0
"Yauco, PR",49500.0,2019-03-01,0,0,0
"Yauco, PR",49500.0,2019-05-01,0,0,0
"Yauco, PR",49500.0,2019-06-01,0,0,0
"Yauco, PR",49500.0,2019-07-01,0,0,0
"Yauco, PR",49500.0,2019-08-01,0,0,0
"Yauco, PR",49500.0,2019-10-01,0,0,0
"Yauco, PR",49500.0,2019-11-01,0,0,0
"Yauco, PR",49500.0,2019-12-01,0,0,0
"Yauco, PR",49500.0,2020-01-01,0,0,0
"Yauco, PR",49500.0,2020-02-01,0,0,0
"Yauco, PR",49500.0,2020-05-01,0,0,0
"Yauco, PR",49500.0,2020-06-01,0,0,0
"Yauco, PR",49500.0,2020-07-01,0,0,0
"Yauco, PR",49500.0,2020-08-01,0,0,0
"Yauco, PR",49500.0,2020-10-01,0,0,0
"Prescott Valley-Prescott, AZ",39150.0,2019-01-01,93,-96,189
"Prescott Valley-Prescott, AZ",39150.0,2019-02-01,192,-14,206
"Prescott Valley-Prescott, AZ",39150.0,2019-03-01,178,25,153
"Prescott Valley-Prescott, AZ",39150.0,2019-04-01,345,140,205
"Prescott Valley-Prescott, AZ",39150.0,2019-05-01,535,293,242
"Prescott Valley-Prescott, AZ",39150.0,2019-06-01,465,181,284
"Prescott Valley-Prescott, AZ",39150.0,2019-07-01,357,89,268
"Prescott Valley-Prescott, AZ",39150.0,2019-08-01,240,0,240
"Prescott Valley-Prescott, AZ",39150.0,2019-09-01,243,-30,273
"Prescott Valley-Prescott, AZ",39150.0,2019-10-01,-102,-213,111
"Prescott Valley-Prescott, AZ",39150.0,2019-11-01,90,-121,211
"Prescott Valley-Prescott, AZ",39150.0,2019-12-01,84,-94,178
"Prescott Valley-Prescott, AZ",39150.0,2020-01-01,128,-124,252
"Prescott Valley-Prescott, AZ",39150.0,2020-02-01,152,-29,181
"Prescott Valley-Prescott, AZ",39150.0,2020-03-01,340,84,256
"Prescott Valley-Prescott, AZ",39150.0,2020-04-01,527,142,385
"Prescott Valley-Prescott, AZ",39150.0,2020-05-01,643,369,274
"Prescott Valley-Prescott, AZ",39150.0,2020-06-01,564,147,417
"Prescott Valley-Prescott, AZ",39150.0,2020-07-01,516,93,423
"Prescott Valley-Prescott, AZ",39150.0,2020-08-01,453,12,441
"Prescott Valley-Prescott, AZ",39150.0,2020-09-01,308,-2,310
"Prescott Valley-Prescott, AZ",39150.0,2020-10-01,390,-168,558
"Prescott Valley-Prescott, AZ",39150.0,2020-11-01,298,-179,477
"Prescott Valley-Prescott, AZ",39150.0,2020-12-01,285,-30,315
"York-Hanover, PA",49620.0,2019-01-01,12,-129,141
"York-Hanover, PA",49620.0,2019-02-01,93,0,93
"York-Hanover, PA",49620.0,2019-03-01,122,0,122
"York-Hanover, PA",49620.0,2019-04-01,179,62,117
"York-Hanover, PA",49620.0,2019-05-01,224,29,195
"York-Hanover, PA",49620.0,2019-06-01,189,11,178
"York-Hanover, PA",49620.0,2019-07-01,157,0,157
"York-Hanover, PA",49620.0,2019-08-01,110,0,110
"York-Hanover, PA",49620.0,2019-09-01,185,0,185
"York-Hanover, PA",49620.0,2019-10-01,81,-65,146
"York-Hanover, PA",49620.0,2019-11-01,111,-21,132
"York-Hanover, PA",49620.0,2019-12-01,-67,-133,66
"York-Hanover, PA",49620.0,2020-01-01,-5,-144,139
"York-Hanover, PA",49620.0,2020-02-01,42,0,42
"York-Hanover, PA",49620.0,2020-03-01,116,27,89
"York-Hanover, PA",49620.0,2020-04-01,112,33,79
"York-Hanover, PA",49620.0,2020-05-01,143,17,126
"York-Hanover, PA",49620.0,2020-06-01,87,-11,98
"York-Hanover, PA",49620.0,2020-07-01,226,0,226
"York-Hanover, PA",49620.0,2020-08-01,176,0,176
"York-Hanover, PA",49620.0,2020-09-01,235,-12,247
"York-Hanover, PA",49620.0,2020-10-01,156,-16,172
"York-Hanover, PA",49620.0,2020-11-01,144,-39,183
"York-Hanover, PA",49620.0,2020-12-01,42,-117,159
"Yuma, AZ",49740.0,2019-01-01,266,267,-1
"Yuma, AZ",49740.0,2019-02-01,27,0,27
"Yuma, AZ",49740.0,2019-03-01,-401,-59,-342
"Yuma, AZ",49740.0,2019-04-01,-1283,-881,-402
"Yuma, AZ",49740.0,2019-05-01,-388,-417,29
"Yuma, AZ",49740.0,2019-06-01,-84,-122,38
"Yuma, AZ",49740.0,2019-07-01,72,0,72
"Yuma, AZ",49740.0,2019-08-01,63,0,63
"Yuma, AZ",49740.0,2019-09-01,190,122,68
"Yuma, AZ",49740.0,2019-10-01,2395,2188,207
"Yuma, AZ",49740.0,2019-11-01,1053,1016,37
"Yuma, AZ",49740.0,2019-12-01,557,523,34
"Yuma, AZ",49740.0,2020-01-01,335,227,108
"Yuma, AZ",49740.0,2020-02-01,76,23,53
"Yuma, AZ",49740.0,2020-03-01,-271,-53,-218
"Yuma, AZ",49740.0,2020-04-01,-71,-66,-5
"Yuma, AZ",49740.0,2020-05-01,-622,-559,-63
"Yuma, AZ",49740.0,2020-06-01,-76,-120,44
"Yuma, AZ",49740.0,2020-07-01,78,-34,112
"Yuma, AZ",49740.0,2020-08-01,-28,0,-28
"Yuma, AZ",49740.0,2020-09-01,75,58,17
"Yuma, AZ",49740.0,2020-10-01,1723,1645,78
"Yuma, AZ",49740.0,2020-11-01,880,869,11
"Yuma, AZ",49740.0,2020-12-01,395,303,92
"Zapata, TX",49820.0,2019-01-01,0,0,0
"Zapata, TX",49820.0,2019-03-01,0,0,0
"Zapata, TX",49820.0,2019-05-01,0,0,0
"Zapata, TX",49820.0,2019-06-01,0,0,0
"Zapata, TX",49820.0,2019-07-01,0,0,0
"Zapata, TX",49820.0,2019-08-01,0,0,0
"Zapata, TX",49820.0,2019-09-01,0,0,0
"Zapata, TX",49820.0,2019-12-01,0,0,0
"Zapata, TX",49820.0,2020-01-01,0,0,0
"Zapata, TX",49820.0,2020-03-01,0,0,0
"Zapata, TX",49820.0,2020-04-01,0,0,0
"Zapata, TX",49820.0,2020-05-01,0,0,0
"Zapata, TX",49820.0,2020-06-01,0,0,0
"Zapata, TX",49820.0,2020-08-01,0,0,0
"Zapata, TX",49820.0,2020-10-01,0,0,0
"Jayuya, PR",27580.0,2019-09-01,0,0,0
"Jayuya, PR",27580.0,2020-01-01,0,0,0
